FECHA EVENTO,ESTADO,MUNICIPIO,CORTA,LARGA,TOTAL,CARGS,GDAS,CARTS,
11-sep-15,D.F.,"MILPA ALTA, D.F.",779,204,983,0,45,3,
07-may-19,CD. MÉX.,"AZCAPOTZALCO, CD. MÉX.",705,3,708,0,0,16,
29-mar-19,CD. MÉX.,"COYOACAN, CD. MÉX.",538,5,543,0,0,1154,
08-mar-13,COAH.,"SALTILLO, COAH.",230,125,355,21,12,25316,
15-abr-13,QRO.,"QUERETARO, QRO.",186,130,316,0,0,0,
12-nov-22,MÉX.,"COACALCO DE BERRIOZABAL, MEX.",255,0,255,0,0,0,
09-nov-22,MÉX.,"COACALCO DE BERRIOZABAL, MEX.",231,0,231,0,0,0,
11-nov-22,MÉX.,"COACALCO DE BERRIOZABAL, MEX.",208,2,210,0,0,72,
10-nov-22,MÉX.,"COACALCO DE BERRIOZABAL, MEX.",205,1,206,1,0,16,
29-nov-13,GTO.,"LEON, GTO.",97,95,192,0,5,433,
28-nov-13,GTO.,"LEON, GTO.",122,68,190,0,7,1042,
11-ene-13,D.F.,"GUSTAVO A. MADERO, D.F.",137,49,186,0,19,700,
17-sep-14,B.C.,"TIJUANA, B.C.",90,94,184,0,0,0,
23-ago-14,SIN.,"MAZATLAN, SIN.",92,75,167,1,52,18,
14-may-16,D.F.,"MILPA ALTA, D.F.",70,95,165,"1,971",89,2995,
09-ene-13,D.F.,"GUSTAVO A. MADERO, D.F.",129,35,164,0,12,1000,
27-nov-13,GTO.,"LEON, GTO.",95,68,163,0,6,242,
04-ene-13,D.F.,"IZTAPALAPA, D.F.",123,37,160,0,11,400,
14-ene-13,D.F.,"GUSTAVO A. MADERO, D.F.",107,33,140,0,10,300,
05-sep-16,CHIS.,"CHAMULA, CHIS.",3,136,139,0,0,0,
16-ene-13,D.F.,"GUSTAVO A. MADERO, D.F.",99,37,136,0,10,400,
13-feb-13,MEX.,"NEZAHUALCOYOTL, MEX.",117,19,136,25,7,1799,
22-ago-13,SON.,"HERMOSILLO, SON.",96,38,134,479,7,2154,
17-ene-13,D.F.,"GUSTAVO A. MADERO, D.F.",101,31,132,0,8,300,
08-nov-22,MÉX.,"COACALCO DE BERRIOZABAL, MEX.",132,0,132,0,0,687,
10-ene-13,D.F.,"GUSTAVO A. MADERO, D.F.",104,24,128,0,14,750,
03-ene-13,D.F.,"IZTAPALAPA, D.F.",103,22,125,0,23,300,
08-sep-16,CHIS.,"CHAMULA, CHIS.",7,113,120,0,0,0,
14-jun-13,D.F.,"CUAUHTEMOC, D.F.",105,11,116,0,8,122,
26-nov-13,GTO.,"LEON, GTO.",77,38,115,1,0,50,
12-jun-13,D.F.,"CUAUHTEMOC, D.F.",83,30,113,0,3,363,
02-sep-16,CHIS.,"CHAMULA, CHIS.",3,110,113,0,0,0,
13-jun-13,D.F.,"CUAUHTEMOC, D.F.",84,28,112,0,5,107,
12-feb-13,MEX.,"NEZAHUALCOYOTL, MEX.",89,20,109,22,4,1166,
02-ene-13,D.F.,"IZTAPALAPA, D.F.",86,22,108,0,6,600,
15-feb-13,MEX.,"NEZAHUALCOYOTL, MEX.",100,6,106,27,11,1466,
11-jun-13,D.F.,"CUAUHTEMOC, D.F.",83,23,106,0,5,1223,
15-mar-16,COAH.,"TORREÓN, COAH.",60,44,104,35,0,4781,
23-ene-13,D.F.,"TLAHUAC, D.F.",76,27,103,0,6,100,
05-dic-14,D.F.,"ALVARO OBREGON, D.F.",69,33,102,0,1,60,
13-jun-23,México,"LERMA, MEX.",102,0,102,0,0,0,
29-nov-14,GTO.,"CELAYA, GTO.",61,40,101,0,9,0,
11-nov-22,MÉX.,"ZUMPANGO, MEX.",101,0,101,0,0,0,
26-ago-14,CHIH.,"JUÁREZ, CHIH.",51,48,99,0,1,986,
03-sep-13,SON.,"SAN LUIS RIO COLORADO, SON.",39,59,98,13,8,47,
03-mar-13,MEX.,"TECAMAC, MEX.",67,29,96,0,8,910,
08-ene-13,D.F.,"GUSTAVO A. MADERO, D.F.",76,19,95,0,14,500,
17-feb-13,MEX.,"NEZAHUALCOYOTL, MEX.",80,15,95,25,6,793,
14-feb-13,MEX.,"NEZAHUALCOYOTL, MEX.",85,9,94,31,6,1887,
08-ene-13,D.F.,"IZTAPALAPA, D.F.",66,26,92,0,1,320,
16-feb-13,MEX.,"NEZAHUALCOYOTL, MEX.",79,13,92,28,11,616,
26-feb-13,MEX.,"TECAMAC, MEX.",61,31,92,0,4,208,
02-mar-13,N.L.,"MONTERREY, N.L.",61,30,91,8,1,4499,
15-ene-13,D.F.,"GUSTAVO A. MADERO, D.F.",64,25,89,0,10,250,
24-feb-13,MEX.,"TLALNEPANTLA DE BAZ, MEX.",74,15,89,0,0,150,
22-ene-13,D.F.,"TLAHUAC, D.F.",62,26,88,0,5,200,
10-abr-13,D.F.,"AZCAPOTZALCO, D.F.",74,14,88,0,1,300,
19-may-13,HGO.,"PACHUCA DE SOTO, HGO.",48,40,88,0,7,1118,
13-feb-13,MEX.,"ECATEPEC DE MOR., MEX.",67,20,87,0,6,600,
08-mar-13,COAH.,"MATAMOROS, COAH.",66,21,87,1,7,0,
09-abr-14,DGO.,"DGO., DGO.",63,24,87,10,8,0,
20-may-13,MEX.,"CHALCO, MEX.",77,9,86,0,0,0,
20-may-13,GRO.,"ATOYAC DE ALVAREZ, GRO.",58,27,85,0,64,1483,
10-jun-13,D.F.,"CUAUHTEMOC, D.F.",75,9,84,0,5,614,
11-sep-21,CD. MÉX.,"GUSTAVO A. MADERO, CD. MÉX.",69,15,84,0,8,5962,
22-feb-13,MEX.,"TLALNEPANTLA DE BAZ, MEX.",67,14,81,0,8,150,
03-nov-15,B.C.,"TIJUANA, B.C.",50,31,81,0,0,0,
20-jun-23,México,"ZUMPANGO, MEX.",80,0,80,0,0,0,
21-feb-13,MEX.,"TLALNEPANTLA DE BAZ, MEX.",64,15,79,0,3,250,
14-dic-14,D.F.,"CUAUHTEMOC, D.F.",64,15,79,0,0,50,
28-nov-14,GTO.,"CELAYA, GTO.",50,28,78,0,5,0,
03-ago-13,JAL.,"ZAPOPAN, JAL.",20,57,77,11,1,318,
11-abr-14,DGO.,"DGO., DGO.",58,19,77,37,3,16,
09-ago-21,CD. MÉX.,"BENITO JUAREZ, CD. MÉX.",21,55,76,0,6,5044,
20-may-13,MEX.,"TOLUCA, MEX.",53,22,75,0,0,410,
11-feb-13,MEX.,"NEZAHUALCOYOTL, MEX.",66,8,74,35,3,1007,
14-mar-23,México,"ECATEPEC DE MORELOS, MEX.",74,0,74,0,0,0,
20-feb-13,MEX.,"TLALNEPANTLA DE BAZ, MEX.",64,9,73,0,7,3170,
04-mar-13,D.F.,"IZTACALCO, D.F.",63,10,73,0,2,960,
08-mar-13,DGO.,"DGO., DGO.",46,27,73,43,1,0,
22-mar-13,DGO.,"DGO., DGO.",51,22,73,24,0,0,
18-jul-13,D.F.,"GUSTAVO A. MADERO, D.F.",54,18,72,0,7,430,
19-dic-14,D.F.,"CUAUHTEMOC, D.F.",52,19,71,0,0,50,
13-nov-14,CHIS.,"COMITAN DE DOMÍNGUEZ, CHIS.",63,7,70,1,0,719,
28-ene-13,D.F.,"TLAHUAC, D.F.",41,28,69,0,2,50,
09-feb-13,D.F.,"MIGUEL HGO., D.F.",57,12,69,0,6,200,
14-feb-13,MEX.,"ECATEPEC DE MOR., MEX.",57,12,69,1,6,112,
01-mar-13,MEX.,"TECAMAC, MEX.",55,14,69,0,9,243,
24-jul-14,D.F.,"GUSTAVO A. MADERO, D.F.",53,16,69,0,7,70,
25-ene-13,D.F.,"TLAHUAC, D.F.",38,30,68,0,4,80,
04-dic-14,GTO.,"LEON, GTO.",49,19,68,0,1,0,
03-nov-22,MÉX.,"CUAUTITLAN, MEX.",67,1,68,0,0,30,
06-mar-23,México,"ECATEPEC DE MORELOS, MEX.",68,0,68,0,0,4,
12-abr-13,D.F.,"AZCAPOTZALCO, D.F.",52,15,67,0,4,4300,
17-jul-13,D.F.,"GUSTAVO A. MADERO, D.F.",52,15,67,0,1,840,
07-abr-14,DGO.,"DGO., DGO.",55,12,67,17,9,0,
25-nov-14,GTO.,"CELAYA, GTO.",40,27,67,0,5,0,
07-feb-13,D.F.,"MIGUEL HGO., D.F.",53,13,66,0,7,0,
25-jul-14,D.F.,"GUSTAVO A. MADERO, D.F.",56,10,66,0,13,100,
12-ene-16,D.F.,"CUAUHTEMOC, D.F.",32,34,66,18,0,3,
24-ene-19,CD. MÉX.,"GUSTAVO A. MADERO, CD. MÉX.",58,7,65,0,1,16172,
11-mar-23,México,"COACALCO DE BERRIOZABAL, MEX.",65,0,65,0,0,0,
08-feb-13,D.F.,"MIGUEL HGO., D.F.",53,11,64,0,7,1050,
12-dic-14,D.F.,"CUAUHTEMOC, D.F.",38,26,64,0,0,300,
14-jun-23,México,"LA PAZ, MEX.",63,1,64,0,40,62,
23-feb-13,MEX.,"TLALNEPANTLA DE BAZ, MEX.",40,23,63,0,2,0,
27-feb-13,MEX.,"TECAMAC, MEX.",38,25,63,0,6,205,
08-abr-14,DGO.,"DGO., DGO.",48,15,63,28,8,0,
22-abr-14,MEX.,"NEZAHUALCOYOTL, MEX.",56,7,63,0,8,300,
21-sep-16,D.F.,"CUAUHTEMOC, D.F.",45,18,63,0,8,977,
19-jun-23,México,"ZUMPANGO, MEX.",63,0,63,1,0,23,
13-feb-13,DGO.,"DGO., DGO.",48,14,62,10,3,0,
09-mar-13,MEX.,"TEXCOCO, MEX.",46,16,62,0,6,253,
09-abr-13,D.F.,"AZCAPOTZALCO, D.F.",45,17,62,0,3,270,
22-oct-14,D.F.,"COYOACAN, D.F.",38,24,62,0,0,50,
27-nov-14,GTO.,"CELAYA, GTO.",40,22,62,0,3,0,
06-feb-13,D.F.,"MIGUEL HGO., D.F.",47,14,61,0,2,1800,
11-abr-13,D.F.,"AZCAPOTZALCO, D.F.",47,14,61,0,0,350,
14-feb-13,MEX.,"NAUCALPAN DE JUAREZ, MEX.",51,9,60,0,4,873,
08-mar-13,COAH.,"TORREÓN, COAH.",50,10,60,1,2,53,
28-mar-13,DGO.,"DGO., DGO.",41,19,60,48,1,0,
24-sep-14,D.F.,"MILPA ALTA, D.F.",38,22,60,0,7,0,
23-mar-19,CHIH.,"JUÁREZ, CHIH.",48,12,60,10,0,710,
22-jun-23,México,"ZUMPANGO, MEX.",60,0,60,13,0,0,
22-feb-13,MEX.,"ATIZAPAN DE ZARAGOZA, MEX.",47,12,59,0,3,351,
02-mar-13,MEX.,"TECAMAC, MEX.",42,17,59,0,18,190,
21-mar-13,DGO.,"DGO., DGO.",39,20,59,33,0,0,
08-abr-13,D.F.,"AZCAPOTZALCO, D.F.",43,16,59,0,1,260,
23-abr-14,MEX.,"NEZAHUALCOYOTL, MEX.",56,3,59,0,7,327,
30-abr-14,DGO.,"DGO., DGO.",49,10,59,27,8,0,
10-sep-14,D.F.,"IZTACALCO, D.F.",35,24,59,0,4,0,
22-sep-15,D.F.,"CUAJIMALPA DE MOR., D.F.",49,10,59,0,2,0,
25-sep-15,D.F.,"CUAJIMALPA DE MOR., D.F.",52,7,59,0,0,0,
13-mar-23,México,"COACALCO DE BERRIOZABAL, MEX.",59,0,59,0,0,0,
14-mar-13,DGO.,"DGO., DGO.",46,12,58,10,0,0,
23-abr-13,D.F.,"COYOACAN, D.F.",49,9,58,0,2,230,
16-jul-13,D.F.,"GUSTAVO A. MADERO, D.F.",45,13,58,0,1,400,
22-jul-14,D.F.,"GUSTAVO A. MADERO, D.F.",47,11,58,0,7,180,
03-dic-14,GTO.,"LEON, GTO.",37,21,58,0,7,0,
30-sep-15,D.F.,"AZCAPOTZALCO, D.F.",51,7,58,0,0,37,
07-dic-15,S.L.P.,"SAN LUIS POTOSI, S.L.P.",47,11,58,2,2,460,
27-may-16,D.F.,"XOCHIMILCO, D.F.",18,40,58,712,24,544,
09-nov-22,MÉX.,"ZUMPANGO, MEX.",56,2,58,0,0,194,
15-feb-13,MEX.,"ECATEPEC DE MOR., MEX.",47,10,57,0,6,773,
28-sep-15,D.F.,"AZCAPOTZALCO, D.F.",45,12,57,0,0,120,
29-sep-15,D.F.,"AZCAPOTZALCO, D.F.",47,10,57,0,4,48,
09-oct-15,D.F.,"AZCAPOTZALCO, D.F.",47,10,57,0,0,110,
22-ene-16,D.F.,"COYOACAN, D.F.",47,10,57,0,3,256,
11-mar-23,México,"ATIZAPAN, MEX.",57,0,57,0,0,0,
20-feb-13,D.F.,"VENUSTIANO CARRANZA, D.F.",44,12,56,0,0,800,
05-mar-13,D.F.,"IZTACALCO, D.F.",45,11,56,0,5,620,
10-mar-13,N.L.,"MONTERREY, N.L.",35,21,56,34,1,14162,
25-mar-13,DGO.,"DGO., DGO.",48,8,56,43,7,0,
27-mar-13,DGO.,"DGO., DGO.",34,22,56,18,6,0,
25-abr-13,D.F.,"COYOACAN, D.F.",31,25,56,0,1,200,
02-may-13,D.F.,"BENITO JUAREZ, D.F.",33,23,56,0,6,100,
26-nov-14,GTO.,"CELAYA, GTO.",45,11,56,0,7,0,
02-oct-15,D.F.,"AZCAPOTZALCO, D.F.",49,7,56,0,0,0,
02-oct-15,D.F.,"AZCAPOTZALCO, D.F.",49,7,56,0,0,0,
02-ene-13,D.F.,"IZTAPALAPA, D.F.",43,12,55,0,6,300,
15-mar-13,DGO.,"DGO., DGO.",39,16,55,57,5,0,
10-abr-14,DGO.,"DGO., DGO.",45,10,55,27,2,0,
26-ago-14,N.L.,"GUADALUPE, N.L.",33,22,55,0,0,25632,
01-oct-14,D.F.,"XOCHIMILCO, D.F.",40,15,55,0,2,0,
23-sep-15,D.F.,"CUAJIMALPA DE MOR., D.F.",48,7,55,0,0,0,
24-sep-15,D.F.,"CUAJIMALPA DE MOR., D.F.",51,4,55,0,0,0,
07-oct-15,D.F.,"AZCAPOTZALCO, D.F.",50,5,55,0,2,25,
28-jun-23,México,"HUEHUETOCA, MEX.",55,0,55,0,0,0,
15-feb-13,MEX.,"NAUCALPAN DE JUAREZ, MEX.",51,3,54,0,1,180,
12-mar-13,DGO.,"DGO., DGO.",39,15,54,17,1,0,
20-may-13,GRO.,"ACAPULCO DE JUAREZ, GRO.",25,29,54,9,8,72,
24-abr-14,MEX.,"NEZAHUALCOYOTL, MEX.",49,5,54,0,4,193,
28-ago-15,SIN.,"AHOME, SIN.",44,10,54,0,7,0,
29-ago-16,D.F.,"GUSTAVO A. MADERO, D.F.",26,28,54,0,8,562,
12-nov-22,MÉX.,"ZUMPANGO, MEX.",54,0,54,0,0,0,
22-sep-23,Michoacán,"LA PIEDAD, MICH.",4,50,54,17,0,52,
24-ene-13,D.F.,"IZTAPALAPA, D.F.",38,15,53,0,3,70,
21-feb-13,D.F.,"VENUSTIANO CARRANZA, D.F.",44,9,53,0,0,200,
14-abr-14,DGO.,"DGO., DGO.",31,22,53,0,6,0,
16-abr-14,DGO.,"DGO., DGO.",38,15,53,22,0,0,
27-jun-14,D.F.,"VENUSTIANO CARRANZA, D.F.",49,4,53,0,8,180,
03-sep-14,D.F.,"MIGUEL HGO., D.F.",39,14,53,0,0,50,
03-dic-14,D.F.,"ALVARO OBREGON, D.F.",36,17,53,0,0,50,
11-dic-14,D.F.,"CUAUHTEMOC, D.F.",43,10,53,0,0,350,
05-oct-15,D.F.,"AZCAPOTZALCO, D.F.",45,8,53,0,5,12,
31-ene-19,CD. MÉX.,"GUSTAVO A. MADERO, CD. MÉX.",44,9,53,0,5,38876,
01-feb-19,CD. MÉX.,"GUSTAVO A. MADERO, CD. MÉX.",41,12,53,0,1,37601,
16-jun-21,CD. MÉX.,"IZTAPALAPA, CD. MÉX.",44,9,53,0,27,4471,
05-ene-13,D.F.,"IZTAPALAPA, D.F.",30,22,52,0,7,160,
19-feb-13,MEX.,"TLALNEPANTLA DE BAZ, MEX.",43,9,52,0,6,500,
26-abr-14,MEX.,"NEZAHUALCOYOTL, MEX.",42,10,52,0,12,0,
28-abr-14,D.F.,"XOCHIMILCO, D.F.",30,22,52,2,0,200,
06-oct-15,D.F.,"AZCAPOTZALCO, D.F.",48,4,52,0,0,55,
11-abr-16,COAH.,"SALTILLO, COAH.",27,25,52,19,0,0,
20-may-16,D.F.,"MILPA ALTA, D.F.",13,39,52,410,36,342,
30-ene-19,CD. MÉX.,"GUSTAVO A. MADERO, CD. MÉX.",44,8,52,0,0,35270,
26-feb-21,CHIS.,"CHENALHÓ, CHIS.",14,38,52,0,0,0,
20-may-22,CD. MÉX.,"GUSTAVO A. MADERO, CD. MÉX.",42,10,52,0,12,3270,
18-feb-13,MEX.,"TLALNEPANTLA DE BAZ, MEX.",46,5,51,0,2,341,
26-mar-13,DGO.,"DGO., DGO.",34,17,51,42,1,0,
24-abr-13,D.F.,"COYOACAN, D.F.",41,10,51,0,0,550,
12-sep-14,D.F.,"IZTACALCO, D.F.",45,6,51,0,3,10,
23-mar-15,D.F.,"LA MAGDALENA CONTRERAS, D.F.",24,27,51,0,0,100,
04-ago-16,D.F.,"TLALPAN, D.F.",22,29,51,0,0,20,
06-sep-16,CHIS.,"CHAMULA, CHIS.",2,49,51,0,0,0,
02-abr-22,CD. MÉX.,"CUAUHTEMOC, CD. MÉX.",32,19,51,0,3,3205,
11-mar-23,México,"ECATEPEC DE MORELOS, MEX.",51,0,51,0,0,0,
13-mar-23,México,"ECATEPEC DE MORELOS, MEX.",51,0,51,0,0,5,
14-mar-23,México,"COACALCO DE BERRIOZABAL, MEX.",51,0,51,0,0,0,
02-ago-23,México,"CHICOLOAPAN, MEX.",51,0,51,0,0,0,
13-feb-13,MEX.,"TOLUCA, MEX.",40,10,50,19,0,475,
10-jul-14,D.F.,"ALVARO OBREGON, D.F.",35,15,50,0,1,0,
15-dic-14,D.F.,"CUAUHTEMOC, D.F.",34,16,50,0,0,600,
18-dic-14,D.F.,"CUAUHTEMOC, D.F.",34,16,50,0,0,250,
25-dic-14,SON.,"HERMOSILLO, SON.",34,16,50,377,3,2777,
25-mar-15,D.F.,"LA MAGDALENA CONTRERAS, D.F.",36,14,50,0,1,70,
21-sep-15,D.F.,"CUAJIMALPA DE MOR., D.F.",44,6,50,0,4,0,
06-sep-16,CHIS.,"SAN CRISTOBAL DE LAS CASAS, CHIS.",3,47,50,0,0,0,
29-oct-22,MÉX.,"NEXTLALPAN, MEX., MEX.",50,0,50,0,0,0,
13-mar-23,México,"ATIZAPAN, MEX.",50,0,50,1,0,48,
02-mar-13,MEX.,"COACALCO DE BERRIOZABAL, MEX.",35,14,49,12,1,396,
16-may-13,D.F.,"ALVARO OBREGON, D.F.",24,25,49,0,0,800,
29-abr-14,D.F.,"XOCHIMILCO, D.F.",42,7,49,0,0,150,
02-may-14,D.F.,"XOCHIMILCO, D.F.",39,10,49,0,3,1800,
17-jul-14,D.F.,"GUSTAVO A. MADERO, D.F.",37,12,49,0,9,0,
21-sep-14,GRO.,"ACAPULCO DE JUAREZ, GRO.",38,11,49,6,16,431,
29-oct-14,D.F.,"BENITO JUAREZ, D.F.",31,18,49,0,2,90,
26-feb-15,D.F.,"IZTAPALAPA, D.F.",35,14,49,0,0,0,
03-mar-15,D.F.,"IZTAPALAPA, D.F.",34,15,49,0,0,350,
10-mar-15,D.F.,"IZTACALCO, D.F.",28,21,49,0,0,0,
20-mar-15,D.F.,"IZTACALCO, D.F.",38,11,49,0,0,100,
08-oct-15,D.F.,"AZCAPOTZALCO, D.F.",45,4,49,0,1,8,
12-nov-15,COAH.,"TORREÓN, COAH.",7,42,49,10,0,210,
08-sep-16,CHIS.,"SAN CRISTOBAL DE LAS CASAS, CHIS.",10,39,49,2,0,50,
08-nov-22,MÉX.,"ZUMPANGO, MEX.",48,1,49,0,1,29,
15-feb-13,MEX.,"TOLUCA, MEX.",37,11,48,10,1,453,
17-feb-13,MEX.,"ECATEPEC DE MOR., MEX.",39,9,48,40,6,0,
28-feb-13,COAH.,"SAN PEDRO, COAH.",34,14,48,0,0,0,
01-mar-13,D.F.,"IZTACALCO, D.F.",37,11,48,0,2,850,
20-mar-13,D.F.,"XOCHIMILCO, D.F.",35,13,48,0,2,420,
20-mar-13,DGO.,"DGO., DGO.",29,19,48,11,4,0,
22-jul-13,D.F.,"GUSTAVO A. MADERO, D.F.",30,18,48,0,2,480,
25-abr-14,DGO.,"DGO., DGO.",40,8,48,15,2,0,
25-sep-14,D.F.,"MILPA ALTA, D.F.",42,6,48,1,1,3,
24-feb-15,D.F.,"IZTAPALAPA, D.F.",31,17,48,0,0,30,
18-mar-15,D.F.,"IZTACALCO, D.F.",30,18,48,0,0,30,
19-mar-15,D.F.,"IZTACALCO, D.F.",32,16,48,0,0,100,
30-sep-15,B.C.,"MEXICALI, B.C.",23,25,48,0,0,0,
07-mar-23,México,"ECATEPEC DE MORELOS, MEX.",48,0,48,0,0,269,
12-jun-23,México,"NEXTLALPAN, MEX., MEX.",48,0,48,0,0,0,
24-jun-23,México,"ZUMPANGO, MEX.",48,0,48,0,0,172,
12-feb-13,MEX.,"ECATEPEC DE MOR., MEX.",36,11,47,0,0,361,
09-mar-13,VER.,"XALAPA, VER.",37,10,47,4,4,1168,
30-abr-13,D.F.,"BENITO JUAREZ, D.F.",35,12,47,0,0,200,
19-jul-13,D.F.,"GUSTAVO A. MADERO, D.F.",39,8,47,0,10,724,
18-jul-14,D.F.,"GUSTAVO A. MADERO, D.F.",40,7,47,0,16,0,
23-jul-14,D.F.,"GUSTAVO A. MADERO, D.F.",43,4,47,0,14,50,
28-ago-14,D.F.,"IZTAPALAPA, D.F.",27,20,47,0,3,25,
10-nov-14,D.F.,"CUAUHTEMOC, D.F.",39,8,47,0,5,400,
19-nov-14,D.F.,"LA MAGDALENA CONTRERAS, D.F.",32,15,47,0,0,200,
02-dic-14,D.F.,"ALVARO OBREGON, D.F.",43,4,47,0,0,100,
04-dic-14,D.F.,"ALVARO OBREGON, D.F.",41,6,47,0,2,50,
04-mar-15,D.F.,"IZTAPALAPA, D.F.",36,11,47,0,2,250,
20-ago-15,SIN.,"AHOME, SIN.",27,20,47,0,0,0,
26-ene-16,D.F.,"COYOACAN, D.F.",30,17,47,0,2,110,
02-ago-18,D.F.,"GUSTAVO A. MADERO, D.F.",34,13,47,0,1,1008,
16-feb-13,MEX.,"TOLUCA, MEX.",39,7,46,8,3,553,
13-sep-13,D.F.,"IZTACALCO, D.F.",35,11,46,5,1,20,
22-nov-13,D.F.,"CUAUHTEMOC, D.F.",32,14,46,8,1,888,
02-may-14,SIN.,"AHOME, SIN.",24,22,46,0,9,0,
09-dic-14,D.F.,"CUAUHTEMOC, D.F.",39,7,46,0,2,150,
27-feb-15,D.F.,"IZTAPALAPA, D.F.",31,15,46,0,0,0,
12-ago-15,SIN.,"AHOME, SIN.",28,18,46,0,2,0,
11-sep-15,D.F.,"TLALPAN, D.F.",41,5,46,0,6,30,
01-oct-15,D.F.,"AZCAPOTZALCO, D.F.",43,3,46,0,1,0,
29-jul-16,D.F.,"GUSTAVO A. MADERO, D.F.",28,18,46,0,2,1380,
12-ago-16,D.F.,"TLALPAN, D.F.",16,30,46,0,7,8,
27-feb-13,MEX.,"CHALCO, MEX.",34,11,45,0,0,268,
06-mar-13,DGO.,"DGO., DGO.",30,15,45,5,1,0,
07-mar-13,MEX.,"CHIMALHUACAN, MEX.",41,4,45,0,2,50,
21-jul-13,N.L.,"MONTERREY, N.L.",32,13,45,61,0,6008,
25-feb-14,CHIH.,"CHIH., CHIH.",29,16,45,5,0,0,
20-feb-15,D.F.,"IZTAPALAPA, D.F.",30,15,45,0,0,100,
25-feb-15,D.F.,"IZTAPALAPA, D.F.",27,18,45,0,0,40,
30-jun-16,SIN.,"AHOME, SIN.",37,8,45,0,14,0,
21-mar-13,D.F.,"XOCHIMILCO, D.F.",35,9,44,0,0,498,
22-mar-13,D.F.,"XOCHIMILCO, D.F.",35,9,44,0,1,587,
19-abr-13,D.F.,"LA MAGDALENA CONTRERAS, D.F.",29,15,44,0,2,700,
26-abr-13,D.F.,"COYOACAN, D.F.",31,13,44,0,0,180,
23-may-13,D.F.,"TLALPAN, D.F.",32,12,44,0,1,385,
24-jul-13,N.L.,"MONTERREY, N.L.",27,17,44,13,0,4072,
18-oct-13,D.F.,"COYOACAN, D.F.",31,13,44,4,2,796,
06-dic-13,D.F.,"CUAUHTEMOC, D.F.",40,4,44,2,0,7,
21-abr-14,DGO.,"DGO., DGO.",32,12,44,19,2,0,
23-abr-14,SIN.,"AHOME, SIN.",31,13,44,0,4,0,
11-sep-14,D.F.,"IZTACALCO, D.F.",41,3,44,0,14,30,
06-mar-15,D.F.,"IZTAPALAPA, D.F.",29,15,44,0,1,150,
12-mar-15,D.F.,"IZTACALCO, D.F.",28,16,44,0,1,0,
21-ago-15,SIN.,"AHOME, SIN.",30,14,44,0,5,0,
02-dic-15,D.F.,"CUAUHTEMOC, D.F.",25,19,44,0,5,108,
15-ene-16,D.F.,"CUAUHTEMOC, D.F.",29,15,44,0,4,24,
21-ene-16,D.F.,"COYOACAN, D.F.",36,8,44,0,4,110,
05-abr-16,D.F.,"IZTAPALAPA, D.F.",22,22,44,13,1,371,
01-sep-16,CHIS.,"CHAMULA, CHIS.",7,37,44,0,0,0,
13-feb-13,MEX.,"NAUCALPAN DE JUAREZ, MEX.",29,14,43,0,8,263,
25-feb-13,MEX.,"TECAMAC, MEX.",30,13,43,0,5,770,
05-mar-13,DGO.,"DGO., DGO.",33,10,43,11,2,0,
07-mar-13,D.F.,"IZTACALCO, D.F.",33,10,43,0,4,650,
07-mar-13,DGO.,"DGO., DGO.",26,17,43,8,2,0,
22-may-13,D.F.,"TLALPAN, D.F.",35,8,43,0,0,148,
30-ago-13,D.F.,"IZTAPALAPA, D.F.",32,11,43,5,0,110,
04-dic-13,D.F.,"CUAUHTEMOC, D.F.",28,15,43,1,3,10,
11-abr-14,D.F.,"MILPA ALTA, D.F.",30,13,43,0,0,60,
16-abr-14,DGO.,"DGO., DGO.",35,8,43,45,1,0,
21-abr-14,MEX.,"NEZAHUALCOYOTL, MEX.",39,4,43,0,14,483,
25-abr-14,MEX.,"NEZAHUALCOYOTL, MEX.",41,2,43,0,6,0,
28-abr-14,DGO.,"DGO., DGO.",33,10,43,4,0,0,
23-may-14,D.F.,"COYOACAN, D.F.",27,16,43,0,6,430,
29-jul-14,D.F.,"XOCHIMILCO, D.F.",36,7,43,0,1,10,
10-oct-14,D.F.,"TLALPAN, D.F.",31,12,43,0,1,30,
23-feb-15,D.F.,"IZTAPALAPA, D.F.",29,14,43,0,2,70,
13-mar-15,D.F.,"IZTACALCO, D.F.",31,12,43,0,0,0,
17-mar-15,D.F.,"IZTACALCO, D.F.",29,14,43,0,0,20,
25-ago-15,D.F.,"TLAHUAC, D.F.",36,7,43,0,4,19,
17-sep-15,D.F.,"CUAJIMALPA DE MOR., D.F.",41,2,43,0,3,0,
18-mar-16,D.F.,"TLAHUAC, D.F.",22,21,43,46,0,249,
11-jul-16,D.F.,"GUSTAVO A. MADERO, D.F.",28,15,43,0,0,991,
25-jul-16,D.F.,"GUSTAVO A. MADERO, D.F.",27,16,43,0,0,1828,
10-ago-16,D.F.,"TLALPAN, D.F.",22,21,43,0,0,0,
25-ene-19,CD. MÉX.,"GUSTAVO A. MADERO, CD. MÉX.",37,6,43,0,0,24912,
18-may-22,CD. MÉX.,"VENUSTIANO CARRANZA, CD. MÉX.",36,7,43,0,0,1539,
26-oct-22,MÉX.,"NEXTLALPAN, MEX., MEX.",43,0,43,0,0,0,
01-mar-13,N.L.,"MONTERREY, N.L.",21,21,42,0,0,0,
06-mar-13,D.F.,"IZTACALCO, D.F.",35,7,42,0,7,1545,
08-mar-13,D.F.,"IZTACALCO, D.F.",30,12,42,0,2,690,
10-mar-13,MEX.,"CHIMALHUACAN, MEX.",41,1,42,0,8,156,
28-ago-13,SON.,"AGUA PRIETA, SON.",20,22,42,20,1,659,
27-sep-13,D.F.,"XOCHIMILCO, D.F.",32,10,42,3,1,60,
03-dic-13,D.F.,"CUAUHTEMOC, D.F.",38,4,42,1,0,0,
29-abr-14,DGO.,"DGO., DGO.",34,8,42,12,8,0,
04-sep-14,D.F.,"MIGUEL HGO., D.F.",36,6,42,0,6,0,
03-oct-14,B.C.,"TIJUANA, B.C.",29,13,42,0,0,0,
05-mar-15,D.F.,"IZTAPALAPA, D.F.",27,15,42,0,0,25,
28-ago-15,D.F.,"TLAHUAC, D.F.",38,4,42,0,0,0,
09-sep-15,D.F.,"TLALPAN, D.F.",37,5,42,0,0,60,
10-sep-15,D.F.,"TLALPAN, D.F.",38,4,42,0,6,0,
14-oct-15,D.F.,"ALVARO OBREGON, D.F.",40,2,42,0,0,35,
28-ene-16,D.F.,"COYOACAN, D.F.",29,13,42,0,0,108,
22-jul-16,D.F.,"GUSTAVO A. MADERO, D.F.",28,14,42,0,0,1531,
19-feb-13,D.F.,"VENUSTIANO CARRANZA, D.F.",32,9,41,0,3,800,
08-mar-13,MEX.,"TEXCOCO, MEX.",32,9,41,0,0,486,
19-mar-13,DGO.,"DGO., DGO.",30,11,41,22,3,0,
25-jun-13,PUE.,"PUE., PUE.",33,8,41,7,10,2100,
30-jul-13,JAL.,"ZAPOPAN, JAL.",10,31,41,2,0,102,
26-sep-13,D.F.,"XOCHIMILCO, D.F.",36,5,41,4,0,1000,
05-jun-14,D.F.,"CUAJIMALPA DE MOR., D.F.",26,15,41,0,3,128,
05-jun-14,D.F.,"MIGUEL HGO., D.F.",40,1,41,0,0,800,
18-jun-14,D.F.,"VENUSTIANO CARRANZA, D.F.",28,13,41,0,6,2100,
26-sep-14,D.F.,"MILPA ALTA, D.F.",31,10,41,1,2,300,
11-mar-15,D.F.,"IZTACALCO, D.F.",25,16,41,0,0,150,
14-ago-15,SIN.,"AHOME, SIN.",27,14,41,0,12,0,
26-ago-15,D.F.,"TLAHUAC, D.F.",31,10,41,208,10,0,
26-ago-15,SIN.,"AHOME, SIN.",26,15,41,0,14,0,
02-sep-15,D.F.,"TLALPAN, D.F.",40,1,41,81,2,214,
27-jul-16,D.F.,"GUSTAVO A. MADERO, D.F.",24,17,41,0,1,420,
28-jul-16,D.F.,"GUSTAVO A. MADERO, D.F.",25,16,41,0,0,66,
15-ago-16,D.F.,"TLALPAN, D.F.",23,18,41,0,5,0,
21-sep-23,Michoacán,"LA PIEDAD, MICH.",2,39,41,10,0,38,
18-mar-13,DGO.,"DGO., DGO.",27,13,40,7,1,0,
26-jul-13,D.F.,"GUSTAVO A. MADERO, D.F.",32,8,40,5,13,380,
05-dic-13,D.F.,"CUAUHTEMOC, D.F.",38,2,40,4,5,5,
25-abr-14,SIN.,"AHOME, SIN.",30,10,40,0,6,0,
26-jun-14,D.F.,"VENUSTIANO CARRANZA, D.F.",26,14,40,0,5,400,
11-jul-14,D.F.,"ALVARO OBREGON, D.F.",32,8,40,0,1,290,
30-sep-14,D.F.,"XOCHIMILCO, D.F.",32,8,40,0,2,80,
24-nov-14,D.F.,"VENUSTIANO CARRANZA, D.F.",26,14,40,0,0,0,
13-feb-15,D.F.,"IZTAPALAPA, D.F.",23,17,40,0,1,1000,
18-feb-15,D.F.,"IZTAPALAPA, D.F.",24,16,40,0,0,200,
19-feb-15,D.F.,"IZTAPALAPA, D.F.",27,13,40,0,0,150,
29-ene-16,D.F.,"COYOACAN, D.F.",25,15,40,0,4,286,
10-jun-16,D.F.,"VENUSTIANO CARRANZA, D.F.",17,23,40,135,1,184,
14-jun-16,D.F.,"VENUSTIANO CARRANZA, D.F.",18,22,40,203,0,166,
27-sep-16,CHIH.,"HGO. DEL PARRAL, CHIH.",34,6,40,0,0,132,
19-feb-13,MEX.,"CUAUTITLAN IZCALLI, MEX.",34,5,39,0,1,869,
23-feb-13,MEX.,"ATIZAPAN DE ZARAGOZA, MEX.",35,4,39,0,0,981,
26-feb-13,MEX.,"CHALCO, MEX.",29,10,39,5,5,209,
05-sep-13,D.F.,"VENUSTIANO CARRANZA, D.F.",20,19,39,4,1,700,
25-sep-13,D.F.,"XOCHIMILCO, D.F.",32,7,39,8,1,50,
27-nov-13,N.L.,"MONTERREY, N.L.",27,12,39,26,1,3050,
22-may-14,D.F.,"COYOACAN, D.F.",30,9,39,0,2,80,
30-may-14,D.F.,"BENITO JUAREZ, D.F.",33,6,39,0,5,45,
17-sep-14,D.F.,"TLAHUAC, D.F.",29,10,39,1,0,50,
18-sep-14,D.F.,"TLAHUAC, D.F.",34,5,39,0,6,15,
13-nov-14,D.F.,"AZCAPOTZALCO, D.F.",28,11,39,0,0,30,
28-nov-14,D.F.,"VENUSTIANO CARRANZA, D.F.",33,6,39,0,0,100,
02-dic-14,GTO.,"LEON, GTO.",27,12,39,0,2,0,
18-nov-15,COAH.,"MÚZQUIZ, COAH.",38,1,39,1,0,0,
03-dic-15,D.F.,"CUAUHTEMOC, D.F.",25,14,39,0,0,206,
24-jun-16,SIN.,"AHOME, SIN.",31,8,39,0,3,0,
07-jul-16,D.F.,"GUSTAVO A. MADERO, D.F.",13,26,39,0,1,1097,
21-jul-16,D.F.,"GUSTAVO A. MADERO, D.F.",26,13,39,0,3,0,
20-oct-21,CD. MÉX.,"IZTACALCO, CD. MÉX.",30,9,39,0,6,3732,
14-feb-13,MEX.,"TOLUCA, MEX.",34,4,38,15,0,121,
17-feb-13,MEX.,"NAUCALPAN DE JUAREZ, MEX.",30,8,38,0,1,16,
07-mar-13,AGS.,"AGS., AGS.",30,8,38,12,0,852,
17-mar-13,MEX.,"LA PAZ, MEX.",31,7,38,0,7,0,
12-abr-13,SIN.,"AHOME, SIN.",29,9,38,0,12,0,
04-ago-13,N.L.,"MONTERREY, N.L.",28,10,38,9,2,1647,
17-oct-13,D.F.,"COYOACAN, D.F.",22,16,38,7,0,280,
29-nov-13,N.L.,"MONTERREY, N.L.",27,11,38,21,0,1777,
01-abr-14,MEX.,"ATIZAPAN, MEX.",33,5,38,0,3,560,
09-may-14,MEX.,"TEXCOCO, MEX.",32,6,38,0,0,0,
20-may-14,D.F.,"COYOACAN, D.F.",30,8,38,0,7,150,
19-jun-14,D.F.,"VENUSTIANO CARRANZA, D.F.",25,13,38,0,0,375,
21-jul-14,D.F.,"GUSTAVO A. MADERO, D.F.",38,0,38,0,11,200,
18-sep-14,TAMPS.,"MATAMOROS, TAMPS.",25,13,38,76,3,366,
27-ago-15,D.F.,"TLAHUAC, D.F.",34,4,38,0,1,0,
31-ago-15,D.F.,"TLALPAN, D.F.",36,2,38,0,11,49,
18-dic-15,D.F.,"CUAUHTEMOC, D.F.",17,21,38,0,1,64,
14-dic-17,GTO.,"LEON, GTO.",25,13,38,0,3,0,
29-ene-19,CD. MÉX.,"GUSTAVO A. MADERO, CD. MÉX.",29,9,38,0,1,8468,
21-ene-13,D.F.,"TLAHUAC, D.F.",28,9,37,0,9,50,
05-feb-13,D.F.,"MIGUEL HGO., D.F.",29,8,37,0,3,0,
22-feb-13,D.F.,"VENUSTIANO CARRANZA, D.F.",30,7,37,0,0,250,
28-feb-13,MEX.,"CHALCO, MEX.",28,9,37,3,1,302,
06-abr-13,MICH.,"MORELIA, MICH.",25,12,37,0,2,0,
18-may-13,CHIH.,"CHIH., CHIH.",3,34,37,0,2,116,
20-jul-13,N.L.,"MONTERREY, N.L.",28,9,37,13,1,2129,
22-dic-13,D.F.,"CUAUHTEMOC, D.F.",36,1,37,3,1,30,
09-may-14,D.F.,"TLALPAN, D.F.",32,5,37,0,20,265,
15-may-14,D.F.,"COYOACAN, D.F.",26,11,37,0,9,120,
12-jul-14,CHIH.,"JUÁREZ, CHIH.",26,11,37,0,0,0,
21-ago-14,D.F.,"IZTAPALAPA, D.F.",22,15,37,0,7,150,
17-oct-14,D.F.,"GUSTAVO A. MADERO, D.F.",37,0,37,0,0,70,
12-nov-14,D.F.,"AZCAPOTZALCO, D.F.",27,10,37,0,0,90,
16-dic-14,D.F.,"CUAUHTEMOC, D.F.",34,3,37,0,0,150,
12-feb-15,D.F.,"IZTAPALAPA, D.F.",25,12,37,0,0,1000,
17-feb-15,D.F.,"IZTAPALAPA, D.F.",24,13,37,0,0,200,
02-mar-15,D.F.,"IZTAPALAPA, D.F.",28,9,37,0,0,70,
04-sep-15,D.F.,"TLALPAN, D.F.",34,3,37,0,5,0,
20-ene-16,D.F.,"COYOACAN, D.F.",24,13,37,0,7,25,
21-jun-16,SIN.,"AHOME, SIN.",28,9,37,0,5,0,
02-ago-16,D.F.,"TLALPAN, D.F.",22,15,37,0,1,67,
05-ago-16,D.F.,"TLALPAN, D.F.",20,17,37,0,0,686,
05-sep-16,CHIS.,"SAN CRISTOBAL DE LAS CASAS, CHIS.",5,32,37,2,0,0,
02-may-19,CHIH.,"JUÁREZ, CHIH.",15,22,37,37,0,561,
02-mar-13,MEX.,"CHALCO, MEX.",31,5,36,1,0,114,
02-abr-13,MICH.,"MORELIA, MICH.",11,25,36,0,0,0,
05-abr-13,MICH.,"ZAMORA, MICH.",24,12,36,0,0,0,
10-jul-13,MEX.,"NAUCALPAN DE JUAREZ, MEX.",2,34,36,2,0,62,
25-jul-13,D.F.,"GUSTAVO A. MADERO, D.F.",30,6,36,2,2,100,
25-jul-13,N.L.,"MONTERREY, N.L.",21,15,36,21,0,2560,
28-mar-14,D.F.,"IZTAPALAPA, D.F.",35,1,36,0,0,12,
24-abr-14,DGO.,"DGO., DGO.",29,7,36,0,4,0,
30-abr-14,D.F.,"XOCHIMILCO, D.F.",32,4,36,0,0,50,
20-jun-14,D.F.,"VENUSTIANO CARRANZA, D.F.",27,9,36,0,1,150,
26-sep-14,TAMPS.,"MATAMOROS, TAMPS.",24,12,36,0,0,0,
15-ago-15,MEX.,"TOLUCA, MEX.",27,9,36,3,0,0,
19-ago-15,D.F.,"TLAHUAC, D.F.",34,2,36,0,1,0,
07-sep-15,D.F.,"TLALPAN, D.F.",34,2,36,0,7,0,
16-jun-16,D.F.,"VENUSTIANO CARRANZA, D.F.",18,18,36,182,8,504,
22-jun-16,SIN.,"AHOME, SIN.",23,13,36,0,5,0,
28-jun-16,SIN.,"AHOME, SIN.",31,5,36,0,4,0,
06-jul-16,D.F.,"GUSTAVO A. MADERO, D.F.",23,13,36,0,1,603,
08-ago-16,D.F.,"TLALPAN, D.F.",22,14,36,0,4,25,
19-oct-23,Michoacán,"URUAPAN, MICH.",6,30,36,30,0,0,
20-mar-13,MEX.,"CHICOLOAPAN, MEX.",28,7,35,0,1,0,
04-abr-13,MICH.,"MORELIA, MICH.",9,26,35,0,2,0,
16-abr-13,QRO.,"QUERETARO, QRO.",27,8,35,0,0,0,
17-may-13,D.F.,"ALVARO OBREGON, D.F.",22,13,35,0,1,150,
24-may-13,D.F.,"TLALPAN, D.F.",32,3,35,0,0,298,
02-jun-13,MICH.,"URUAPAN, MICH.",23,12,35,9,0,0,
26-ago-13,SON.,"NOGALES, SON.",22,13,35,265,3,685,
25-nov-13,GTO.,"LEON, GTO.",25,10,35,0,0,0,
28-feb-14,D.F.,"MIGUEL HGO., D.F.",27,8,35,2,0,350,
06-jun-14,D.F.,"CUAJIMALPA DE MOR., D.F.",33,2,35,0,2,0,
11-jun-14,D.F.,"AZCAPOTZALCO, D.F.",29,6,35,0,2,210,
16-jun-14,D.F.,"VENUSTIANO CARRANZA, D.F.",30,5,35,0,1,200,
09-oct-14,D.F.,"TLALPAN, D.F.",30,5,35,0,0,0,
24-nov-14,GTO.,"CELAYA, GTO.",17,18,35,0,7,19,
13-dic-14,D.F.,"CUAUHTEMOC, D.F.",33,2,35,0,0,200,
17-ago-15,SIN.,"AHOME, SIN.",15,20,35,0,10,0,
20-ago-15,D.F.,"TLAHUAC, D.F.",28,7,35,0,1,0,
21-ago-15,D.F.,"TLAHUAC, D.F.",28,7,35,0,1,101,
18-sep-15,D.F.,"CUAJIMALPA DE MOR., D.F.",30,5,35,0,0,278,
20-jun-16,D.F.,"BENITO JUAREZ, D.F.",12,23,35,90,12,96,
24-jun-16,D.F.,"BENITO JUAREZ, D.F.",21,14,35,70,6,289,
11-ago-16,D.F.,"TLALPAN, D.F.",15,20,35,0,0,90,
16-feb-13,MEX.,"NAUCALPAN DE JUAREZ, MEX.",30,4,34,0,5,500,
28-feb-13,COAH.,"FRANCISCO I. MADERO, COAH.",28,6,34,0,0,0,
05-mar-13,MEX.,"CHIMALHUACAN, MEX.",29,5,34,0,2,459,
09-mar-13,MEX.,"CHIMALHUACAN, MEX.",32,2,34,0,1,193,
11-mar-13,DGO.,"DGO., DGO.",23,11,34,25,4,0,
02-abr-13,MEX.,"ACOLMAN, MEX.",31,3,34,5,1,113,
13-abr-13,MICH.,"MORELIA, MICH.",27,7,34,0,2,0,
23-abr-14,DGO.,"DGO., DGO.",28,6,34,3,3,0,
08-may-14,D.F.,"TLALPAN, D.F.",29,5,34,0,9,82,
08-jul-14,D.F.,"ALVARO OBREGON, D.F.",28,6,34,0,3,180,
15-jul-14,D.F.,"GUSTAVO A. MADERO, D.F.",31,3,34,0,4,200,
16-jul-14,D.F.,"VENUSTIANO CARRANZA, D.F.",32,2,34,0,8,50,
26-ago-14,D.F.,"IZTAPALAPA, D.F.",20,14,34,0,4,0,
05-nov-14,D.F.,"CUAJIMALPA DE MOR., D.F.",24,10,34,0,0,0,
24-mar-15,D.F.,"LA MAGDALENA CONTRERAS, D.F.",19,15,34,0,0,0,
01-sep-15,D.F.,"TLALPAN, D.F.",33,1,34,0,5,0,
03-sep-15,D.F.,"TLALPAN, D.F.",33,1,34,0,3,0,
27-jun-16,D.F.,"BENITO JUAREZ, D.F.",18,16,34,145,12,0,
27-jun-16,SIN.,"AHOME, SIN.",24,10,34,0,15,0,
14-jul-16,D.F.,"GUSTAVO A. MADERO, D.F.",17,17,34,0,0,981,
27-ago-16,D.F.,"MIGUEL HGO., D.F.",14,20,34,0,5,1071,
15-dic-17,GTO.,"LEON, GTO.",23,11,34,0,0,0,
04-nov-22,MÉX.,"CUAUTITLAN, MEX.",34,0,34,0,0,50,
05-nov-22,MÉX.,"CUAUTITLAN, MEX.",30,4,34,1,0,30,
16-feb-13,MEX.,"ECATEPEC DE MOR., MEX.",26,7,33,0,0,0,
13-mar-13,D.F.,"CUAJIMALPA DE MOR., D.F.",21,12,33,0,1,125,
03-abr-13,MICH.,"MORELIA, MICH.",26,7,33,0,1,0,
14-may-13,D.F.,"ALVARO OBREGON, D.F.",24,9,33,0,6,150,
24-jul-13,D.F.,"GUSTAVO A. MADERO, D.F.",30,3,33,0,5,150,
27-jul-13,N.L.,"MONTERREY, N.L.",21,12,33,11,0,1093,
06-sep-13,D.F.,"VENUSTIANO CARRANZA, D.F.",28,5,33,5,0,300,
02-oct-13,D.F.,"AZCAPOTZALCO, D.F.",23,10,33,4,6,100,
04-oct-13,D.F.,"AZCAPOTZALCO, D.F.",24,9,33,12,1,400,
09-oct-13,D.F.,"LA MAGDALENA CONTRERAS, D.F.",27,6,33,5,2,120,
06-nov-13,D.F.,"TLALPAN, D.F.",26,7,33,0,1,0,
13-mar-14,D.F.,"IZTACALCO, D.F.",27,6,33,0,2,120,
02-may-14,MEX.,"ECATEPEC DE MOR., MEX.",29,4,33,0,1,0,
21-may-14,D.F.,"COYOACAN, D.F.",23,10,33,0,2,20,
08-oct-14,D.F.,"TLALPAN, D.F.",33,0,33,0,3,0,
07-nov-14,SIN.,"AHOME, SIN.",23,10,33,0,0,0,
27-mar-15,D.F.,"LA MAGDALENA CONTRERAS, D.F.",22,11,33,0,1,600,
13-ago-15,SIN.,"AHOME, SIN.",27,6,33,0,0,0,
27-ago-15,SIN.,"AHOME, SIN.",26,7,33,0,4,0,
08-sep-15,D.F.,"TLALPAN, D.F.",31,2,33,0,1,0,
20-jun-16,SIN.,"AHOME, SIN.",17,16,33,0,7,0,
26-jul-16,D.F.,"GUSTAVO A. MADERO, D.F.",12,21,33,0,0,0,
01-dic-16,COAH.,"SALTILLO, COAH.",22,11,33,131,13,1460,
11-mar-20,CHIH.,"JUÁREZ, CHIH.",20,13,33,14,0,524,
08-mar-13,HGO.,"PACHUCA DE SOTO, HGO.",28,4,32,0,10,788,
08-mar-13,MEX.,"VALLE DE CHALCO SOLIDARIDAD, MEX.",26,6,32,0,1,200,
04-abr-13,MEX.,"ZINACANTEPEC, MEX.",15,17,32,0,1,2459,
12-abr-13,MICH.,"ZAMORA, MICH.",23,9,32,0,0,0,
09-jun-13,D.F.,"MILPA ALTA, D.F.",26,6,32,0,1,161,
23-jul-13,QRO.,"QUERETARO, QRO.",24,8,32,0,1,0,
28-jul-13,N.L.,"MONTERREY, N.L.",17,15,32,21,0,2261,
29-jul-13,N.L.,"MONTERREY, N.L.",24,8,32,24,0,3507,
25-oct-13,D.F.,"BENITO JUAREZ, D.F.",23,9,32,0,4,40,
29-nov-13,D.F.,"CUAJIMALPA DE MOR., D.F.",26,6,32,0,0,30,
22-abr-14,DGO.,"DGO., DGO.",26,6,32,39,3,0,
06-may-14,DGO.,"DGO., DGO.",29,3,32,11,2,0,
14-may-14,D.F.,"COYOACAN, D.F.",24,8,32,0,3,80,
16-may-14,MEX.,"ATLACOMULCO, MEX.",23,9,32,0,0,0,
04-jun-14,D.F.,"CUAJIMALPA DE MOR., D.F.",31,1,32,0,5,40,
26-jun-14,MEX.,"ECATEPEC DE MOR., MEX.",25,7,32,32,1,0,
19-sep-14,D.F.,"IZTACALCO, D.F.",30,2,32,1,3,0,
22-sep-14,D.F.,"MILPA ALTA, D.F.",28,4,32,0,2,29,
14-nov-14,SIN.,"AHOME, SIN.",20,12,32,0,2,0,
26-nov-14,D.F.,"VENUSTIANO CARRANZA, D.F.",29,3,32,0,0,80,
01-dic-14,GTO.,"CELAYA, GTO.",20,12,32,0,0,0,
05-dic-14,GTO.,"LEON, GTO.",23,9,32,0,1,0,
05-dic-14,TAMPS.,"MATAMOROS, TAMPS.",15,17,32,0,0,55,
23-sep-15,SIN.,"CHOIX, SIN.",24,8,32,0,0,0,
30-sep-15,SIN.,"EL FUERTE, SIN.",21,11,32,0,4,0,
13-oct-15,SIN.,"EL FUERTE, SIN.",25,7,32,0,2,0,
28-oct-15,SIN.,"GUASAVE, SIN.",27,5,32,0,0,0,
04-dic-15,D.F.,"CUAUHTEMOC, D.F.",15,17,32,0,3,203,
30-jun-16,D.F.,"BENITO JUAREZ, D.F.",21,11,32,243,0,620,
05-jul-16,D.F.,"GUSTAVO A. MADERO, D.F.",10,22,32,203,5,0,
01-ago-16,D.F.,"TLALPAN, D.F.",19,13,32,0,1,0,
31-ago-16,D.F.,"AZCAPOTZALCO, D.F.",18,14,32,0,1,0,
01-jun-23,Sinaloa,"EL FUERTE, SIN.",22,10,32,0,0,0,
31-ene-13,B.C.,"TIJUANA, B.C.",4,27,31,0,0,0,
08-mar-13,AGS.,"AGS., AGS.",25,6,31,11,0,855,
08-mar-13,MEX.,"CHIMALHUACAN, MEX.",27,4,31,0,5,22,
08-mar-13,COAH.,"MÚZQUIZ, COAH.",17,14,31,4,0,152,
12-mar-13,MEX.,"LA PAZ, MEX.",27,4,31,0,2,100,
15-abr-13,D.F.,"LA MAGDALENA CONTRERAS, D.F.",21,10,31,0,1,150,
15-may-13,D.F.,"ALVARO OBREGON, D.F.",23,8,31,0,2,150,
08-nov-13,D.F.,"TLALPAN, D.F.",21,10,31,0,0,400,
27-nov-13,D.F.,"CUAJIMALPA DE MOR., D.F.",24,7,31,0,0,70,
28-nov-13,N.L.,"MONTERREY, N.L.",25,6,31,11,0,2697,
27-mar-14,MEX.,"TECAMAC, MEX.",25,6,31,0,1,0,
03-abr-14,MEX.,"ATIZAPAN DE ZARAGOZA, MEX.",22,9,31,7,0,709,
30-abr-14,SIN.,"AHOME, SIN.",28,3,31,0,8,0,
07-may-14,D.F.,"TLALPAN, D.F.",25,6,31,0,4,0,
08-may-14,DGO.,"DGO., DGO.",23,8,31,34,1,0,
04-jul-14,D.F.,"LA MAGDALENA CONTRERAS, D.F.",14,17,31,0,0,700,
26-ago-14,NAY.,"IXTLAN DEL RIO, NAY.",15,16,31,0,0,27,
27-ago-14,D.F.,"IZTAPALAPA, D.F.",19,12,31,0,14,600,
09-sep-14,D.F.,"IZTACALCO, D.F.",31,0,31,0,5,0,
03-oct-14,D.F.,"XOCHIMILCO, D.F.",29,2,31,0,3,0,
08-dic-14,D.F.,"CUAUHTEMOC, D.F.",25,6,31,0,0,0,
19-ago-15,SIN.,"AHOME, SIN.",26,5,31,0,2,0,
24-ago-15,D.F.,"TLAHUAC, D.F.",30,1,31,0,0,0,
24-ago-15,SIN.,"AHOME, SIN.",18,13,31,0,6,0,
23-jun-16,SIN.,"AHOME, SIN.",20,11,31,0,6,0,
29-jun-16,SIN.,"AHOME, SIN.",30,1,31,0,6,0,
15-jul-16,D.F.,"GUSTAVO A. MADERO, D.F.",16,15,31,0,1,215,
17-ago-16,D.F.,"MIGUEL HGO., D.F.",17,14,31,0,0,45,
24-ago-16,D.F.,"MIGUEL HGO., D.F.",11,20,31,0,0,407,
14-feb-19,CD. MÉX.,"IZTAPALAPA, CD. MÉX.",26,5,31,0,5,31475,
14-oct-22,MÉX.,"VALLE DE CHALCO SOLIDARIDAD, MEX.",31,0,31,0,4,140,
15-jun-23,México,"NEXTLALPAN, MEX., MEX.",31,0,31,0,0,0,
12-feb-13,MEX.,"TOLUCA, MEX.",25,5,30,5,0,37,
18-feb-13,MEX.,"CUAUTITLAN IZCALLI, MEX.",27,3,30,4,1,677,
20-feb-13,MEX.,"ATIZAPAN DE ZARAGOZA, MEX.",24,6,30,0,3,150,
21-feb-13,MEX.,"CUAUTITLAN IZCALLI, MEX.",29,1,30,0,6,721,
13-abr-13,QRO.,"QUERETARO, QRO.",12,18,30,0,2,0,
21-may-13,D.F.,"TLALPAN, D.F.",24,6,30,0,7,1453,
29-may-13,D.F.,"MILPA ALTA, D.F.",16,14,30,0,0,0,
21-ago-13,D.F.,"IZTAPALAPA, D.F.",24,6,30,0,1,60,
27-ago-13,D.F.,"IZTAPALAPA, D.F.",15,15,30,0,2,70,
16-oct-13,D.F.,"COYOACAN, D.F.",20,10,30,4,0,90,
04-abr-14,D.F.,"TLAHUAC, D.F.",27,3,30,0,1,65,
12-abr-14,DGO.,"DGO., DGO.",22,8,30,3,7,0,
29-abr-14,MEX.,"ECATEPEC DE MOR., MEX.",30,0,30,0,5,0,
10-may-14,MEX.,"TEXCOCO, MEX.",21,9,30,0,0,0,
21-may-14,SIN.,"EL FUERTE, SIN.",6,24,30,0,0,0,
28-may-14,D.F.,"BENITO JUAREZ, D.F.",22,8,30,0,2,35,
20-jun-14,MEX.,"TECAMAC, MEX.",19,11,30,0,1,0,
24-jun-14,D.F.,"VENUSTIANO CARRANZA, D.F.",27,3,30,0,2,120,
18-sep-14,OAX.,"OAX. DE JUAREZ, OAX.",21,9,30,0,3,5878,
21-oct-14,D.F.,"COYOACAN, D.F.",28,2,30,0,1,100,
31-oct-14,CHIS.,"TUXTLA GUTIÉRREZ, CHIS.",21,9,30,9,5,949,
23-mar-15,TAMPS.,"NUEVO LAREDO, TAMPS.",15,15,30,3,0,44,
07-mar-16,D.F.,"TLAHUAC, D.F.",8,22,30,2,5,0,
15-abr-16,D.F.,"IZTACALCO, D.F.",11,19,30,342,0,736,
09-ago-16,D.F.,"TLALPAN, D.F.",19,11,30,0,0,0,
19-dic-17,GTO.,"LEON, GTO.",23,7,30,0,1,0,
12-abr-19,CD. MÉX.,"MIGUEL HGO., CD. MÉX.",24,6,30,0,0,1014,
26-abr-19,CHIH.,"JUÁREZ, CHIH.",21,9,30,12,0,590,
29-may-19,CD. MÉX.,"VENUSTIANO CARRANZA, CD. MÉX.",28,2,30,0,0,2047,
23-jun-23,México,"NICOLAS ROMERO, MEX.",30,0,30,0,0,0,
22-feb-13,MEX.,"CUAUTITLAN IZCALLI, MEX.",22,7,29,0,1,306,
27-feb-13,MEX.,"IXTAPALUCA, MEX.",23,6,29,3,2,169,
02-mar-13,N.L.,"GUADALUPE, N.L.",8,21,29,5,0,1381,
03-abr-13,SIN.,"AHOME, SIN.",19,10,29,0,0,0,
18-abr-13,D.F.,"LA MAGDALENA CONTRERAS, D.F.",18,11,29,0,8,100,
28-may-13,D.F.,"MILPA ALTA, D.F.",23,6,29,0,0,0,
26-jun-13,PUE.,"PUE., PUE.",27,2,29,21,2,1597,
03-ago-13,N.L.,"MONTERREY, N.L.",19,10,29,30,1,1201,
02-sep-13,D.F.,"VENUSTIANO CARRANZA, D.F.",12,17,29,0,0,350,
24-sep-13,D.F.,"XOCHIMILCO, D.F.",19,10,29,7,1,200,
30-oct-13,D.F.,"ALVARO OBREGON, D.F.",26,3,29,19,1,970,
27-mar-14,AGS.,"AGS., AGS.",28,1,29,7,0,208,
28-mar-14,MEX.,"TECAMAC, MEX.",25,4,29,0,3,0,
29-mar-14,MEX.,"TECAMAC, MEX.",22,7,29,0,0,0,
12-abr-14,MEX.,"TLALNEPANTLA DE BAZ, MEX.",21,8,29,10,0,366,
29-abr-14,SIN.,"AHOME, SIN.",23,6,29,0,6,0,
16-may-14,DGO.,"DGO., DGO.",23,6,29,4,1,0,
10-jun-14,D.F.,"AZCAPOTZALCO, D.F.",29,0,29,0,0,128,
27-jun-14,MEX.,"TLALNEPANTLA DE BAZ, MEX.",21,8,29,0,0,0,
28-jun-14,MEX.,"TLALNEPANTLA DE BAZ, MEX.",21,8,29,0,0,0,
03-jul-14,D.F.,"LA MAGDALENA CONTRERAS, D.F.",18,11,29,0,6,70,
28-oct-14,SIN.,"AHOME, SIN.",21,8,29,0,1,0,
02-nov-14,CHIS.,"COMITAN DE DOMÍNGUEZ, CHIS.",26,3,29,0,0,172,
11-nov-14,D.F.,"AZCAPOTZALCO, D.F.",29,0,29,0,3,0,
11-feb-15,D.F.,"IZTAPALAPA, D.F.",23,6,29,0,0,2000,
16-feb-15,D.F.,"IZTAPALAPA, D.F.",21,8,29,0,0,250,
15-jun-16,D.F.,"VENUSTIANO CARRANZA, D.F.",14,15,29,217,5,1403,
29-sep-16,SIN.,"SIN., SIN.",22,7,29,0,8,0,
30-nov-23,Guanajuato,"LEON, GTO.",17,12,29,39,0,9,
17-feb-13,MEX.,"TOLUCA, MEX.",20,8,28,8,0,191,
22-feb-13,MEX.,"TULTITLAN, MEX.",21,7,28,4,3,292,
24-feb-13,MEX.,"CUAUTITLAN IZCALLI, MEX.",23,5,28,0,2,256,
03-mar-13,MEX.,"CHALCO, MEX.",24,4,28,1,0,137,
04-mar-13,MEX.,"CHIMALHUACAN, MEX.",20,8,28,2,6,465,
06-mar-13,MEX.,"CHIMALHUACAN, MEX.",18,10,28,0,0,191,
12-mar-13,D.F.,"CUAJIMALPA DE MOR., D.F.",25,3,28,0,1,176,
14-mar-13,D.F.,"CUAJIMALPA DE MOR., D.F.",18,10,28,0,2,150,
14-abr-13,QRO.,"QUERETARO, QRO.",20,8,28,0,2,0,
13-may-13,D.F.,"ALVARO OBREGON, D.F.",23,5,28,0,4,168,
31-may-13,D.F.,"MILPA ALTA, D.F.",20,8,28,0,0,0,
10-oct-13,D.F.,"LA MAGDALENA CONTRERAS, D.F.",23,5,28,6,1,30,
15-oct-13,D.F.,"COYOACAN, D.F.",20,8,28,3,0,230,
01-dic-13,N.L.,"SAN NICOLAS DE LOS GARZA, N.L.",21,7,28,19,0,1415,
02-abr-14,MEX.,"ATIZAPAN, MEX.",23,5,28,0,3,412,
04-abr-14,MEX.,"ATIZAPAN, MEX.",22,6,28,12,0,185,
25-jun-14,D.F.,"VENUSTIANO CARRANZA, D.F.",24,4,28,0,6,0,
04-jul-14,TAMPS.,"MATAMOROS, TAMPS.",17,11,28,0,0,0,
09-jul-14,D.F.,"ALVARO OBREGON, D.F.",25,3,28,0,9,100,
14-jul-14,D.F.,"GUSTAVO A. MADERO, D.F.",25,3,28,0,1,80,
13-oct-14,D.F.,"GUSTAVO A. MADERO, D.F.",27,1,28,0,2,0,
15-oct-14,GTO.,"SALAMANCA, GTO.",16,12,28,0,0,0,
30-oct-14,SIN.,"AHOME, SIN.",22,6,28,0,0,0,
21-nov-14,D.F.,"LA MAGDALENA CONTRERAS, D.F.",22,6,28,0,0,60,
28-jun-16,D.F.,"BENITO JUAREZ, D.F.",14,14,28,242,7,398,
04-jul-16,D.F.,"GUSTAVO A. MADERO, D.F.",9,19,28,107,1,115,
30-ago-16,D.F.,"AZCAPOTZALCO, D.F.",13,15,28,0,2,192,
06-sep-16,D.F.,"AZCAPOTZALCO, D.F.",11,17,28,0,0,1847,
14-nov-16,D.F.,"LA MAGDALENA CONTRERAS, D.F.",21,7,28,0,4,0,
17-nov-16,D.F.,"LA MAGDALENA CONTRERAS, D.F.",18,10,28,0,0,50,
28-ene-19,CD. MÉX.,"GUSTAVO A. MADERO, CD. MÉX.",20,8,28,0,5,25872,
11-feb-13,MEX.,"ECATEPEC DE MOR., MEX.",22,5,27,0,3,82,
07-mar-13,MEX.,"TEXCOCO, MEX.",17,10,27,0,0,203,
07-mar-13,MEX.,"VALLE DE CHALCO SOLIDARIDAD, MEX.",21,6,27,0,1,65,
29-mar-13,DGO.,"DGO., DGO.",22,5,27,25,6,0,
16-abr-13,D.F.,"LA MAGDALENA CONTRERAS, D.F.",20,7,27,0,1,126,
27-jun-13,GTO.,"LEON, GTO.",8,19,27,0,0,0,
23-jul-13,N.L.,"MONTERREY, N.L.",19,8,27,60,0,1350,
25-jul-13,QRO.,"QUERETARO, QRO.",21,6,27,0,4,0,
29-ago-13,D.F.,"IZTAPALAPA, D.F.",22,5,27,3,2,120,
11-sep-13,D.F.,"IZTACALCO, D.F.",22,5,27,2,1,80,
07-nov-13,D.F.,"TLALPAN, D.F.",24,3,27,0,2,350,
24-nov-13,N.L.,"MONTERREY, N.L.",17,10,27,81,0,1114,
02-abr-14,D.F.,"TLAHUAC, D.F.",24,3,27,0,13,158,
03-abr-14,D.F.,"TLAHUAC, D.F.",22,5,27,0,2,55,
06-may-14,D.F.,"TLALPAN, D.F.",24,3,27,0,5,0,
09-may-14,SIN.,"AHOME, SIN.",24,3,27,0,14,0,
30-may-14,SIN.,"EL FUERTE, SIN.",7,20,27,0,3,0,
02-jun-14,D.F.,"CUAJIMALPA DE MOR., D.F.",21,6,27,0,0,0,
02-jul-14,D.F.,"LA MAGDALENA CONTRERAS, D.F.",26,1,27,0,0,100,
16-oct-14,GTO.,"SALAMANCA, GTO.",22,5,27,0,0,0,
04-sep-15,PUE.,"PUE., PUE.",24,3,27,5,0,654,
21-nov-15,D.F.,"CUAUHTEMOC, D.F.",13,14,27,0,3,3,
27-nov-15,D.F.,"CUAUHTEMOC, D.F.",12,15,27,0,3,240,
06-dic-15,D.F.,"CUAUHTEMOC, D.F.",10,17,27,0,3,450,
17-dic-15,D.F.,"CUAUHTEMOC, D.F.",12,15,27,0,3,16,
03-ago-16,D.F.,"TLALPAN, D.F.",22,5,27,0,3,1344,
27-sep-16,D.F.,"ALVARO OBREGON, D.F.",20,7,27,0,0,148,
04-oct-16,D.F.,"ALVARO OBREGON, D.F.",17,10,27,0,0,242,
16-oct-18,GTO.,"LEON, GTO.",19,8,27,0,0,0,
15-feb-19,CD. MÉX.,"IZTAPALAPA, CD. MÉX.",25,2,27,0,2,43635,
15-mar-19,CD. MÉX.,"BENITO JUAREZ, CD. MÉX.",25,2,27,0,0,2664,
23-jun-23,México,"TECAMAC, MEX.",27,0,27,0,0,233,
20-feb-13,MEX.,"TULTITLAN, MEX.",23,3,26,1,1,385,
05-mar-13,MEX.,"METEPEC, MEX.",19,7,26,7,0,286,
19-mar-13,D.F.,"XOCHIMILCO, D.F.",20,6,26,0,0,136,
18-may-13,B.C.,"TIJUANA, B.C.",2,24,26,0,0,0,
04-jul-13,GTO.,"LEON, GTO.",17,9,26,0,1,156,
19-jul-13,N.L.,"MONTERREY, N.L.",19,7,26,6,0,913,
23-jul-13,D.F.,"GUSTAVO A. MADERO, D.F.",21,5,26,0,0,830,
23-oct-13,D.F.,"BENITO JUAREZ, D.F.",15,11,26,3,1,120,
29-oct-13,D.F.,"ALVARO OBREGON, D.F.",20,6,26,3,6,480,
15-nov-13,GTO.,"IRAPUATO, GTO.",21,5,26,0,0,0,
10-ene-14,PUE.,"PUE., PUE.",24,2,26,21,0,948,
26-feb-14,D.F.,"MIGUEL HGO., D.F.",23,3,26,2,0,400,
14-mar-14,D.F.,"IZTACALCO, D.F.",22,4,26,3,2,380,
01-abr-14,D.F.,"TLAHUAC, D.F.",22,4,26,1,2,8,
04-abr-14,DGO.,"DGO., DGO.",23,3,26,0,0,0,
02-may-14,MEX.,"ALMOLOYA DE JUAREZ, MEX.",26,0,26,0,0,0,
09-may-14,DGO.,"DGO., DGO.",21,5,26,10,2,0,
12-may-14,DGO.,"DGO., DGO.",20,6,26,5,0,0,
13-may-14,D.F.,"COYOACAN, D.F.",24,2,26,0,5,50,
20-may-14,SIN.,"EL FUERTE, SIN.",6,20,26,0,2,0,
26-jun-14,MEX.,"TLALNEPANTLA DE BAZ, MEX.",22,4,26,2,0,72,
06-oct-14,D.F.,"TLALPAN, D.F.",23,3,26,0,1,20,
15-oct-14,D.F.,"GUSTAVO A. MADERO, D.F.",25,1,26,0,0,0,
21-oct-14,CHIS.,"TUXTLA GUTIÉRREZ, CHIS.",18,8,26,17,0,1724,
30-oct-14,SIN.,"EL FUERTE, SIN.",9,17,26,0,0,0,
30-oct-14,D.F.,"BENITO JUAREZ, D.F.",20,6,26,0,0,25,
13-feb-15,TAMPS.,"MATAMOROS, TAMPS.",14,12,26,6,0,0,
01-sep-15,SIN.,"CHOIX, SIN.",21,5,26,0,2,0,
09-sep-15,SIN.,"CHOIX, SIN.",21,5,26,0,5,0,
11-nov-15,COAH.,"MONCLOVA, COAH.",25,1,26,0,0,6329,
12-nov-15,D.F.,"CUAUHTEMOC, D.F.",14,12,26,0,1,38,
13-nov-15,COAH.,"SABINAS, COAH.",25,1,26,0,0,0,
17-nov-15,COAH.,"PIEDRAS NEGRAS, COAH.",25,1,26,0,0,0,
17-nov-15,COAH.,"ACUÑA, COAH.",25,1,26,0,0,0,
24-nov-15,D.F.,"CUAUHTEMOC, D.F.",16,10,26,0,5,155,
01-sep-16,D.F.,"AZCAPOTZALCO, D.F.",13,13,26,0,0,85,
06-ago-18,D.F.,"GUSTAVO A. MADERO, D.F.",21,5,26,0,1,893,
01-abr-23,México,"CUAUTITLAN IZCALLI, MEX.",26,0,26,0,0,0,
26-ene-13,QRO.,"QUERETARO, QRO.",15,10,25,0,0,0,
23-feb-13,MEX.,"TULTITLAN, MEX.",18,7,25,2,2,379,
25-feb-13,MEX.,"CHALCO, MEX.",21,4,25,5,3,344,
01-mar-13,MEX.,"CHALCO, MEX.",22,3,25,1,2,48,
04-mar-13,DGO.,"DGO., DGO.",18,7,25,9,1,0,
06-mar-13,MEX.,"TEXCOCO, MEX.",21,4,25,0,1,705,
10-mar-13,MEX.,"TEXCOCO, MEX.",23,2,25,0,0,6,
20-mar-13,MEX.,"TULTEPEC, MEX.",19,6,25,0,2,209,
01-abr-13,MEX.,"ACOLMAN, MEX.",21,4,25,4,4,34,
06-abr-13,N.L.,"LOS ALDAMAS, N.L.",5,20,25,41,0,150,
11-abr-13,SIN.,"AHOME, SIN.",14,11,25,0,8,0,
19-abr-13,MEX.,"TENANGO DEL VALLE, MEX.",12,13,25,1,1,0,
07-may-13,AGS.,"CALVILLO, AGS.",19,6,25,0,0,50,
27-jun-13,GTO.,"LEON, GTO.",20,5,25,0,0,0,
23-ago-13,D.F.,"IZTAPALAPA, D.F.",14,11,25,4,5,70,
26-mar-14,D.F.,"IZTAPALAPA, D.F.",20,5,25,0,5,350,
29-mar-14,MEX.,"CHICOLOAPAN, MEX.",16,9,25,0,1,111,
03-abr-14,QRO.,"QUERETARO, QRO.",16,9,25,0,3,0,
24-abr-14,SIN.,"AHOME, SIN.",22,3,25,0,8,0,
28-abr-14,SIN.,"AHOME, SIN.",17,8,25,0,2,0,
05-may-14,DGO.,"DGO., DGO.",21,4,25,27,0,0,
16-may-14,D.F.,"COYOACAN, D.F.",22,3,25,0,9,30,
16-may-14,SIN.,"EL FUERTE, SIN.",16,9,25,0,4,0,
30-may-14,MEX.,"LA PAZ, MEX.",18,7,25,0,5,199,
03-jun-14,D.F.,"CUAJIMALPA DE MOR., D.F.",24,1,25,0,6,0,
06-jun-14,SIN.,"CULIACAN, SIN.",19,6,25,0,2,0,
12-jun-14,D.F.,"AZCAPOTZALCO, D.F.",23,2,25,0,5,814,
26-ago-14,COAH.,"SALTILLO, COAH.",23,2,25,0,3,2470,
02-sep-14,D.F.,"IZTAPALAPA, D.F.",24,1,25,0,0,0,
23-sep-14,D.F.,"MILPA ALTA, D.F.",23,2,25,0,5,32,
02-oct-14,D.F.,"XOCHIMILCO, D.F.",22,3,25,0,0,0,
29-oct-14,SIN.,"AHOME, SIN.",17,8,25,0,0,0,
30-oct-14,CHIS.,"TUXTLA GUTIÉRREZ, CHIS.",13,12,25,5,6,2454,
31-oct-14,CHIS.,"TAPACHULA, CHIS.",15,10,25,22,0,1234,
03-nov-14,SIN.,"AHOME, SIN.",14,11,25,0,0,0,
11-ago-15,SIN.,"AHOME, SIN.",10,15,25,0,0,0,
18-ago-15,D.F.,"TLAHUAC, D.F.",24,1,25,0,3,0,
25-ago-15,SIN.,"AHOME, SIN.",18,7,25,0,6,0,
23-oct-15,SIN.,"GUASAVE, SIN.",17,8,25,0,68,0,
09-nov-15,SIN.,"SIN., SIN.",19,6,25,0,4,0,
25-nov-15,D.F.,"CUAUHTEMOC, D.F.",14,11,25,0,6,52,
04-dic-15,COAH.,"SALTILLO, COAH.",20,5,25,5,0,793,
05-dic-15,D.F.,"CUAUHTEMOC, D.F.",12,13,25,0,4,1261,
14-ene-16,D.F.,"CUAUHTEMOC, D.F.",16,9,25,0,2,25,
18-ene-16,D.F.,"COYOACAN, D.F.",20,5,25,0,1,0,
25-ago-16,D.F.,"MIGUEL HGO., D.F.",14,11,25,0,2,100,
27-oct-16,D.F.,"IZTACALCO, D.F.",22,3,25,0,0,0,
05-oct-18,GTO.,"LEON, GTO.",12,13,25,0,0,0,
17-oct-18,GTO.,"LEON, GTO.",21,4,25,0,1,0,
07-dic-18,SIN.,"MAZATLAN, SIN.",23,2,25,0,1,0,
16-jun-23,Guanajuato,"LEON, GTO.",17,8,25,7,0,351,
10-jun-24,Michoacán,"APATZINGAN, MICH.",10,15,25,99,0,121,
29-ene-13,D.F.,"TLAHUAC, D.F.",14,10,24,0,0,20,
30-ene-13,D.F.,"TLAHUAC, D.F.",19,5,24,0,2,10,
12-feb-13,D.F.,"MIGUEL HGO., D.F.",17,7,24,0,0,120,
24-feb-13,MEX.,"ATIZAPAN DE ZARAGOZA, MEX.",19,5,24,0,0,400,
28-feb-13,MEX.,"IXTAPALUCA, MEX.",17,7,24,5,1,0,
03-mar-13,MEX.,"COACALCO DE BERRIOZABAL, MEX.",16,8,24,6,2,654,
05-mar-13,MEX.,"TEXCOCO, MEX.",18,6,24,5,0,690,
09-mar-13,MEX.,"VALLE DE CHALCO SOLIDARIDAD, MEX.",15,9,24,0,0,97,
22-mar-13,MEX.,"CHICOLOAPAN, MEX.",21,3,24,0,2,0,
06-abr-13,COAH.,"ACUÑA, COAH.",6,18,24,7,0,326,
17-abr-13,QRO.,"QUERETARO, QRO.",19,5,24,0,1,0,
13-jun-13,MEX.,"NAUCALPAN DE JUAREZ, MEX.",15,9,24,18,2,435,
30-jun-13,GTO.,"GTO., GTO.",20,4,24,0,0,74,
24-jul-13,QRO.,"QUERETARO, QRO.",15,9,24,0,1,0,
22-ago-13,D.F.,"IZTAPALAPA, D.F.",17,7,24,3,0,120,
26-ago-13,D.F.,"IZTAPALAPA, D.F.",16,8,24,3,1,40,
09-sep-13,D.F.,"IZTACALCO, D.F.",19,5,24,4,4,95,
26-nov-13,N.L.,"MONTERREY, N.L.",15,9,24,6,0,2688,
30-nov-13,N.L.,"MONTERREY, N.L.",12,12,24,89,0,2323,
04-abr-14,QRO.,"QUERETARO, QRO.",14,10,24,0,1,0,
15-may-14,MEX.,"ATLACOMULCO, MEX.",18,6,24,0,0,0,
17-may-14,MEX.,"ATLACOMULCO, MEX.",14,10,24,0,1,0,
22-may-14,SIN.,"EL FUERTE, SIN.",12,12,24,0,0,0,
26-may-14,D.F.,"BENITO JUAREZ, D.F.",16,8,24,0,1,45,
27-may-14,MEX.,"LA PAZ, MEX.",20,4,24,0,3,0,
09-jun-14,D.F.,"AZCAPOTZALCO, D.F.",20,4,24,0,1,0,
23-jun-14,D.F.,"VENUSTIANO CARRANZA, D.F.",22,2,24,0,0,50,
25-jun-14,MEX.,"ECATEPEC DE MOR., MEX.",16,8,24,0,8,0,
20-ago-14,D.F.,"IZTAPALAPA, D.F.",17,7,24,0,0,200,
02-sep-14,MICH.,"MORELIA, MICH.",22,2,24,9,0,0,
08-sep-14,D.F.,"IZTACALCO, D.F.",19,5,24,0,0,0,
14-oct-14,D.F.,"GUSTAVO A. MADERO, D.F.",20,4,24,0,0,0,
14-oct-14,GTO.,"SALAMANCA, GTO.",14,10,24,0,1,30,
27-oct-14,SIN.,"AHOME, SIN.",19,5,24,0,0,0,
31-oct-14,SIN.,"AHOME, SIN.",21,3,24,0,5,0,
03-nov-14,SIN.,"EL FUERTE, SIN.",18,6,24,0,0,0,
04-nov-14,CHIS.,"COMITAN DE DOMÍNGUEZ, CHIS.",21,3,24,1,0,276,
06-nov-14,SIN.,"AHOME, SIN.",13,11,24,0,2,0,
07-nov-14,TAMPS.,"MATAMOROS, TAMPS.",18,6,24,0,0,0,
06-ago-15,D.F.,"MIGUEL HGO., D.F.",19,5,24,0,0,36,
16-oct-15,SIN.,"BADIRAGUATO, SIN.",16,8,24,0,7,0,
21-oct-15,SIN.,"GUASAVE, SIN.",17,7,24,0,12,0,
26-nov-15,D.F.,"CUAUHTEMOC, D.F.",11,13,24,0,3,64,
17-jun-16,D.F.,"VENUSTIANO CARRANZA, D.F.",9,15,24,0,17,455,
13-jul-16,D.F.,"GUSTAVO A. MADERO, D.F.",17,7,24,0,5,4461,
02-sep-16,D.F.,"AZCAPOTZALCO, D.F.",16,8,24,0,2,0,
26-sep-16,D.F.,"ALVARO OBREGON, D.F.",12,12,24,0,11,100,
28-sep-16,D.F.,"ALVARO OBREGON, D.F.",13,11,24,0,8,372,
30-sep-16,D.F.,"ALVARO OBREGON, D.F.",17,7,24,0,4,0,
07-oct-16,D.F.,"ALVARO OBREGON, D.F.",16,8,24,0,2,0,
13-oct-16,D.F.,"CUAJIMALPA DE MOR., D.F.",13,11,24,0,1,168,
14-oct-16,D.F.,"CUAJIMALPA DE MOR., D.F.",19,5,24,0,0,576,
21-oct-16,D.F.,"CUAJIMALPA DE MOR., D.F.",16,8,24,0,0,65,
28-oct-16,D.F.,"IZTACALCO, D.F.",20,4,24,0,0,45,
31-oct-16,D.F.,"IZTACALCO, D.F.",20,4,24,0,0,0,
11-nov-16,D.F.,"LA MAGDALENA CONTRERAS, D.F.",19,5,24,0,0,0,
19-ago-17,MEX.,"CHIMALHUACAN, MEX.",17,7,24,5,0,77,
27-mar-19,CD. MÉX.,"COYOACAN, CD. MÉX.",21,3,24,0,0,1199,
21-feb-20,SIN.,"SIN., SIN.",12,12,24,0,3,0,
12-oct-22,MÉX.,"VALLE DE CHALCO SOLIDARIDAD, MEX.",23,1,24,0,0,42,
21-oct-22,MÉX.,"LA PAZ, MEX.",24,0,24,0,81,233,
31-oct-22,MÉX.,"CUAUTITLAN, MEX.",22,2,24,0,0,0,
25-jun-24,Sinaloa,"SALVADOR ALVARADO, SIN.",23,1,24,0,0,897,
12-feb-13,MEX.,"NAUCALPAN DE JUAREZ, MEX.",17,6,23,0,4,0,
11-mar-13,MEX.,"LA PAZ, MEX.",20,3,23,0,2,0,
16-mar-13,MEX.,"CUAUTITLAN, MEX.",23,0,23,2,1,307,
16-mar-13,MEX.,"LA PAZ, MEX.",19,4,23,0,1,0,
20-mar-13,MEX.,"ZUMPANGO, MEX.",14,9,23,1,1,729,
05-abr-13,SIN.,"AHOME, SIN.",19,4,23,0,2,0,
08-abr-13,OAX.,"SANTA MARIA ATZOMPA, OAX.",13,10,23,0,0,180,
09-abr-13,OAX.,"SAN JUAN BAUTISTA TUXTEPEC, OAX.",16,7,23,5,0,0,
19-abr-13,QRO.,"QUERETARO, QRO.",18,5,23,0,3,0,
26-jul-13,N.L.,"MONTERREY, N.L.",19,4,23,12,0,2165,
30-jul-13,N.L.,"GUADALUPE, N.L.",14,9,23,1,0,718,
28-ago-13,D.F.,"IZTAPALAPA, D.F.",17,6,23,4,0,360,
27-sep-13,SIN.,"CULIACAN, SIN.",16,7,23,0,4,0,
31-oct-13,D.F.,"ALVARO OBREGON, D.F.",20,3,23,3,2,66,
05-nov-13,D.F.,"TLALPAN, D.F.",17,6,23,0,0,500,
02-dic-13,D.F.,"CUAUHTEMOC, D.F.",20,3,23,0,1,0,
03-dic-13,N.L.,"SAN NICOLAS DE LOS GARZA, N.L.",13,10,23,13,0,2321,
12-feb-14,D.F.,"CUAUHTEMOC, D.F.",18,5,23,0,0,138,
04-mar-14,D.F.,"MIGUEL HGO., D.F.",20,3,23,0,7,200,
20-mar-14,D.F.,"IZTACALCO, D.F.",14,9,23,2,0,12,
21-mar-14,N.L.,"SAN NICOLAS DE LOS GARZA, N.L.",22,1,23,6,0,93,
28-mar-14,MEX.,"CHICOLOAPAN, MEX.",19,4,23,0,1,46,
12-abr-14,MEX.,"CUAUTITLAN IZCALLI, MEX.",21,2,23,7,0,595,
08-may-14,SIN.,"AHOME, SIN.",16,7,23,0,10,0,
16-may-14,MEX.,"CHALCO, MEX.",22,1,23,3,1,0,
29-may-14,D.F.,"BENITO JUAREZ, D.F.",22,1,23,0,3,530,
14-jun-14,MEX.,"IXTLAHUACA, MEX.",12,11,23,0,2,0,
17-jun-14,D.F.,"VENUSTIANO CARRANZA, D.F.",22,1,23,0,2,120,
01-jul-14,D.F.,"LA MAGDALENA CONTRERAS, D.F.",23,0,23,0,0,450,
15-jul-14,CHIH.,"JUÁREZ, CHIH.",14,9,23,0,0,0,
26-ago-14,ZAC.,"FRESNILLO, ZAC.",16,7,23,0,0,0,
30-ago-14,TAMPS.,"REYNOSA, TAMPS.",10,13,23,0,0,520,
20-oct-14,D.F.,"COYOACAN, D.F.",18,5,23,0,0,130,
23-oct-14,CHIS.,"TUXTLA GUTIÉRREZ, CHIS.",20,3,23,9,0,787,
06-nov-14,D.F.,"CUAJIMALPA DE MOR., D.F.",16,7,23,0,0,0,
07-nov-14,CHIS.,"TUXTLA GUTIÉRREZ, CHIS.",15,8,23,1,0,1328,
13-nov-14,SIN.,"AHOME, SIN.",20,3,23,0,2,0,
26-mar-15,D.F.,"LA MAGDALENA CONTRERAS, D.F.",16,7,23,2,0,65,
11-ago-15,MEX.,"AMECAMECA, MEX.",11,12,23,0,8,22,
24-ago-15,B.C.,"TIJUANA, B.C.",15,8,23,0,0,0,
10-sep-15,SIN.,"CHOIX, SIN.",11,12,23,0,3,0,
21-oct-15,D.F.,"ALVARO OBREGON, D.F.",22,1,23,0,1,0,
29-nov-15,D.F.,"CUAUHTEMOC, D.F.",7,16,23,0,0,22,
13-ene-16,D.F.,"CUAUHTEMOC, D.F.",18,5,23,0,0,363,
17-mar-16,D.F.,"TLAHUAC, D.F.",10,13,23,0,0,50,
21-jun-16,D.F.,"BENITO JUAREZ, D.F.",12,11,23,0,10,3491,
29-jun-16,D.F.,"BENITO JUAREZ, D.F.",9,14,23,290,8,291,
01-jul-16,D.F.,"BENITO JUAREZ, D.F.",8,15,23,404,9,100,
07-sep-16,D.F.,"AZCAPOTZALCO, D.F.",16,7,23,0,0,100,
15-nov-16,D.F.,"LA MAGDALENA CONTRERAS, D.F.",19,4,23,0,10,0,
29-dic-16,B.C.,"TIJUANA, B.C.",9,14,23,0,5,0,
11-ago-17,CHIS.,"TAPACHULA, CHIS.",2,21,23,2,12,59,
29-nov-17,CHIH.,"JUÁREZ, CHIH.",6,17,23,10,0,523,
18-dic-17,GTO.,"LEON, GTO.",11,12,23,0,3,0,
12-feb-19,CD. MÉX.,"IZTAPALAPA, CD. MÉX.",19,4,23,0,0,36815,
27-ene-20,CD. MÉX.,"GUSTAVO A. MADERO, CD. MÉX.",19,4,23,0,2,878,
25-feb-21,CHIS.,"CHENALHÓ, CHIS.",1,22,23,0,0,0,
14-nov-22,GTO.,"LEON, GTO.",14,9,23,0,1,0,
15-nov-22,GTO.,"LEON, GTO.",15,8,23,0,1,0,
03-dic-22,CHIS.,"CHENALHÓ, CHIS.",5,18,23,0,0,122,
24-jun-24,Michoacán,"TACAMBARO, MICH.",4,19,23,17,0,272,
13-feb-13,TAMPS.,"MATAMOROS, TAMPS.",10,12,22,0,1,0,
21-feb-13,MEX.,"ATIZAPAN DE ZARAGOZA, MEX.",18,4,22,0,2,40,
23-feb-13,MEX.,"CUAUTITLAN IZCALLI, MEX.",22,0,22,10,3,784,
25-feb-13,MEX.,"COACALCO DE BERRIOZABAL, MEX.",15,7,22,4,0,108,
01-mar-13,N.L.,"SAN NICOLAS DE LOS GARZA, N.L.",10,12,22,3,0,361,
09-mar-13,N.L.,"MONTERREY, N.L.",19,3,22,13,0,7653,
13-mar-13,MEX.,"HUIXQUILUCAN, MEX.",21,1,22,11,0,234,
21-mar-13,MEX.,"ZUMPANGO, MEX.",18,4,22,2,16,59,
25-mar-13,D.F.,"XOCHIMILCO, D.F.",21,1,22,0,0,251,
04-abr-13,SIN.,"AHOME, SIN.",18,4,22,0,7,1,
12-abr-13,MICH.,"MORELIA, MICH.",18,4,22,0,0,0,
13-abr-13,MEX.,"TEOTIHUACAN, MEX.",12,10,22,1,2,260,
16-abr-13,MEX.,"TENANGO DEL VALLE, MEX.",19,3,22,1,0,0,
17-abr-13,D.F.,"LA MAGDALENA CONTRERAS, D.F.",18,4,22,0,1,40,
10-jun-13,MEX.,"NAUCALPAN DE JUAREZ, MEX.",18,4,22,1,0,43,
04-jul-13,CHIS.,"TAPACHULA, CHIS.",19,3,22,0,0,97,
31-jul-13,D.F.,"TLAHUAC, D.F.",13,9,22,0,0,42,
20-ago-13,D.F.,"IZTAPALAPA, D.F.",15,7,22,4,1,0,
20-ago-13,B.C.,"MEXICALI, B.C.",18,4,22,0,0,0,
10-sep-13,D.F.,"IZTACALCO, D.F.",19,3,22,3,0,350,
12-sep-13,D.F.,"IZTACALCO, D.F.",12,10,22,3,0,1210,
18-nov-13,GTO.,"IRAPUATO, GTO.",19,3,22,0,0,145,
21-nov-13,D.F.,"CUAUHTEMOC, D.F.",16,6,22,2,3,103,
06-dic-13,NAY.,"RUIZ, NAY.",14,8,22,0,0,0,
19-dic-13,D.F.,"CUAUHTEMOC, D.F.",21,1,22,1,1,7,
13-feb-14,D.F.,"CUAUHTEMOC, D.F.",19,3,22,0,0,390,
07-mar-14,D.F.,"MIGUEL HGO., D.F.",20,2,22,4,11,125,
25-mar-14,QRO.,"QUERETARO, QRO.",19,3,22,0,0,0,
08-abr-14,D.F.,"MILPA ALTA, D.F.",15,7,22,0,0,150,
10-abr-14,MEX.,"NAUCALPAN DE JUAREZ, MEX.",20,2,22,6,0,38,
26-abr-14,DGO.,"DGO., DGO.",17,5,22,3,6,0,
28-abr-14,MEX.,"NAUCALPAN DE JUAREZ, MEX.",18,4,22,11,0,593,
13-may-14,MEX.,"ATLACOMULCO, MEX.",17,5,22,0,0,0,
31-may-14,MEX.,"TOLUCA, MEX.",20,2,22,3,0,200,
19-jul-14,CHIH.,"JUÁREZ, CHIH.",14,8,22,0,0,0,
05-ago-14,SIN.,"MAZATLAN, SIN.",17,5,22,0,7,0,
29-ago-14,D.F.,"IZTAPALAPA, D.F.",18,4,22,0,2,0,
15-sep-14,D.F.,"TLAHUAC, D.F.",15,7,22,0,1,0,
27-oct-14,D.F.,"COYOACAN, D.F.",20,2,22,0,1,0,
27-oct-14,CHIS.,"TUXTLA GUTIÉRREZ, CHIS.",18,4,22,6,0,1711,
05-nov-14,SIN.,"AHOME, SIN.",14,8,22,0,1,0,
07-ago-15,D.F.,"MIGUEL HGO., D.F.",21,1,22,0,15,0,
17-ago-15,SIN.,"CULIACAN, SIN.",21,1,22,0,0,0,
31-ago-15,MEX.,"ATIZAPAN DE ZARAGOZA, MEX.",20,2,22,1,5,187,
30-oct-15,D.F.,"COYOACAN, D.F.",4,18,22,0,0,0,
01-dic-15,D.F.,"CUAUHTEMOC, D.F.",13,9,22,0,0,269,
18-jul-16,D.F.,"GUSTAVO A. MADERO, D.F.",14,8,22,0,0,145,
20-jul-16,D.F.,"GUSTAVO A. MADERO, D.F.",11,11,22,0,0,1331,
08-sep-16,D.F.,"AZCAPOTZALCO, D.F.",15,7,22,0,5,541,
17-oct-16,D.F.,"CUAJIMALPA DE MOR., D.F.",16,6,22,0,0,160,
19-oct-16,D.F.,"CUAJIMALPA DE MOR., D.F.",16,6,22,0,0,0,
03-nov-16,D.F.,"IZTACALCO, D.F.",20,2,22,0,3,0,
09-nov-16,D.F.,"LA MAGDALENA CONTRERAS, D.F.",15,7,22,0,0,0,
29-nov-17,CHIH.,"JUÁREZ, CHIH.",6,16,22,10,0,559,
13-dic-17,GTO.,"LEON, GTO.",13,9,22,0,2,0,
08-mar-18,CHIH.,"CHIH., CHIH.",14,8,22,0,0,137,
09-ago-18,D.F.,"GUSTAVO A. MADERO, D.F.",17,5,22,0,17,1180,
23-ago-18,CHIH.,"HGO. DEL PARRAL, CHIH.",19,3,22,9,1,1583,
23-ene-19,CD. MÉX.,"GUSTAVO A. MADERO, CD. MÉX.",20,2,22,0,1,22956,
13-feb-19,CD. MÉX.,"IZTAPALAPA, CD. MÉX.",18,4,22,0,3,47591,
20-feb-19,CD. MÉX.,"CUAUHTEMOC, CD. MÉX.",20,2,22,0,1,7743,
14-mar-19,CD. MÉX.,"BENITO JUAREZ, CD. MÉX.",21,1,22,0,0,91,
05-oct-22,MÉX.,"CHALCO, MEX.",22,0,22,0,0,33,
29-oct-22,MÉX.,"COYOTEPEC, MEX.",22,0,22,0,37,0,
12-nov-22,MÉX.,"SAN MARTIN DE LAS PIRAMIDES, MEX.",22,0,22,0,0,0,
27-jun-23,México,"METEPEC, MEX.",22,0,22,0,0,5,
10-jul-23,Michoacán,"ZAMORA, MICH.",8,14,22,35,0,104,
19-feb-13,MEX.,"TULTITLAN, MEX.",17,4,21,6,1,41,
20-feb-13,MEX.,"CUAUTITLAN IZCALLI, MEX.",17,4,21,4,0,257,
26-feb-13,MEX.,"IXTAPALUCA, MEX.",18,3,21,3,0,55,
01-mar-13,MEX.,"IXTAPALUCA, MEX.",18,3,21,3,0,116,
03-mar-13,N.L.,"GUADALUPE, N.L.",8,13,21,5,0,1227,
04-mar-13,GRO.,"ACAPULCO DE JUAREZ, GRO.",14,7,21,0,10,25,
06-mar-13,MEX.,"VALLE DE CHALCO SOLIDARIDAD, MEX.",19,2,21,3,5,105,
13-mar-13,MEX.,"LA PAZ, MEX.",16,5,21,0,0,89,
17-mar-13,MEX.,"CUAUTITLAN, MEX.",18,3,21,0,0,1005,
21-mar-13,MEX.,"CHICOLOAPAN, MEX.",16,5,21,0,0,0,
02-abr-13,MEX.,"ZINACANTEPEC, MEX.",18,3,21,0,0,100,
04-abr-13,MEX.,"HUEHUETOCA, MEX.",14,7,21,7,1,3,
04-abr-13,MEX.,"ACOLMAN, MEX.",18,3,21,3,1,69,
05-abr-13,MEX.,"HUEHUETOCA, MEX.",17,4,21,3,0,210,
05-abr-13,MEX.,"HUEHUETOCA, MEX.",21,0,21,2,0,413,
14-abr-13,MEX.,"TEJUPILCO, MEX.",15,6,21,7,0,14,
20-abr-13,MEX.,"AMECAMECA, MEX.",19,2,21,0,0,0,
22-abr-13,QRO.,"SAN JUAN DEL RIO, QRO.",13,8,21,0,2,0,
23-abr-13,QRO.,"PEDRO ESCOBEDO, QRO.",16,5,21,0,0,0,
25-abr-13,QRO.,"QUERETARO, QRO.",17,4,21,0,0,0,
28-jun-13,GTO.,"GTO., GTO.",18,3,21,0,0,269,
31-jul-13,N.L.,"GUADALUPE, N.L.",11,10,21,17,0,1028,
13-ago-13,COAH.,"RAMOS ARIZPE, COAH.",11,10,21,0,0,0,
12-oct-13,COAH.,"PIEDRAS NEGRAS, COAH.",9,12,21,2,0,738,
14-nov-13,GTO.,"IRAPUATO, GTO.",12,9,21,0,0,0,
28-nov-13,D.F.,"CUAJIMALPA DE MOR., D.F.",20,1,21,0,0,0,
02-dic-13,N.L.,"SAN NICOLAS DE LOS GARZA, N.L.",15,6,21,8,0,1917,
19-feb-14,D.F.,"CUAUHTEMOC, D.F.",16,5,21,0,1,158,
26-feb-14,CHIH.,"JUÁREZ, CHIH.",9,12,21,7,1,18,
28-feb-14,CHIH.,"JUÁREZ, CHIH.",6,15,21,0,0,213,
24-mar-14,QRO.,"QUERETARO, QRO.",9,12,21,0,0,0,
26-mar-14,MEX.,"TECAMAC, MEX.",14,7,21,0,0,0,
20-may-14,MEX.,"VALLE DE CHALCO SOLIDARIDAD, MEX.",19,2,21,2,0,51,
23-may-14,SIN.,"EL FUERTE, SIN.",10,11,21,0,3,0,
27-may-14,SIN.,"EL FUERTE, SIN.",4,17,21,0,0,0,
30-may-14,MEX.,"TOLUCA, MEX.",18,3,21,2,0,1000,
13-jun-14,D.F.,"AZCAPOTZALCO, D.F.",20,1,21,0,5,570,
27-jun-14,MEX.,"ECATEPEC DE MOR., MEX.",17,4,21,0,1,0,
20-jul-14,CHIH.,"JUÁREZ, CHIH.",15,6,21,0,0,0,
07-oct-14,D.F.,"TLALPAN, D.F.",21,0,21,0,3,0,
20-nov-14,D.F.,"LA MAGDALENA CONTRERAS, D.F.",14,7,21,0,1,0,
25-nov-14,D.F.,"VENUSTIANO CARRANZA, D.F.",17,4,21,0,0,0,
28-nov-14,SIN.,"MAZATLAN, SIN.",17,4,21,0,0,0,
02-mar-15,GTO.,"SALAMANCA, GTO.",17,4,21,0,0,0,
17-ago-15,D.F.,"TLAHUAC, D.F.",20,1,21,0,0,0,
19-oct-15,SIN.,"GUASAVE, SIN.",21,0,21,0,0,0,
23-oct-15,D.F.,"ALVARO OBREGON, D.F.",14,7,21,0,3,0,
23-nov-15,D.F.,"CUAUHTEMOC, D.F.",12,9,21,0,4,12,
13-jun-16,D.F.,"VENUSTIANO CARRANZA, D.F.",8,13,21,0,5,1805,
19-jul-16,D.F.,"GUSTAVO A. MADERO, D.F.",18,3,21,0,4,0,
22-ago-16,D.F.,"MIGUEL HGO., D.F.",9,12,21,0,0,0,
11-oct-16,D.F.,"CUAJIMALPA DE MOR., D.F.",10,11,21,0,2,618,
25-oct-16,D.F.,"IZTACALCO, D.F.",17,4,21,0,0,0,
26-oct-16,D.F.,"IZTACALCO, D.F.",12,9,21,0,0,0,
22-nov-16,D.F.,"COYOACAN, D.F.",16,5,21,0,0,0,
23-nov-16,D.F.,"COYOACAN, D.F.",16,5,21,0,6,0,
13-dic-16,GTO.,"LEON, GTO.",11,10,21,0,0,0,
09-feb-17,D.F.,"TLAHUAC, D.F.",19,2,21,0,0,120,
31-ago-18,D.F.,"AZCAPOTZALCO, D.F.",21,0,21,0,0,37,
11-feb-19,CD. MÉX.,"IZTAPALAPA, CD. MÉX.",19,2,21,0,3,48382,
28-mar-19,CD. MÉX.,"COYOACAN, CD. MÉX.",17,4,21,0,0,1918,
27-may-19,CD. MÉX.,"VENUSTIANO CARRANZA, CD. MÉX.",16,5,21,0,0,1168,
03-mar-20,CHIH.,"CHIH., CHIH.",14,7,21,0,2,432,
10-nov-22,MÉX.,"ZUMPANGO, MEX.",21,0,21,0,0,0,
13-nov-22,CHIS.,"CHENALHÓ, CHIS.",2,19,21,0,0,0,
24-nov-22,N.L.,"SANTA CATARINA, N.L.",15,6,21,11,0,564,
31-mar-23,México,"CUAUTITLAN IZCALLI, MEX.",21,0,21,0,0,44,
01-jun-23,Sinaloa,"CHOIX, SIN.",20,1,21,0,0,0,
23-jun-23,Guanajuato,"IRAPUATO, GTO.",16,5,21,142,0,430,
01-dic-23,Guanajuato,"LEON, GTO.",15,6,21,56,0,"2,376",
18-feb-13,MEX.,"ATIZAPAN DE ZARAGOZA, MEX.",16,4,20,0,2,330,
19-feb-13,MEX.,"ATIZAPAN DE ZARAGOZA, MEX.",17,3,20,0,3,40,
05-mar-13,MEX.,"VALLE DE CHALCO SOLIDARIDAD, MEX.",17,3,20,4,1,92,
10-mar-13,MEX.,"VALLE DE CHALCO SOLIDARIDAD, MEX.",17,3,20,0,1,65,
03-abr-13,MEX.,"ACOLMAN, MEX.",11,9,20,0,1,336,
12-abr-13,MEX.,"TEJUPILCO, MEX.",16,4,20,13,0,0,
17-abr-13,MICH.,"LA PIEDAD, MICH.",12,8,20,0,0,0,
21-abr-13,N.L.,"CARMEN, N.L.",10,10,20,15,0,50,
28-abr-13,MICH.,"LA PIEDAD, MICH.",20,0,20,0,0,0,
30-may-13,D.F.,"MILPA ALTA, D.F.",17,3,20,0,0,47,
11-jun-13,MEX.,"NAUCALPAN DE JUAREZ, MEX.",15,5,20,4,0,745,
17-jun-13,MICH.,"BUENAVISTA, MICH.",3,17,20,0,0,0,
30-jul-13,D.F.,"TLAHUAC, D.F.",16,4,20,0,0,80,
28-ago-13,GTO.,"CELAYA, GTO.",2,18,20,4,0,1,
11-oct-13,D.F.,"LA MAGDALENA CONTRERAS, D.F.",19,1,20,2,0,180,
01-nov-13,D.F.,"ALVARO OBREGON, D.F.",12,8,20,0,0,1000,
13-nov-13,GTO.,"IRAPUATO, GTO.",15,5,20,0,0,0,
08-dic-13,D.F.,"CUAUHTEMOC, D.F.",17,3,20,1,0,40,
12-mar-14,D.F.,"IZTACALCO, D.F.",14,6,20,2,3,170,
19-mar-14,D.F.,"IZTACALCO, D.F.",14,6,20,0,3,4,
27-mar-14,MEX.,"CHICOLOAPAN, MEX.",14,6,20,0,2,0,
31-mar-14,D.F.,"TLAHUAC, D.F.",17,3,20,0,0,160,
17-abr-14,MEX.,"ECATEPEC DE MOR., MEX.",16,4,20,0,1,0,
14-may-14,SIN.,"EL FUERTE, SIN.",7,13,20,0,0,0,
19-jun-14,MEX.,"TECAMAC, MEX.",17,3,20,0,1,0,
21-jun-14,MEX.,"TECAMAC, MEX.",15,5,20,0,0,0,
18-ago-14,D.F.,"IZTAPALAPA, D.F.",19,1,20,0,2,150,
19-ago-14,D.F.,"IZTAPALAPA, D.F.",19,1,20,0,0,75,
23-oct-14,D.F.,"COYOACAN, D.F.",17,3,20,0,0,500,
28-oct-14,CHIS.,"TUXTLA GUTIÉRREZ, CHIS.",14,6,20,21,2,1520,
29-oct-14,CHIS.,"TUXTLA GUTIÉRREZ, CHIS.",7,13,20,4,15,1802,
30-oct-14,CHIS.,"COMITAN DE DOMÍNGUEZ, CHIS.",13,7,20,0,0,264,
31-oct-14,D.F.,"BENITO JUAREZ, D.F.",16,4,20,0,0,300,
01-dic-14,GTO.,"LEON, GTO.",15,5,20,0,1,0,
06-ene-15,DGO.,"LERDO, DGO.",15,5,20,1,0,0,
06-feb-15,TAMPS.,"MATAMOROS, TAMPS.",8,12,20,200,0,0,
20-feb-15,TAMPS.,"MATAMOROS, TAMPS.",8,12,20,0,0,100,
03-mar-15,GTO.,"SALAMANCA, GTO.",16,4,20,0,0,0,
17-ago-15,SIN.,"MAZATLAN, SIN.",3,17,20,0,0,0,
21-ago-15,SIN.,"MAZATLAN, SIN.",16,4,20,0,4,0,
07-oct-15,SIN.,"EL FUERTE, SIN.",16,4,20,0,3,0,
20-oct-15,SIN.,"GUASAVE, SIN.",15,5,20,0,4,0,
19-nov-15,D.F.,"CUAUHTEMOC, D.F.",10,10,20,0,4,2,
04-dic-15,S.L.P.,"SAN LUIS POTOSI, S.L.P.",13,7,20,0,2,0,
12-jul-16,D.F.,"GUSTAVO A. MADERO, D.F.",16,4,20,0,2,1169,
20-oct-16,D.F.,"CUAJIMALPA DE MOR., D.F.",12,8,20,0,0,70,
29-ene-18,D.F.,"CUAUHTEMOC, D.F.",13,7,20,0,0,1623,
31-ene-18,D.F.,"CUAUHTEMOC, D.F.",11,9,20,0,0,176,
25-feb-19,CD. MÉX.,"CUAUHTEMOC, CD. MÉX.",18,2,20,0,0,4737,
26-mar-19,CD. MÉX.,"COYOACAN, CD. MÉX.",15,5,20,0,1,2119,
11-abr-19,CD. MÉX.,"MIGUEL HGO., CD. MÉX.",13,7,20,0,0,1254,
29-abr-19,CHIH.,"JUÁREZ, CHIH.",9,11,20,10,0,299,
24-nov-21,CHIH.,"JUÁREZ, CHIH.",11,9,20,11,0,592,
10-nov-22,GTO.,"LEON, GTO.",17,3,20,0,1,0,
16-mar-23,México,"ECATEPEC DE MORELOS, MEX.",20,0,20,0,0,0,
05-jun-23,Sinaloa,"CHOIX, SIN.",16,4,20,0,0,256,
16-jun-23,México,"NEXTLALPAN, MEX., MEX.",20,0,20,0,0,0,
22-jun-23,México,"TECAMAC, MEX.",20,0,20,13,0,0,
07-jul-23,Sinaloa,"AHOME, SIN.",17,3,20,0,0,59,
18-oct-23,Michoacán,"URUAPAN, MICH.",2,18,20,2,0,0,
28-nov-23,Guanajuato,"LEON, GTO.",16,4,20,4,1,63,
29-nov-23,Guanajuato,"LEON, GTO.",16,4,20,39,6,515,
20-jun-24,Sinaloa,"SALVADOR ALVARADO, SIN.",17,3,20,0,0,311,
25-jun-24,Zacatecas,"ZACATECAS, ZAC.",16,4,20,49,1,808,
25-jun-24,Michoacán,"TACAMBARO, MICH.",5,15,20,6,0,450,
07-feb-13,TAMPS.,"VICTORIA, TAMPS.",13,6,19,2,1,105,
11-feb-13,MEX.,"TOLUCA, MEX.",15,4,19,10,0,367,
14-mar-13,MEX.,"LA PAZ, MEX.",17,2,19,0,0,300,
15-mar-13,D.F.,"CUAJIMALPA DE MOR., D.F.",13,6,19,0,0,235,
10-abr-13,MICH.,"MORELIA, MICH.",3,16,19,0,0,0,
11-abr-13,MICH.,"MORELIA, MICH.",14,5,19,0,2,0,
28-jun-13,MEX.,"NAUCALPAN DE JUAREZ, MEX.",13,6,19,8,0,1252,
15-jul-13,D.F.,"GUSTAVO A. MADERO, D.F.",17,2,19,0,1,150,
02-ago-13,D.F.,"TLAHUAC, D.F.",11,8,19,3,1,90,
29-ago-13,GTO.,"CELAYA, GTO.",14,5,19,0,0,0,
23-sep-13,D.F.,"XOCHIMILCO, D.F.",16,3,19,3,0,100,
20-dic-13,D.F.,"CUAUHTEMOC, D.F.",19,0,19,0,0,0,
22-mar-14,QRO.,"QUERETARO, QRO.",13,6,19,0,6,0,
25-mar-14,D.F.,"IZTAPALAPA, D.F.",12,7,19,0,0,128,
26-mar-14,QRO.,"QUERETARO, QRO.",11,8,19,0,0,0,
10-abr-14,D.F.,"MILPA ALTA, D.F.",17,2,19,0,0,0,
11-abr-14,MEX.,"TLALNEPANTLA DE BAZ, MEX.",14,5,19,5,2,494,
16-abr-14,MEX.,"ECATEPEC DE MOR., MEX.",18,1,19,0,10,785,
22-abr-14,MEX.,"CHIMALHUACAN, MEX.",15,4,19,0,0,0,
23-abr-14,MEX.,"ECATEPEC DE MOR., MEX.",18,1,19,0,10,0,
28-abr-14,MEX.,"ECATEPEC DE MOR., MEX.",15,4,19,0,0,0,
20-may-14,MEX.,"ACOLMAN, MEX.",16,3,19,0,0,0,
27-may-14,D.F.,"BENITO JUAREZ, D.F.",18,1,19,0,0,85,
30-may-14,SIN.,"CHOIX, SIN.",7,12,19,0,0,0,
01-sep-14,D.F.,"IZTAPALAPA, D.F.",18,1,19,0,0,100,
17-oct-14,TAMPS.,"MATAMOROS, TAMPS.",8,11,19,1,0,80,
22-oct-14,CHIS.,"TUXTLA GUTIÉRREZ, CHIS.",14,5,19,11,2,591,
24-oct-14,D.F.,"COYOACAN, D.F.",18,1,19,0,0,250,
31-oct-14,CHIS.,"COMITAN DE DOMÍNGUEZ, CHIS.",9,10,19,5,1,288,
10-nov-14,D.F.,"AZCAPOTZALCO, D.F.",15,4,19,0,0,30,
21-nov-14,SIN.,"MAZATLAN, SIN.",8,11,19,0,0,0,
17-dic-14,DGO.,"LERDO, DGO.",13,6,19,1,0,0,
24-dic-14,DGO.,"GOMEZ PALACIO, DGO.",8,11,19,0,0,0,
26-mar-15,YUC.,"MERIDA, YUC.",17,2,19,0,0,760,
15-ago-15,MEX.,"TLALNEPANTLA DE BAZ, MEX.",9,10,19,0,0,200,
19-ago-15,OAX.,"OAX. DE JUAREZ, OAX.",2,17,19,1,0,128,
10-sep-15,B.C.,"MEXICALI, B.C.",10,9,19,0,0,0,
11-sep-15,SIN.,"CHOIX, SIN.",6,13,19,0,10,0,
02-oct-15,TAMPS.,"TAMPICO, TAMPS.",10,9,19,43,4,552,
17-nov-15,SIN.,"SIN., SIN.",19,0,19,0,9,0,
28-nov-15,D.F.,"CUAUHTEMOC, D.F.",10,9,19,0,0,80,
09-dic-15,CHIH.,"HGO. DEL PARRAL, CHIH.",12,7,19,1,0,614,
10-dic-15,D.F.,"CUAUHTEMOC, D.F.",5,14,19,0,6,26,
27-ene-16,D.F.,"COYOACAN, D.F.",12,7,19,0,0,90,
10-mar-16,D.F.,"TLAHUAC, D.F.",13,6,19,39,4,0,
15-mar-16,COAH.,"MONCLOVA, COAH.",1,18,19,0,0,0,
07-jun-16,D.F.,"VENUSTIANO CARRANZA, D.F.",8,11,19,0,0,327,
22-jun-16,D.F.,"BENITO JUAREZ, D.F.",6,13,19,335,5,2480,
05-sep-16,D.F.,"AZCAPOTZALCO, D.F.",13,6,19,0,3,80,
20-sep-16,SIN.,"SIN., SIN.",15,4,19,0,5,0,
03-oct-16,D.F.,"ALVARO OBREGON, D.F.",10,9,19,0,5,18,
06-oct-16,D.F.,"ALVARO OBREGON, D.F.",11,8,19,0,0,0,
14-oct-16,MEX.,"TULTEPEC, MEX.",16,3,19,0,0,0,
18-oct-16,D.F.,"CUAJIMALPA DE MOR., D.F.",15,4,19,0,2,0,
24-oct-16,D.F.,"IZTACALCO, D.F.",13,6,19,0,2,0,
04-nov-16,D.F.,"IZTACALCO, D.F.",13,6,19,0,2,0,
08-nov-16,D.F.,"LA MAGDALENA CONTRERAS, D.F.",11,8,19,0,1,3532,
24-nov-16,D.F.,"COYOACAN, D.F.",15,4,19,0,4,0,
15-dic-16,GTO.,"LEON, GTO.",12,7,19,0,1,0,
20-dic-16,GTO.,"LEON, GTO.",11,8,19,0,0,0,
07-mar-18,CHIH.,"CHIH., CHIH.",17,2,19,0,0,272,
16-mar-18,DGO.,"LERDO, DGO.",19,0,19,0,0,0,
10-ago-18,D.F.,"GUSTAVO A. MADERO, D.F.",9,10,19,0,4,564,
20-ago-18,D.F.,"BENITO JUAREZ, D.F.",17,2,19,0,15,3131,
26-feb-19,CD. MÉX.,"CUAUHTEMOC, CD. MÉX.",16,3,19,0,0,2469,
24-ene-20,CD. MÉX.,"GUSTAVO A. MADERO, CD. MÉX.",17,2,19,0,3,433,
05-mar-20,CHIH.,"CHIH., CHIH.",18,1,19,0,0,151,
17-jun-22,N.L.,"MONTERREY, N.L.",14,5,19,8,0,474,
12-nov-22,CHIS.,"CHENALHÓ, CHIS.",4,15,19,3,0,132,
15-mar-23,México,"ECATEPEC DE MORELOS, MEX.",19,0,19,0,0,0,
18-ene-13,D.F.,"IZTAPALAPA, D.F.",17,1,18,0,1,100,
08-mar-13,COAH.,"VIESCA, COAH.",13,5,18,21,2,0,
31-mar-13,GRO.,"AJUCHITLAN DEL PROGRESO, GRO.",6,12,18,0,0,97,
08-abr-13,SIN.,"AHOME, SIN.",14,4,18,0,3,0,
09-abr-13,MEX.,"TEOTIHUACAN, MEX.",18,0,18,0,0,306,
18-abr-13,QRO.,"QUERETARO, QRO.",13,5,18,0,3,0,
19-abr-13,SIN.,"GUASAVE, SIN.",12,6,18,0,1,0,
20-abr-13,MEX.,"TENANGO DEL VALLE, MEX.",15,3,18,3,0,69,
18-may-13,N.L.,"MONTERREY, N.L.",0,18,18,0,4,2588,
25-jun-13,GTO.,"LEON, GTO.",16,2,18,0,0,0,
01-jul-13,GTO.,"LEON, GTO.",8,10,18,0,0,48,
02-jul-13,GTO.,"LEON, GTO.",7,11,18,0,0,85,
03-jul-13,GTO.,"LEON, GTO.",10,8,18,8,0,174,
29-jul-13,D.F.,"TLAHUAC, D.F.",13,5,18,0,0,90,
01-ago-13,D.F.,"TLAHUAC, D.F.",15,3,18,0,0,65,
04-sep-13,D.F.,"VENUSTIANO CARRANZA, D.F.",13,5,18,2,1,90,
11-nov-13,GTO.,"IRAPUATO, GTO.",17,1,18,0,1,0,
27-feb-14,D.F.,"MIGUEL HGO., D.F.",16,2,18,2,0,330,
06-mar-14,D.F.,"MIGUEL HGO., D.F.",18,0,18,1,15,250,
05-abr-14,MEX.,"NICOLAS ROMERO, MEX.",14,4,18,8,0,723,
08-abr-14,GTO.,"ACAMBARO, GTO.",14,4,18,0,0,0,
15-abr-14,MEX.,"ECATEPEC DE MOR., MEX.",13,5,18,0,5,0,
26-abr-14,MEX.,"ECATEPEC DE MOR., MEX.",15,3,18,0,2,0,
30-abr-14,MEX.,"ALMOLOYA DE JUAREZ, MEX.",16,2,18,0,0,0,
02-may-14,DGO.,"DGO., DGO.",12,6,18,1,0,0,
03-may-14,MEX.,"ALMOLOYA DE JUAREZ, MEX.",15,3,18,0,0,0,
03-may-14,MEX.,"TEOLOYUCAN, MEX.",11,7,18,3,2,115,
06-may-14,MEX.,"TEXCOCO, MEX.",15,3,18,0,0,0,
15-may-14,DGO.,"DGO., DGO.",14,4,18,3,3,0,
16-may-14,MEX.,"AMECAMECA, MEX.",12,6,18,0,2,0,
19-may-14,D.F.,"COYOACAN, D.F.",17,1,18,0,5,0,
27-may-14,MEX.,"TOLUCA, MEX.",12,6,18,0,0,100,
31-may-14,TAMPS.,"MATAMOROS, TAMPS.",11,7,18,0,1,0,
02-jun-14,SIN.,"CULIACAN, SIN.",10,8,18,0,2,0,
24-jun-14,MEX.,"ECATEPEC DE MOR., MEX.",14,4,18,0,5,0,
21-ago-14,B.C.,"ENSENADA, B.C.",4,14,18,0,0,0,
22-ago-14,D.F.,"IZTAPALAPA, D.F.",16,2,18,0,5,100,
10-oct-14,TAMPS.,"MATAMOROS, TAMPS.",12,6,18,0,0,0,
11-oct-14,SON.,"SAN LUIS RIO COLORADO, SON.",8,10,18,3,0,600,
31-oct-14,SIN.,"EL FUERTE, SIN.",10,8,18,0,0,0,
07-nov-14,SIN.,"EL FUERTE, SIN.",9,9,18,0,0,0,
18-nov-14,D.F.,"LA MAGDALENA CONTRERAS, D.F.",16,2,18,0,0,0,
09-feb-15,D.F.,"IZTAPALAPA, D.F.",6,12,18,0,1,0,
14-feb-15,TAMPS.,"MATAMOROS, TAMPS.",10,8,18,0,0,200,
02-sep-15,SIN.,"MAZATLAN, SIN.",11,7,18,0,11,0,
02-sep-15,MEX.,"ATIZAPAN DE ZARAGOZA, MEX.",17,1,18,6,6,415,
10-sep-15,SIN.,"MAZATLAN, SIN.",15,3,18,0,8,0,
15-sep-15,OAX.,"OAX. DE JUAREZ, OAX.",1,17,18,3,0,56,
02-oct-15,SIN.,"EL FUERTE, SIN.",11,7,18,0,6,0,
26-oct-15,SIN.,"GUASAVE, SIN.",13,5,18,0,5,0,
10-nov-15,D.F.,"CUAUHTEMOC, D.F.",5,13,18,0,0,0,
17-nov-15,D.F.,"CUAUHTEMOC, D.F.",12,6,18,0,17,42,
30-nov-15,D.F.,"CUAUHTEMOC, D.F.",10,8,18,0,0,11,
04-dic-15,CHIS.,"TUXTLA GUTIÉRREZ, CHIS.",14,4,18,2,2,1148,
25-ene-16,D.F.,"COYOACAN, D.F.",18,0,18,0,8,190,
08-mar-16,D.F.,"TLAHUAC, D.F.",13,5,18,11,0,0,
16-mar-16,D.F.,"TLAHUAC, D.F.",14,4,18,45,0,135,
24-mar-16,GTO.,"SALAMANCA, GTO.",8,10,18,0,11,0,
22-abr-16,D.F.,"IZTAPALAPA, D.F.",10,8,18,262,6,105,
19-ago-16,D.F.,"MIGUEL HGO., D.F.",8,10,18,0,5,15,
23-ago-16,D.F.,"MIGUEL HGO., D.F.",12,6,18,0,8,425,
08-nov-16,SIN.,"GUASAVE, SIN.",12,6,18,0,6,0,
10-nov-16,D.F.,"LA MAGDALENA CONTRERAS, D.F.",14,4,18,0,12,50,
09-dic-16,GTO.,"LEON, GTO.",9,9,18,0,0,0,
09-dic-16,S.L.P.,"SAN LUIS POTOSI, S.L.P.",17,1,18,0,0,0,
14-dic-16,GTO.,"LEON, GTO.",16,2,18,0,0,0,
07-jun-17,CHIS.,"TUXTLA GUTIÉRREZ, CHIS.",12,6,18,87,0,432,
28-jul-17,ZAC.,"GUADALUPE, ZAC.",12,6,18,2,1,0,
28-jul-17,ZAC.,"FRESNILLO, ZAC.",12,6,18,2,1,0,
28-jul-17,ZAC.,"GUADALUPE, ZAC.",12,6,18,2,1,496,
18-ago-17,MEX.,"CHIMALHUACAN, MEX.",11,7,18,0,0,31,
13-sep-17,GTO.,"GTO., GTO.",18,0,18,0,1,0,
22-ene-18,D.F.,"CUAUHTEMOC, D.F.",15,3,18,0,0,246,
13-feb-18,SIN.,"CULIACAN, SIN.",16,2,18,0,5,0,
22-ene-19,CD. MÉX.,"GUSTAVO A. MADERO, CD. MÉX.",16,2,18,0,1,10447,
23-abr-19,CD. MÉX.,"ALVARO OBREGON, CD. MÉX.",14,4,18,0,0,596,
01-abr-23,México,"NAUCALPAN DE JUAREZ, MEX.",18,0,18,0,0,0,
07-may-23,Michoacán,"SAHUAYO, MICH.",1,17,18,0,0,24,
31-may-23,Sinaloa,"EL FUERTE, SIN.",9,9,18,0,0,0,
24-jun-24,Sinaloa,"CULIACAN, SIN.",12,6,18,0,0,308,
12-feb-13,B.C.,"MEXICALI, B.C.",12,5,17,0,0,0,
14-feb-13,D.F.,"MIGUEL HGO., D.F.",16,1,17,0,0,0,
01-mar-13,N.L.,"GUADALUPE, N.L.",7,10,17,5,0,1445,
07-mar-13,N.L.,"MONTERREY, N.L.",7,10,17,21,0,6371,
13-mar-13,MEX.,"NICOLAS ROMERO, MEX.",7,10,17,1,0,104,
23-mar-13,MEX.,"CHICOLOAPAN, MEX.",12,5,17,0,2,0,
26-mar-13,D.F.,"XOCHIMILCO, D.F.",15,2,17,0,0,53,
06-abr-13,MICH.,"ZAMORA, MICH.",13,4,17,0,2,0,
09-abr-13,MICH.,"MORELIA, MICH.",14,3,17,0,0,0,
10-abr-13,MICH.,"ZAMORA, MICH.",6,11,17,0,0,0,
13-abr-13,MEX.,"TEJUPILCO, MEX.",13,4,17,3,0,0,
13-abr-13,QRO.,"AMEALCO DE BONFIL, QRO.",5,12,17,0,0,0,
16-abr-13,OAX.,"SANTA CRUZ XOXOCOTLAN, OAX.",10,7,17,0,0,0,
17-abr-13,MEX.,"AMECAMECA, MEX.",15,2,17,5,3,0,
27-abr-13,N.L.,"HUALAHUISES, N.L.",9,8,17,12,0,250,
15-jun-13,MEX.,"NAUCALPAN DE JUAREZ, MEX.",16,1,17,3,5,357,
26-jun-13,MEX.,"NAUCALPAN DE JUAREZ, MEX.",6,11,17,7,0,109,
27-jun-13,PUE.,"PUE., PUE.",13,4,17,4,4,1472,
28-jun-13,GTO.,"LEON, GTO.",11,6,17,0,0,850,
01-ago-13,JAL.,"TLAQUEPAQUE, JAL.",12,5,17,3,0,53,
08-ago-13,D.F.,"TLAHUAC, D.F.",11,6,17,2,1,60,
03-sep-13,D.F.,"VENUSTIANO CARRANZA, D.F.",12,5,17,3,0,90,
26-sep-13,ZAC.,"FRESNILLO, ZAC.",11,6,17,0,1,13,
01-oct-13,D.F.,"AZCAPOTZALCO, D.F.",10,7,17,3,8,160,
11-nov-13,D.F.,"MILPA ALTA, D.F.",7,10,17,0,0,5,
07-dic-13,D.F.,"CUAUHTEMOC, D.F.",15,2,17,0,2,600,
09-dic-13,D.F.,"CUAUHTEMOC, D.F.",17,0,17,0,1,0,
09-ene-14,PUE.,"PUE., PUE.",17,0,17,5,0,177,
21-feb-14,D.F.,"CUAUHTEMOC, D.F.",13,4,17,0,1,180,
03-mar-14,D.F.,"MIGUEL HGO., D.F.",14,3,17,2,0,125,
27-mar-14,D.F.,"IZTAPALAPA, D.F.",13,4,17,0,0,0,
30-mar-14,QRO.,"SAN JUAN DEL RIO, QRO.",8,9,17,0,1,0,
04-abr-14,MEX.,"TULTITLAN, MEX.",11,6,17,0,1,193,
07-abr-14,MEX.,"TLALNEPANTLA DE BAZ, MEX.",14,3,17,2,0,558,
22-abr-14,MEX.,"ECATEPEC DE MOR., MEX.",15,2,17,0,4,0,
01-may-14,SIN.,"AHOME, SIN.",14,3,17,0,11,0,
03-may-14,MEX.,"ECATEPEC DE MOR., MEX.",17,0,17,0,0,0,
12-may-14,D.F.,"COYOACAN, D.F.",11,6,17,0,4,0,
14-may-14,TAMPS.,"MATAMOROS, TAMPS.",2,15,17,0,0,273,
15-may-14,SIN.,"EL FUERTE, SIN.",12,5,17,0,4,0,
20-may-14,MEX.,"METEPEC, MEX.",15,2,17,3,1,50,
20-may-14,MEX.,"TULTEPEC, MEX.",13,4,17,0,0,6,
21-may-14,MEX.,"VALLE DE CHALCO SOLIDARIDAD, MEX.",15,2,17,0,0,0,
22-may-14,MEX.,"NAUCALPAN DE JUAREZ, MEX.",10,7,17,2,2,567,
23-may-14,TAMPS.,"MATAMOROS, TAMPS.",5,12,17,0,0,0,
26-may-14,SIN.,"CULIACAN, SIN.",14,3,17,1,1,0,
28-may-14,MEX.,"LA PAZ, MEX.",16,1,17,0,0,0,
10-jun-14,SIN.,"CHOIX, SIN.",1,16,17,0,1,0,
25-jun-14,MEX.,"CHALCO, MEX.",12,5,17,1,0,53,
27-jun-14,MEX.,"CHALCO, MEX.",12,5,17,0,8,0,
28-jun-14,MEX.,"ECATEPEC DE MOR., MEX.",17,0,17,0,8,0,
25-ago-14,D.F.,"IZTAPALAPA, D.F.",17,0,17,0,3,70,
16-oct-14,D.F.,"GUSTAVO A. MADERO, D.F.",17,0,17,0,0,500,
17-oct-14,CHIS.,"COMITAN DE DOMÍNGUEZ, CHIS.",7,10,17,3,0,31,
18-oct-14,TAMPS.,"REYNOSA, TAMPS.",10,7,17,0,0,0,
23-oct-14,CHIS.,"COMITAN DE DOMÍNGUEZ, CHIS.",12,5,17,0,0,698,
29-oct-14,GRO.,"ACAPULCO DE JUAREZ, GRO.",10,7,17,1,2,0,
04-nov-14,SIN.,"AHOME, SIN.",11,6,17,0,0,0,
05-nov-14,SIN.,"EL FUERTE, SIN.",13,4,17,0,8,0,
07-nov-14,D.F.,"CUAJIMALPA DE MOR., D.F.",16,1,17,0,0,30,
21-nov-14,TAMPS.,"MATAMOROS, TAMPS.",7,10,17,0,0,0,
22-nov-14,TAMPS.,"MATAMOROS, TAMPS.",10,7,17,0,0,0,
25-nov-14,SIN.,"MAZATLAN, SIN.",12,5,17,0,0,0,
17-dic-14,DGO.,"GOMEZ PALACIO, DGO.",11,6,17,1,0,0,
26-dic-14,TAMPS.,"MATAMOROS, TAMPS.",8,9,17,0,0,0,
30-dic-14,TAMPS.,"MATAMOROS, TAMPS.",9,8,17,0,0,0,
10-feb-15,D.F.,"IZTAPALAPA, D.F.",6,11,17,0,1,0,
04-mar-15,GTO.,"SALAMANCA, GTO.",13,4,17,0,0,0,
27-mar-15,YUC.,"MERIDA, YUC.",9,8,17,0,0,1254,
03-ago-15,D.F.,"MIGUEL HGO., D.F.",15,2,17,0,1,0,
10-ago-15,SIN.,"AHOME, SIN.",11,6,17,0,0,0,
11-ago-15,MEX.,"TLALNEPANTLA DE BAZ, MEX.",11,6,17,0,2,33,
12-ago-15,D.F.,"MIGUEL HGO., D.F.",15,2,17,0,0,0,
28-ago-15,SIN.,"CULIACAN, SIN.",10,7,17,0,4,0,
04-sep-15,MEX.,"ATIZAPAN DE ZARAGOZA, MEX.",16,1,17,3,0,1095,
15-oct-15,SIN.,"EL FUERTE, SIN.",13,4,17,0,1,0,
07-nov-15,MEX.,"CAPULHUAC, MEX.",15,2,17,0,0,41,
12-dic-15,SON.,"HERMOSILLO, SON.",17,0,17,79,0,100,
15-mar-16,D.F.,"TLAHUAC, D.F.",11,6,17,123,0,136,
03-jun-16,D.F.,"XOCHIMILCO, D.F.",7,10,17,60,15,1738,
06-jun-16,D.F.,"VENUSTIANO CARRANZA, D.F.",8,9,17,155,0,0,
16-ago-16,D.F.,"MIGUEL HGO., D.F.",9,8,17,0,2,0,
19-ago-16,MEX.,"AMECAMECA, MEX.",7,10,17,13,3,73,
10-oct-16,D.F.,"CUAJIMALPA DE MOR., D.F.",12,5,17,0,0,0,
16-dic-16,GTO.,"LEON, GTO.",9,8,17,1,1,0,
19-dic-16,GTO.,"LEON, GTO.",11,6,17,0,0,0,
03-mar-17,TAMPS.,"MATAMOROS, TAMPS.",9,8,17,12,0,1148,
10-mar-17,CHIH.,"HGO. DEL PARRAL, CHIH.",12,5,17,11,0,1130,
19-ago-17,MEX.,"CHIMALHUACAN, MEX.",12,5,17,0,0,0,
12-oct-17,SIN.,"CULIACAN, SIN.",16,1,17,0,0,0,
23-oct-18,CHIH.,"JUÁREZ, CHIH.",9,8,17,4,0,379,
07-feb-19,CD. MÉX.,"IZTAPALAPA, CD. MÉX.",16,1,17,0,0,63152,
22-mar-19,CD. MÉX.,"COYOACAN, CD. MÉX.",15,2,17,0,0,1510,
12-mar-20,CHIH.,"JUÁREZ, CHIH.",10,7,17,72,0,1248,
24-sep-21,CD. MÉX.,"MIGUEL HGO., CD. MÉX.",15,2,17,0,0,1257,
21-jun-22,N.L.,"MONTERREY, N.L.",9,8,17,1,0,517,
26-ago-22,MÉX.,"ATIZAPAN, MEX.",14,3,17,2,2,461,
15-oct-22,MÉX.,"VALLE DE CHALCO SOLIDARIDAD, MEX.",17,0,17,0,0,0,
04-may-23,Sinaloa,"CULIACAN, SIN.",14,3,17,0,0,17,
19-may-23,Sinaloa,"CULIACAN, SIN.",11,6,17,0,1,213,
31-may-23,Sinaloa,"CHOIX, SIN.",16,1,17,0,0,0,
22-jun-23,Guanajuato,"IRAPUATO, GTO.",14,3,17,28,0,846,
07-jul-23,Sinaloa,"GUASAVE, SIN.",5,12,17,0,0,49,
26-jun-24,Sinaloa,"SALVADOR ALVARADO, SIN.",12,5,17,0,2,443,
31-ene-13,D.F.,"TLAHUAC, D.F.",11,5,16,0,0,0,
11-feb-13,TAMPS.,"MATAMOROS, TAMPS.",10,6,16,0,0,0,
12-feb-13,TAMPS.,"MATAMOROS, TAMPS.",9,7,16,0,0,0,
13-feb-13,B.C.,"MEXICALI, B.C.",12,4,16,0,0,0,
10-mar-13,MEX.,"METEPEC, MEX.",13,3,16,9,0,330,
11-mar-13,MEX.,"CUAUTITLAN, MEX.",14,2,16,1,0,126,
12-mar-13,MEX.,"NICOLAS ROMERO, MEX.",11,5,16,5,0,466,
13-mar-13,MEX.,"CUAUTITLAN, MEX.",13,3,16,0,0,92,
14-mar-13,MEX.,"CUAUTITLAN, MEX.",14,2,16,0,0,75,
05-abr-13,MICH.,"MORELIA, MICH.",11,5,16,0,0,0,
05-abr-13,MEX.,"ACOLMAN, MEX.",11,5,16,2,6,69,
09-abr-13,N.L.,"LOS HERRERAS, N.L.",0,16,16,21,0,250,
11-abr-13,MEX.,"TEJUPILCO, MEX.",11,5,16,6,0,90,
19-abr-13,MEX.,"AMECAMECA, MEX.",12,4,16,0,7,0,
20-may-13,D.F.,"TLALPAN, D.F.",10,6,16,0,0,820,
21-may-13,CAMP.,"CAMP., CAMP.",6,10,16,0,0,0,
14-jun-13,MEX.,"NAUCALPAN DE JUAREZ, MEX.",15,1,16,5,1,275,
16-jun-13,MICH.,"BUENAVISTA, MICH.",4,12,16,0,0,0,
19-jun-13,MEX.,"NAUCALPAN DE JUAREZ, MEX.",11,5,16,6,1,257,
25-jun-13,PUE.,"TEHUACAN, PUE.",11,5,16,1,0,210,
30-jun-13,GTO.,"GTO., GTO.",13,3,16,0,0,40,
11-jul-13,N.L.,"APODACA, N.L.",13,3,16,3,0,9723,
15-jul-13,N.L.,"APODACA, N.L.",9,7,16,15,0,787,
08-ago-13,N.L.,"SANTA CATARINA, N.L.",8,8,16,3,0,1125,
13-ago-13,D.F.,"MIGUEL HGO., D.F.",14,2,16,1,0,220,
14-ago-13,D.F.,"MIGUEL HGO., D.F.",9,7,16,0,1,12,
15-ago-13,D.F.,"MIGUEL HGO., D.F.",11,5,16,0,1,50,
10-oct-13,COAH.,"PIEDRAS NEGRAS, COAH.",8,8,16,0,0,265,
18-oct-13,COAH.,"PIEDRAS NEGRAS, COAH.",12,4,16,0,0,700,
19-oct-13,COAH.,"PIEDRAS NEGRAS, COAH.",8,8,16,0,0,330,
28-oct-13,D.F.,"ALVARO OBREGON, D.F.",16,0,16,0,0,125,
26-nov-13,D.F.,"CUAJIMALPA DE MOR., D.F.",14,2,16,0,0,213,
04-dic-13,N.L.,"SAN NICOLAS DE LOS GARZA, N.L.",11,5,16,25,0,1388,
07-dic-13,TAMPS.,"NUEVO LAREDO, TAMPS.",11,5,16,13,0,1201,
11-dic-13,D.F.,"CUAUHTEMOC, D.F.",13,3,16,0,2,0,
21-dic-13,D.F.,"CUAUHTEMOC, D.F.",16,0,16,0,0,0,
10-mar-14,D.F.,"IZTACALCO, D.F.",11,5,16,1,5,20,
24-mar-14,D.F.,"IZTAPALAPA, D.F.",12,4,16,0,0,0,
26-mar-14,MEX.,"CHICOLOAPAN, MEX.",13,3,16,0,4,0,
28-mar-14,AGS.,"AGS., AGS.",13,3,16,7,0,100,
28-mar-14,QRO.,"QUERETARO, QRO.",9,7,16,0,0,0,
11-abr-14,MEX.,"CUAUTITLAN IZCALLI, MEX.",13,3,16,3,3,290,
24-abr-14,MEX.,"ECATEPEC DE MOR., MEX.",13,3,16,0,0,0,
29-abr-14,MEX.,"ALMOLOYA DE JUAREZ, MEX.",15,1,16,0,0,0,
30-abr-14,MEX.,"ECATEPEC DE MOR., MEX.",14,2,16,0,2,0,
07-may-14,SIN.,"AHOME, SIN.",9,7,16,0,10,0,
12-may-14,MEX.,"TENANCINGO, MEX.",13,3,16,0,0,0,
13-may-14,SIN.,"EL FUERTE, SIN.",10,6,16,0,0,0,
13-may-14,MEX.,"AMECAMECA, MEX.",9,7,16,0,0,0,
15-may-14,MEX.,"CHALCO, MEX.",11,5,16,1,3,5,
24-may-14,MEX.,"METEPEC, MEX.",13,3,16,1,0,710,
27-may-14,OAX.,"OAX. DE JUAREZ, OAX.",2,14,16,0,0,0,
29-may-14,MEX.,"LA PAZ, MEX.",16,0,16,0,1,0,
30-may-14,SIN.,"CULIACAN, SIN.",12,4,16,0,2,0,
07-jun-14,MEX.,"TOLUCA, MEX.",14,2,16,6,1,0,
12-jun-14,MEX.,"IXTLAHUACA, MEX.",8,8,16,1,0,0,
11-ago-14,SIN.,"MAZATLAN, SIN.",14,2,16,0,8,0,
14-ago-14,SIN.,"MAZATLAN, SIN.",10,6,16,0,11,0,
29-ago-14,TAMPS.,"REYNOSA, TAMPS.",8,8,16,7,2,194,
24-sep-14,MICH.,"JIQUILPAN, MICH.",7,9,16,10,0,784,
23-oct-14,CHIS.,"VILLAFLORES, CHIS.",9,7,16,1,0,0,
24-oct-14,CHIS.,"VILLAFLORES, CHIS.",10,6,16,0,0,0,
31-oct-14,CHIS.,"VILLAFLORES, CHIS.",7,9,16,0,5,0,
04-nov-14,SIN.,"EL FUERTE, SIN.",8,8,16,0,0,0,
04-nov-14,CHIS.,"TUXTLA GUTIÉRREZ, CHIS.",13,3,16,8,0,833,
13-nov-14,SIN.,"CHOIX, SIN.",8,8,16,0,0,0,
14-nov-14,SIN.,"CHOIX, SIN.",10,6,16,0,0,0,
09-dic-14,TAMPS.,"MATAMOROS, TAMPS.",9,7,16,0,0,0,
05-mar-15,GTO.,"SALAMANCA, GTO.",11,5,16,0,0,0,
10-ago-15,D.F.,"MIGUEL HGO., D.F.",12,4,16,0,2,0,
12-ago-15,SIN.,"CULIACAN, SIN.",13,3,16,0,1,0,
13-ago-15,TAMPS.,"NUEVO LAREDO, TAMPS.",8,8,16,18,1,1649,
18-ago-15,COAH.,"PIEDRAS NEGRAS, COAH.",4,12,16,0,0,216,
25-ago-15,MEX.,"CHICONCUAC, MEX.",11,5,16,0,3,130,
29-ago-15,B.C.,"MEXICALI, B.C.",9,7,16,0,0,0,
01-sep-15,MEX.,"ATIZAPAN DE ZARAGOZA, MEX.",12,4,16,0,9,1571,
03-sep-15,MEX.,"ATIZAPAN, MEX.",11,5,16,4,0,5800,
08-sep-15,SIN.,"CHOIX, SIN.",3,13,16,0,1,0,
16-sep-15,B.C.,"MEXICALI, B.C.",9,7,16,0,0,0,
01-oct-15,SIN.,"EL FUERTE, SIN.",10,6,16,0,4,0,
09-oct-15,MEX.,"ECATEPEC DE MOR., MEX.",14,2,16,3,6,518,
20-oct-15,MEX.,"NEZAHUALCOYOTL, MEX.",13,3,16,0,0,0,
29-oct-15,D.F.,"ALVARO OBREGON, D.F.",10,6,16,0,7,0,
09-nov-15,D.F.,"CUAUHTEMOC, D.F.",16,0,16,0,3,0,
18-nov-15,D.F.,"CUAUHTEMOC, D.F.",7,9,16,0,0,920,
07-dic-15,D.F.,"CUAUHTEMOC, D.F.",7,9,16,0,2,32,
07-dic-15,S.L.P.,"CIUDAD VALLES, S.L.P.",14,2,16,0,4,434,
10-dic-15,CHIH.,"HGO. DEL PARRAL, CHIH.",14,2,16,8,3,758,
14-dic-15,D.F.,"CUAUHTEMOC, D.F.",8,8,16,0,0,5,
04-abr-16,S.L.P.,"SAN LUIS POTOSI, S.L.P.",14,2,16,0,0,5,
21-abr-16,D.F.,"IZTACALCO, D.F.",8,8,16,146,2,440,
30-may-16,N.L.,"GUADALUPE, N.L.",11,5,16,0,0,430,
08-jul-16,D.F.,"GUSTAVO A. MADERO, D.F.",9,7,16,0,2,31,
19-sep-16,SIN.,"SIN., SIN.",14,2,16,0,7,0,
05-oct-16,D.F.,"ALVARO OBREGON, D.F.",11,5,16,0,1,810,
10-oct-16,MEX.,"ECATEPEC DE MOR., MEX.",16,0,16,0,1,1,
03-nov-16,SIN.,"GUASAVE, SIN.",10,6,16,0,7,0,
07-nov-16,D.F.,"LA MAGDALENA CONTRERAS, D.F.",10,6,16,0,2,1289,
07-nov-16,MEX.,"NEZAHUALCOYOTL, MEX.",13,3,16,7,60,144,
09-nov-16,SIN.,"GUASAVE, SIN.",10,6,16,0,8,0,
06-jun-17,CHIS.,"TUXTLA GUTIÉRREZ, CHIS.",10,6,16,35,0,921,
29-ago-17,MEX.,"CHICOLOAPAN, MEX.",11,5,16,0,0,188,
04-dic-17,CHIH.,"JUÁREZ, CHIH.",6,10,16,6,0,364,
06-feb-19,CD. MÉX.,"IZTAPALAPA, CD. MÉX.",13,3,16,0,0,69678,
22-feb-19,CD. MÉX.,"CUAUHTEMOC, CD. MÉX.",14,2,16,0,0,751,
01-mar-19,CD. MÉX.,"CUAUHTEMOC, CD. MÉX.",16,0,16,0,2,7180,
20-mar-19,CD. MÉX.,"COYOACAN, CD. MÉX.",8,8,16,0,0,717,
21-mar-19,CD. MÉX.,"COYOACAN, CD. MÉX.",14,2,16,0,1,2591,
08-abr-19,CD. MÉX.,"MIGUEL HGO., CD. MÉX.",12,4,16,0,1,558,
29-may-19,CD. MÉX.,"IZTAPALAPA, CD. MÉX.",11,5,16,0,0,536,
12-feb-20,COAH.,"SALTILLO, COAH.",9,7,16,11,0,323,
19-feb-20,SIN.,"SIN., SIN.",9,7,16,0,0,0,
25-nov-21,CHIH.,"JUÁREZ, CHIH.",14,2,16,8,0,459,
15-nov-22,CHIS.,"CHENALHÓ, CHIS.",3,13,16,2,0,64,
23-mar-23,México,"SAN MATEO ATENCO, MEX.",15,1,16,0,0,0,
24-mar-23,México,"CUAUTITLAN IZCALLI, MEX.",16,0,16,0,0,567,
24-mar-23,México,"NAUCALPAN DE JUAREZ, MEX.",1,15,16,0,0,421,
03-may-23,Sinaloa,"CULIACAN, SIN.",14,2,16,0,0,182,
24-jun-23,Guanajuato,"IRAPUATO, GTO.",10,6,16,29,4,"1,024",
25-feb-13,MEX.,"IXTAPALUCA, MEX.",13,2,15,7,1,50,
01-mar-13,MEX.,"COACALCO DE BERRIOZABAL, MEX.",14,1,15,6,0,20,
01-mar-13,DGO.,"DGO., DGO.",13,2,15,5,0,541,
02-mar-13,MEX.,"IXTAPALUCA, MEX.",14,1,15,2,1,20,
04-mar-13,MEX.,"VALLE DE CHALCO SOLIDARIDAD, MEX.",14,1,15,0,4,128,
09-mar-13,MEX.,"METEPEC, MEX.",11,4,15,7,1,173,
11-mar-13,MEX.,"HUIXQUILUCAN, MEX.",14,1,15,0,0,689,
15-mar-13,MEX.,"LA PAZ, MEX.",11,4,15,0,0,0,
17-mar-13,MEX.,"HUIXQUILUCAN, MEX.",14,1,15,0,5,0,
19-mar-13,MEX.,"CHICOLOAPAN, MEX.",14,1,15,0,0,0,
21-mar-13,MEX.,"TULTEPEC, MEX.",9,6,15,3,6,102,
06-abr-13,MEX.,"IXTLAHUACA, MEX.",13,2,15,3,0,12,
08-abr-13,MEX.,"TEOTIHUACAN, MEX.",11,4,15,2,7,401,
09-abr-13,SIN.,"AHOME, SIN.",9,6,15,0,5,0,
10-abr-13,SIN.,"AHOME, SIN.",11,4,15,0,5,0,
11-abr-13,MEX.,"ATLACOMULCO, MEX.",13,2,15,0,0,0,
13-abr-13,MEX.,"ATLACOMULCO, MEX.",12,3,15,0,0,0,
21-abr-13,QRO.,"SAN JUAN DEL RIO, QRO.",9,6,15,0,0,0,
25-jun-13,MEX.,"NAUCALPAN DE JUAREZ, MEX.",9,6,15,2,0,110,
22-jul-13,N.L.,"MONTERREY, N.L.",7,8,15,13,0,3700,
27-jul-13,CHIS.,"TUXTLA GUTIÉRREZ, CHIS.",11,4,15,0,2,0,
01-ago-13,N.L.,"MONTERREY, N.L.",8,7,15,31,0,607,
09-ago-13,D.F.,"TLAHUAC, D.F.",11,4,15,0,2,20,
16-ago-13,D.F.,"MIGUEL HGO., D.F.",12,3,15,0,0,100,
03-oct-13,D.F.,"AZCAPOTZALCO, D.F.",14,1,15,5,0,380,
12-nov-13,D.F.,"MILPA ALTA, D.F.",13,2,15,0,1,0,
17-feb-14,D.F.,"CUAUHTEMOC, D.F.",14,1,15,0,0,512,
20-feb-14,D.F.,"CUAUHTEMOC, D.F.",11,4,15,0,0,20,
21-mar-14,D.F.,"IZTAPALAPA, D.F.",14,1,15,3,2,53,
23-mar-14,QRO.,"AMEALCO DE BONFIL, QRO.",7,8,15,0,6,0,
27-mar-14,QRO.,"QUERETARO, QRO.",11,4,15,0,0,0,
05-abr-14,MEX.,"COACALCO DE BERRIOZABAL, MEX.",12,3,15,0,4,0,
05-abr-14,MEX.,"TULTITLAN, MEX.",13,2,15,4,0,229,
05-abr-14,JAL.,"TOMATLAN, JAL.",7,8,15,0,0,0,
10-abr-14,MEX.,"TLALNEPANTLA DE BAZ, MEX.",12,3,15,4,4,116,
18-abr-14,MEX.,"ECATEPEC DE MOR., MEX.",10,5,15,0,1,0,
19-abr-14,MEX.,"ECATEPEC DE MOR., MEX.",13,2,15,0,0,0,
22-abr-14,SIN.,"AHOME, SIN.",14,1,15,0,7,0,
02-may-14,SIN.,"GUASAVE, SIN.",10,5,15,0,7,0,
28-may-14,MEX.,"TOLUCA, MEX.",11,4,15,0,0,100,
31-may-14,MEX.,"LA PAZ, MEX.",12,3,15,0,2,0,
14-jun-14,MEX.,"JILOTEPEC, MEX.",4,11,15,0,3,0,
23-jun-14,MEX.,"TLALNEPANTLA DE BAZ, MEX.",11,4,15,1,3,137,
22-jul-14,CHIH.,"JUÁREZ, CHIH.",8,7,15,0,0,0,
29-jul-14,CHIH.,"JUÁREZ, CHIH.",8,7,15,0,0,0,
31-jul-14,CHIH.,"JUÁREZ, CHIH.",11,4,15,0,1,0,
06-ago-14,SIN.,"MAZATLAN, SIN.",10,5,15,0,0,0,
08-oct-14,N.L.,"MONTERREY, N.L.",10,5,15,79,0,12556,
24-oct-14,CHIS.,"TUXTLA GUTIÉRREZ, CHIS.",11,4,15,1,2,2001,
29-oct-14,SIN.,"EL FUERTE, SIN.",8,7,15,0,0,0,
05-nov-14,CHIS.,"TUXTLA GUTIÉRREZ, CHIS.",6,9,15,4,1,1241,
24-nov-14,SIN.,"MAZATLAN, SIN.",8,7,15,0,0,0,
26-nov-14,SIN.,"MAZATLAN, SIN.",12,3,15,0,1,0,
18-dic-14,TAMPS.,"MATAMOROS, TAMPS.",7,8,15,0,0,0,
24-dic-14,TAMPS.,"MATAMOROS, TAMPS.",8,7,15,0,0,0,
30-ene-15,TAMPS.,"MATAMOROS, TAMPS.",8,7,15,0,0,0,
31-ene-15,B.C.,"TIJUANA, B.C.",9,6,15,0,0,0,
12-ago-15,MEX.,"TLALNEPANTLA DE BAZ, MEX.",12,3,15,0,1,240,
18-ago-15,SIN.,"MAZATLAN, SIN.",11,4,15,0,0,0,
28-ago-15,B.C.,"MEXICALI, B.C.",7,8,15,0,0,0,
03-sep-15,MEX.,"COYOTEPEC, MEX.",13,2,15,0,0,0,
22-sep-15,SIN.,"MAZATLAN, SIN.",12,3,15,0,2,0,
05-oct-15,MEX.,"ECATEPEC DE MOR., MEX.",12,3,15,0,0,100,
22-oct-15,D.F.,"ALVARO OBREGON, D.F.",9,6,15,0,5,190,
06-nov-15,D.F.,"COYOACAN, D.F.",12,3,15,0,12,38,
02-dic-15,B.C.,"TIJUANA, B.C.",9,6,15,0,0,0,
05-dic-15,CHIS.,"TUXTLA GUTIÉRREZ, CHIS.",11,4,15,6,0,1957,
09-dic-15,S.L.P.,"SAN LUIS POTOSI, S.L.P.",15,0,15,1,0,0,
11-dic-15,D.F.,"CUAUHTEMOC, D.F.",8,7,15,0,9,10,
04-abr-16,S.L.P.,"SAN LUIS POTOSI, S.L.P.",13,2,15,0,0,0,
27-sep-16,SIN.,"SIN., SIN.",13,2,15,0,3,0,
01-oct-16,SIN.,"GUASAVE, SIN.",10,5,15,0,4,0,
19-oct-16,SIN.,"EL FUERTE, SIN.",11,4,15,0,8,0,
04-nov-16,SIN.,"GUASAVE, SIN.",10,5,15,0,8,0,
10-nov-16,MEX.,"NEZAHUALCOYOTL, MEX.",12,3,15,31,1,49,
05-may-17,GTO.,"SALAMANCA, GTO.",10,5,15,0,0,0,
01-jun-17,CHIH.,"HGO. DEL PARRAL, CHIH.",14,1,15,7,0,1206,
27-jul-17,ZAC.,"FRESNILLO, ZAC.",12,3,15,5,1,43,
20-sep-17,SIN.,"AHOME, SIN.",10,5,15,0,1,0,
17-nov-17,SON.,"HERMOSILLO, SON.",13,2,15,1,0,305,
04-dic-17,GTO.,"LEON, GTO.",6,9,15,0,0,0,
30-ene-18,D.F.,"CUAUHTEMOC, D.F.",13,2,15,0,0,1431,
15-feb-18,COAH.,"MATAMOROS, COAH.",9,6,15,0,0,0,
06-mar-18,CHIH.,"CHIH., CHIH.",9,6,15,0,0,504,
05-mar-19,CD. MÉX.,"BENITO JUAREZ, CD. MÉX.",12,3,15,0,0,448,
19-mar-19,CD. MÉX.,"COYOACAN, CD. MÉX.",11,4,15,0,1,228,
11-jun-19,CD. MÉX.,"AZCAPOTZALCO, CD. MÉX.",4,11,15,0,0,1267,
07-ago-19,CD. MÉX.,"BENITO JUAREZ, CD. MÉX.",12,3,15,0,0,747,
22-ago-19,MÉX.,"TLALNEPANTLA DE BAZ, MEX.",11,4,15,0,2,1385,
02-sep-19,TAMPS.,"REYNOSA, TAMPS.",8,7,15,66,0,443,
10-jun-22,SIN.,"AHOME, SIN.",13,2,15,0,0,127,
06-sep-22,MÉX.,"ECATEPEC DE MOR., MEX.",15,0,15,0,18,489,
09-nov-22,MÉX.,"IXTAPALUCA, MEX.",15,0,15,0,0,20,
11-nov-22,GTO.,"LEON, GTO.",14,1,15,0,0,514,
09-dic-22,CHIH.,"CHIH., CHIH.",11,4,15,6,0,644,
15-jun-23,Guanajuato,"LEON, GTO.",10,5,15,6,0,233,
17-jun-23,Guanajuato,"LEON, GTO.",10,5,15,5,0,144,
28-jun-24,Sinaloa,"SALVADOR ALVARADO, SIN.",15,0,15,0,6,"2,438",
17-ene-13,TAMPS.,"REYNOSA, TAMPS.",11,3,14,13,0,791,
11-feb-13,TAMPS.,"VICTORIA, TAMPS.",8,6,14,0,0,100,
03-mar-13,MICH.,"LAZARO CARDENAS, MICH.",11,3,14,9,1,165,
06-mar-13,AGS.,"AGS., AGS.",12,2,14,5,0,121,
06-mar-13,MEX.,"METEPEC, MEX.",13,1,14,3,1,123,
08-mar-13,MEX.,"METEPEC, MEX.",14,0,14,4,1,280,
10-mar-13,N.L.,"GUADALUPE, N.L.",12,2,14,2,1,8243,
11-mar-13,GRO.,"ACAPULCO DE JUAREZ, GRO.",10,4,14,4,8,69,
14-mar-13,CHIH.,"DELICIAS, CHIH.",13,1,14,0,0,0,
22-mar-13,MEX.,"TULTEPEC, MEX.",10,4,14,3,4,14,
02-abr-13,MEX.,"HUEHUETOCA, MEX.",8,6,14,1,1,0,
03-abr-13,MEX.,"ZINACANTEPEC, MEX.",13,1,14,0,0,11,
11-abr-13,B.C.,"MEXICALI, B.C.",7,7,14,0,0,0,
18-abr-13,MEX.,"AMECAMECA, MEX.",12,2,14,0,10,0,
22-abr-13,MICH.,"LA PIEDAD, MICH.",14,0,14,0,0,0,
29-abr-13,D.F.,"BENITO JUAREZ, D.F.",12,2,14,0,5,100,
07-may-13,SIN.,"CHOIX, SIN.",10,4,14,0,0,0,
18-may-13,TAB.,"CENTRO, TAB.",11,3,14,26,7,60,
21-may-13,B.C.,"MEXICALI, B.C.",8,6,14,0,0,0,
22-may-13,MICH.,"URUAPAN, MICH.",8,6,14,0,0,0,
22-may-13,MICH.,"URUAPAN, MICH.",8,6,14,0,0,0,
29-may-13,MICH.,"URUAPAN, MICH.",10,4,14,0,0,0,
28-jun-13,PUE.,"PUE., PUE.",9,5,14,2,2,3026,
13-sep-13,B.C.,"MEXICALI, B.C.",12,2,14,0,0,0,
01-oct-13,N.L.,"ANAHUAC, N.L.",4,10,14,3,0,0,
11-oct-13,COAH.,"NUEVA ROSITA, COAH.",6,8,14,11,0,178,
14-oct-13,D.F.,"COYOACAN, D.F.",10,4,14,2,0,3,
24-oct-13,D.F.,"BENITO JUAREZ, D.F.",10,4,14,35,0,65,
15-nov-13,D.F.,"MILPA ALTA, D.F.",5,9,14,0,0,120,
20-nov-13,D.F.,"CUAUHTEMOC, D.F.",10,4,14,0,0,21,
18-dic-13,D.F.,"CUAUHTEMOC, D.F.",12,2,14,0,1,0,
18-dic-13,TAMPS.,"MATAMOROS, TAMPS.",7,7,14,0,0,175,
20-dic-13,TAMPS.,"MATAMOROS, TAMPS.",8,6,14,0,3,0,
10-feb-14,N.L.,"MONTERREY, N.L.",3,11,14,14,0,7253,
11-feb-14,D.F.,"CUAUHTEMOC, D.F.",14,0,14,0,1,118,
14-feb-14,D.F.,"CUAUHTEMOC, D.F.",12,2,14,0,0,110,
10-mar-14,N.L.,"MONTERREY, N.L.",3,11,14,11,0,7203,
11-mar-14,N.L.,"MONTERREY, N.L.",12,2,14,80,0,7187,
14-mar-14,B.C.,"MEXICALI, B.C.",8,6,14,0,0,0,
31-mar-14,MEX.,"NICOLAS ROMERO, MEX.",12,2,14,0,0,0,
02-abr-14,MEX.,"COACALCO DE BERRIOZABAL, MEX.",10,4,14,0,0,0,
08-abr-14,MEX.,"TLALNEPANTLA DE BAZ, MEX.",12,2,14,2,0,558,
03-may-14,DGO.,"DGO., DGO.",9,5,14,0,0,0,
08-may-14,MEX.,"TEXCOCO, MEX.",10,4,14,0,2,0,
14-may-14,MEX.,"ATLACOMULCO, MEX.",14,0,14,0,0,0,
14-may-14,DGO.,"DGO., DGO.",9,5,14,8,1,0,
23-may-14,MEX.,"NAUCALPAN DE JUAREZ, MEX.",9,5,14,3,0,318,
23-may-14,MEX.,"TULTEPEC, MEX.",13,1,14,2,0,63,
27-may-14,SIN.,"CULIACAN, SIN.",12,2,14,0,1,0,
06-jun-14,SIN.,"CHOIX, SIN.",6,8,14,0,4,0,
23-jul-14,CHIH.,"JUÁREZ, CHIH.",8,6,14,0,0,0,
30-ago-14,MICH.,"ZAMORA, MICH.",8,6,14,0,0,128,
05-sep-14,MICH.,"SAHUAYO, MICH.",10,4,14,2,0,6,
20-sep-14,COAH.,"SALTILLO, COAH.",4,10,14,0,0,0,
06-oct-14,MICH.,"ZINAPECUARO, MICH.",3,11,14,2,0,17,
13-oct-14,GTO.,"SALAMANCA, GTO.",9,5,14,0,0,0,
20-oct-14,CHIS.,"COMITAN DE DOMÍNGUEZ, CHIS.",8,6,14,6,0,485,
22-oct-14,CHIS.,"VILLAFLORES, CHIS.",8,6,14,2,0,0,
25-oct-14,CHIS.,"TUXTLA GUTIÉRREZ, CHIS.",13,1,14,7,1,1090,
27-oct-14,CHIS.,"VILLAFLORES, CHIS.",8,6,14,0,0,0,
29-oct-14,CHIS.,"COMITAN DE DOMÍNGUEZ, CHIS.",10,4,14,2,0,281,
05-nov-14,D.F.,"CUAJIMALPA DE MOR., D.F.",14,0,14,0,0,80,
06-nov-14,CHIS.,"VILLAFLORES, CHIS.",11,3,14,2,0,122,
15-dic-14,N.L.,"MONTERREY, N.L.",5,9,14,0,0,6795,
29-dic-14,TAMPS.,"MATAMOROS, TAMPS.",8,6,14,0,0,6,
11-ago-15,D.F.,"MIGUEL HGO., D.F.",12,2,14,0,0,0,
12-ago-15,CHIH.,"CHIH., CHIH.",13,1,14,7,1,216,
12-ago-15,MEX.,"TOLUCA, MEX.",9,5,14,4,0,0,
13-ago-15,MEX.,"TLALNEPANTLA DE BAZ, MEX.",7,7,14,0,0,40,
14-ago-15,SIN.,"MAZATLAN, SIN.",12,2,14,0,0,0,
14-ago-15,SIN.,"CULIACAN, SIN.",11,3,14,0,2,0,
15-ago-15,MEX.,"ZUMPANGO, MEX.",9,5,14,0,0,50,
17-ago-15,CHIH.,"CHIH., CHIH.",9,5,14,8,0,455,
20-ago-15,COAH.,"SALTILLO, COAH.",11,3,14,0,0,830,
20-ago-15,DGO.,"DGO., DGO.",14,0,14,1,0,0,
22-ago-15,MEX.,"LERMA, MEX.",14,0,14,0,0,0,
24-ago-15,COAH.,"TORREÓN, COAH.",12,2,14,1,0,158,
24-ago-15,COAH.,"MONCLOVA, COAH.",9,5,14,2,0,595,
26-ago-15,OAX.,"OAX. DE JUAREZ, OAX.",3,11,14,0,0,0,
27-ago-15,OAX.,"OAX. DE JUAREZ, OAX.",0,14,14,0,0,0,
02-sep-15,MEX.,"COYOTEPEC, MEX.",12,2,14,0,0,0,
04-sep-15,MEX.,"COYOTEPEC, MEX.",10,4,14,0,1,0,
05-sep-15,MEX.,"ATIZAPAN DE ZARAGOZA, MEX.",12,2,14,4,1,40,
11-sep-15,MEX.,"CHALCO, MEX.",9,5,14,0,0,50,
01-oct-15,B.C.,"TIJUANA, B.C.",7,7,14,0,0,0,
11-oct-15,MEX.,"ECATEPEC DE MOR., MEX.",11,3,14,0,0,148,
22-oct-15,B.C.,"TIJUANA, B.C.",10,4,14,0,0,0,
23-oct-15,MEX.,"NEZAHUALCOYOTL, MEX.",13,1,14,0,4,312,
29-oct-15,SIN.,"GUASAVE, SIN.",12,2,14,0,1,0,
11-nov-15,D.F.,"CUAUHTEMOC, D.F.",8,6,14,0,2,0,
13-nov-15,D.F.,"CUAUHTEMOC, D.F.",6,8,14,0,6,1,
19-nov-15,N.L.,"MONTERREY, N.L.",3,11,14,0,0,0,
22-nov-15,D.F.,"CUAUHTEMOC, D.F.",3,11,14,0,0,15,
07-dic-15,B.C.,"TIJUANA, B.C.",9,5,14,0,0,0,
08-dic-15,S.L.P.,"SAN LUIS POTOSI, S.L.P.",12,2,14,0,0,0,
16-dic-15,D.F.,"CUAUHTEMOC, D.F.",5,9,14,0,0,46,
11-mar-16,D.F.,"TLAHUAC, D.F.",8,6,14,42,0,1032,
17-mar-16,GTO.,"SALAMANCA, GTO.",13,1,14,0,0,430,
18-mar-16,GTO.,"SALAMANCA, GTO.",12,2,14,1,2,8,
06-abr-16,D.F.,"IZTAPALAPA, D.F.",10,4,14,88,6,133,
08-abr-16,D.F.,"IZTAPALAPA, D.F.",5,9,14,171,3,165,
14-abr-16,D.F.,"IZTAPALAPA, D.F.",5,9,14,106,0,646,
27-may-16,N.L.,"MONTERREY, N.L.",5,9,14,5,0,981,
09-jun-16,D.F.,"VENUSTIANO CARRANZA, D.F.",10,4,14,162,3,1352,
23-jun-16,D.F.,"BENITO JUAREZ, D.F.",9,5,14,0,16,0,
31-ago-16,CHIS.,"CHAMULA, CHIS.",2,12,14,0,0,0,
02-sep-16,SIN.,"MOCORITO, SIN.",7,7,14,0,0,0,
22-sep-16,SIN.,"SIN., SIN.",13,1,14,0,10,0,
06-oct-16,SIN.,"CHOIX, SIN.",12,2,14,0,4,0,
15-oct-16,MEX.,"ECATEPEC DE MOR., MEX.",11,3,14,0,0,0,
10-nov-16,SIN.,"GUASAVE, SIN.",8,6,14,0,8,0,
10-ene-17,D.F.,"CUAUHTEMOC, D.F.",5,9,14,0,0,0,
16-mar-17,TAMPS.,"NUEVO LAREDO, TAMPS.",7,7,14,1,0,626,
22-may-17,D.F.,"BENITO JUAREZ, D.F.",13,1,14,0,0,8639,
08-jun-17,YUC.,"MERIDA, YUC.",14,0,14,6,0,111,
04-ago-17,CHIS.,"TUXTLA GUTIÉRREZ, CHIS.",13,1,14,0,0,566,
06-sep-17,GTO.,"GTO., GTO.",10,4,14,0,0,13,
07-sep-17,GTO.,"GTO., GTO.",7,7,14,0,1,70,
25-sep-17,DGO.,"DGO., DGO.",10,4,14,0,0,0,
07-dic-17,GTO.,"LEON, GTO.",4,10,14,0,0,0,
27-jul-18,GTO.,"IRAPUATO, GTO.",12,2,14,0,0,0,
07-ago-18,D.F.,"GUSTAVO A. MADERO, D.F.",11,3,14,0,7,283,
12-oct-18,GTO.,"LEON, GTO.",12,2,14,0,1,0,
19-oct-18,GTO.,"LEON, GTO.",11,3,14,0,0,0,
19-oct-18,CHIH.,"JUÁREZ, CHIH.",8,6,14,8,0,781,
24-oct-18,CHIH.,"JUÁREZ, CHIH.",3,11,14,7,0,1322,
09-nov-18,D.F.,"COYOACAN, D.F.",9,5,14,0,0,7240,
19-feb-19,CD. MÉX.,"CUAUHTEMOC, CD. MÉX.",13,1,14,0,0,3958,
06-mar-19,CHIS.,"TUXTLA GUTIÉRREZ, CHIS.",12,2,14,2,4,1960,
29-abr-19,CD. MÉX.,"VENUSTIANO CARRANZA, CD. MÉX.",11,3,14,0,2,1465,
24-jun-19,CD. MÉX.,"IZTACALCO, CD. MÉX.",12,2,14,0,0,420,
15-ago-19,CD. MÉX.,"IZTAPALAPA, CD. MÉX.",12,2,14,0,0,110,
25-sep-19,MÉX.,"CHIMALHUACAN, MEX.",13,1,14,6,0,0,
11-oct-19,CD. MÉX.,"IZTAPALAPA, CD. MÉX.",0,14,14,0,0,139,
15-oct-19,CD. MÉX.,"IZTAPALAPA, CD. MÉX.",4,10,14,0,0,0,
06-dic-19,GTO.,"LEON, GTO.",11,3,14,0,0,0,
18-dic-19,CD. MÉX.,"IZTAPALAPA, CD. MÉX.",4,10,14,0,0,54,
23-ene-20,CD. MÉX.,"GUSTAVO A. MADERO, CD. MÉX.",13,1,14,0,0,778,
04-feb-20,CD. MÉX.,"GUSTAVO A. MADERO, CD. MÉX.",13,1,14,0,0,3426,
11-mar-20,SIN.,"AHOME, SIN.",4,10,14,0,2,0,
30-nov-21,CHIH.,"JUÁREZ, CHIH.",10,4,14,59,0,420,
17-dic-21,OAX.,"JUCHITAN DE ZARAGOZA, OAX.",13,1,14,0,0,199,
27-ago-22,MÉX.,"CHIMALHUACAN, MEX.",12,2,14,2,0,22,
04-oct-22,MÉX.,"CHALCO, MEX.",14,0,14,0,0,71,
10-oct-22,SIN.,"MAZATLAN, SIN.",14,0,14,0,0,404,
17-mar-23,México,"ATIZAPAN, MEX.",14,0,14,0,0,0,
21-mar-23,México,"TOLUCA, MEX.",13,1,14,0,0,"1,331",
08-may-23,Sinaloa,"NAVOLATO, SIN.",10,4,14,0,5,277,
17-may-23,Sinaloa,"CULIACAN, SIN.",14,0,14,0,0,72,
20-jun-23,México,"TECAMAC, MEX.",13,1,14,0,0,127,
24-jun-23,México,"TECAMAC, MEX.",14,0,14,0,0,106,
05-jul-23,Michoacán,"ZAMORA, MICH.",1,13,14,47,0,302,
06-jul-23,Sinaloa,"GUASAVE, SIN.",4,10,14,0,0,0,
31-ago-23,Querétaro,"QUERETARO, QRO.",6,8,14,11,17,647,
12-oct-23,Sinaloa,"MAZATLAN, SIN.",4,10,14,0,0,135,
08-feb-13,CHIH.,"CHIH., CHIH.",11,2,13,0,0,655,
17-feb-13,GRO.,"ACAPULCO DE JUAREZ, GRO.",2,11,13,0,0,0,
18-feb-13,MEX.,"TULTITLAN, MEX.",10,3,13,0,0,163,
02-mar-13,N.L.,"SAN NICOLAS DE LOS GARZA, N.L.",5,8,13,0,0,190,
16-mar-13,MEX.,"NICOLAS ROMERO, MEX.",12,1,13,6,0,142,
02-abr-13,SIN.,"AHOME, SIN.",12,1,13,0,10,0,
07-abr-13,MICH.,"MORELIA, MICH.",8,5,13,0,0,0,
09-abr-13,MEX.,"TEJUPILCO, MEX.",12,1,13,10,0,0,
10-abr-13,MEX.,"TEOTIHUACAN, MEX.",10,3,13,3,2,136,
13-abr-13,QRO.,"QUERETARO, QRO.",9,4,13,0,2,0,
14-abr-13,MICH.,"ZAMORA, MICH.",12,1,13,0,0,0,
20-abr-13,QRO.,"SAN JUAN DEL RIO, QRO.",8,5,13,0,2,0,
16-may-13,MICH.,"URUAPAN, MICH.",4,9,13,0,0,0,
18-may-13,YUC.,"VALLADOLID, YUC.",6,7,13,0,0,164,
20-may-13,CHIS.,"LAS MARGARITAS, CHIS.",10,3,13,0,0,100,
20-may-13,MICH.,"ZITACUARO, MICH.",7,6,13,0,0,0,
31-may-13,MICH.,"URUAPAN, MICH.",10,3,13,0,0,0,
17-jun-13,B.C.,"MEXICALI, B.C.",5,8,13,0,0,0,
24-jun-13,MEX.,"NAUCALPAN DE JUAREZ, MEX.",12,1,13,2,0,286,
27-jun-13,GTO.,"GTO., GTO.",1,12,13,0,0,0,
10-jul-13,MOR.,"CUERNAVACA, MOR.",11,2,13,0,1,86,
14-jul-13,N.L.,"APODACA, N.L.",8,5,13,13,0,1757,
05-ago-13,D.F.,"TLAHUAC, D.F.",11,2,13,2,1,35,
07-ago-13,D.F.,"TLAHUAC, D.F.",11,2,13,0,1,30,
19-ago-13,D.F.,"IZTAPALAPA, D.F.",8,5,13,0,1,285,
19-ago-13,GTO.,"SAN FRANCISCO DEL RINCON, GTO.",10,3,13,0,0,0,
07-oct-13,D.F.,"LA MAGDALENA CONTRERAS, D.F.",9,4,13,2,1,250,
11-oct-13,COAH.,"PIEDRAS NEGRAS, COAH.",9,4,13,1,1,885,
22-oct-13,D.F.,"BENITO JUAREZ, D.F.",8,5,13,0,0,502,
12-dic-13,D.F.,"CUAUHTEMOC, D.F.",10,3,13,0,3,800,
27-feb-14,CHIH.,"JUÁREZ, CHIH.",8,5,13,0,1,49,
24-mar-14,MEX.,"TECAMAC, MEX.",10,3,13,0,0,0,
31-mar-14,QRO.,"SAN JUAN DEL RIO, QRO.",2,11,13,0,0,0,
08-abr-14,MEX.,"NAUCALPAN DE JUAREZ, MEX.",12,1,13,13,6,488,
11-abr-14,MEX.,"CUAUTITLAN, MEX.",6,7,13,2,6,91,
17-abr-14,DGO.,"DGO., DGO.",9,4,13,0,5,0,
07-may-14,MEX.,"SAN MATEO ATENCO, MEX.",13,0,13,0,0,50,
07-may-14,MEX.,"IXTAPALUCA, MEX.",10,3,13,0,4,0,
08-may-14,DGO.,"DGO., DGO.",11,2,13,2,1,0,
15-may-14,MEX.,"NOPALTEPEC, MEX.",9,4,13,0,1,0,
16-may-14,TAMPS.,"MATAMOROS, TAMPS.",4,9,13,0,0,0,
24-may-14,MEX.,"NAUCALPAN DE JUAREZ, MEX.",10,3,13,1,0,100,
24-may-14,MEX.,"TIANGUISTENCO, MEX.",9,4,13,0,0,0,
05-jun-14,SIN.,"BADIRAGUATO, SIN.",7,6,13,0,0,0,
05-jun-14,SIN.,"CULIACAN, SIN.",7,6,13,0,0,0,
07-jun-14,MEX.,"TEJUPILCO, MEX.",9,4,13,4,0,0,
13-jun-14,MEX.,"IXTLAHUACA, MEX.",8,5,13,0,0,85,
21-jun-14,MEX.,"IXTAPALUCA, MEX.",10,3,13,0,0,0,
21-jun-14,MEX.,"CUAUTITLAN IZCALLI, MEX.",9,4,13,0,0,0,
21-jun-14,MEX.,"TULTITLAN, MEX.",12,1,13,0,0,0,
15-ago-14,SIN.,"MAZATLAN, SIN.",10,3,13,0,10,0,
01-sep-14,TAMPS.,"MATAMOROS, TAMPS.",7,6,13,0,0,0,
02-sep-14,MICH.,"ZAMORA, MICH.",8,5,13,4,0,139,
02-sep-14,MICH.,"TACAMBARO, MICH.",8,5,13,5,0,828,
05-sep-14,MICH.,"ZITACUARO, MICH.",9,4,13,2,0,0,
05-oct-14,N.L.,"MONTERREY, N.L.",11,2,13,12,4,131,
18-oct-14,CHIS.,"TAPACHULA, CHIS.",9,4,13,0,0,101,
19-oct-14,MICH.,"ARIO, MICH.",7,6,13,0,0,1686,
20-oct-14,CHIS.,"TAPACHULA, CHIS.",10,3,13,0,0,27,
24-oct-14,TAMPS.,"MATAMOROS, TAMPS.",10,3,13,0,0,0,
26-oct-14,CHIS.,"TUXTLA GUTIÉRREZ, CHIS.",5,8,13,0,2,1463,
27-oct-14,CHIS.,"COMITAN DE DOMÍNGUEZ, CHIS.",8,5,13,3,0,63,
28-oct-14,CHIS.,"COMITAN DE DOMÍNGUEZ, CHIS.",8,5,13,1,0,290,
29-oct-14,CHIS.,"VILLAFLORES, CHIS.",7,6,13,0,0,0,
30-oct-14,CHIS.,"VILLAFLORES, CHIS.",0,13,13,12,2,0,
31-oct-14,CHIS.,"TAPACHULA, CHIS.",10,3,13,0,1,3011,
03-nov-14,D.F.,"CUAJIMALPA DE MOR., D.F.",12,1,13,0,0,150,
04-nov-14,D.F.,"CUAJIMALPA DE MOR., D.F.",13,0,13,0,0,0,
06-nov-14,SIN.,"EL FUERTE, SIN.",6,7,13,0,0,0,
11-nov-14,SIN.,"CHOIX, SIN.",8,5,13,0,0,0,
10-dic-14,TAMPS.,"MATAMOROS, TAMPS.",11,2,13,0,0,43,
12-dic-14,TAMPS.,"MATAMOROS, TAMPS.",8,5,13,0,0,0,
16-dic-14,TAMPS.,"MATAMOROS, TAMPS.",7,6,13,3,0,70,
22-dic-14,GRO.,"IGUALA DE LA INDEPENDENCIA, GRO.",8,5,13,0,0,0,
27-feb-15,TAMPS.,"MATAMOROS, TAMPS.",6,7,13,0,0,0,
28-mar-15,OAX.,"OAX. DE JUAREZ, OAX.",3,10,13,0,0,30,
04-ago-15,D.F.,"MIGUEL HGO., D.F.",9,4,13,0,1,0,
10-ago-15,DGO.,"DGO., DGO.",12,1,13,2,1,0,
11-ago-15,DGO.,"DGO., DGO.",9,4,13,13,3,0,
11-ago-15,COAH.,"ACUÑA, COAH.",11,2,13,0,0,0,
12-ago-15,DGO.,"DGO., DGO.",10,3,13,8,2,0,
13-ago-15,SIN.,"CULIACAN, SIN.",7,6,13,0,0,0,
15-ago-15,COAH.,"SALTILLO, COAH.",5,8,13,0,0,117,
20-ago-15,COAH.,"SALTILLO, COAH.",10,3,13,2,0,188,
20-ago-15,COAH.,"MONCLOVA, COAH.",10,3,13,0,0,191,
25-ago-15,SIN.,"MAZATLAN, SIN.",8,5,13,0,9,0,
27-ago-15,SIN.,"MAZATLAN, SIN.",11,2,13,0,9,0,
31-ago-15,COAH.,"TORREÓN, COAH.",11,2,13,5,0,24,
01-sep-15,MEX.,"COYOTEPEC, MEX.",9,4,13,0,0,0,
03-sep-15,COAH.,"SALTILLO, COAH.",11,2,13,0,0,150,
04-sep-15,SIN.,"MAZATLAN, SIN.",12,1,13,0,8,0,
04-sep-15,B.C.,"MEXICALI, B.C.",4,9,13,0,0,0,
08-sep-15,SIN.,"MAZATLAN, SIN.",11,2,13,0,4,0,
09-sep-15,COAH.,"SALTILLO, COAH.",11,2,13,16,3,118,
11-sep-15,SIN.,"MAZATLAN, SIN.",10,3,13,0,5,0,
15-sep-15,D.F.,"CUAJIMALPA DE MOR., D.F.",6,7,13,0,0,2,
24-sep-15,MEX.,"TEZOYUCA, MEX.",11,2,13,0,0,0,
12-oct-15,D.F.,"ALVARO OBREGON, D.F.",4,9,13,0,0,50,
30-oct-15,SIN.,"GUASAVE, SIN.",9,4,13,0,0,0,
05-nov-15,D.F.,"COYOACAN, D.F.",7,6,13,0,0,0,
05-dic-15,S.L.P.,"SAN LUIS POTOSI, S.L.P.",12,1,13,0,0,25,
10-dic-15,S.L.P.,"SAN LUIS POTOSI, S.L.P.",10,3,13,7,0,232,
05-mar-16,TAMPS.,"MATAMOROS, TAMPS.",11,2,13,5,0,492,
07-abr-16,D.F.,"IZTAPALAPA, D.F.",11,2,13,169,2,261,
20-ago-16,MEX.,"TLALNEPANTLA DE BAZ, MEX.",9,4,13,3,1,319,
26-sep-16,SIN.,"SIN., SIN.",13,0,13,0,6,0,
07-nov-16,SIN.,"GUASAVE, SIN.",10,3,13,0,8,0,
24-may-17,SIN.,"SIN., SIN.",13,0,13,0,0,0,
29-jul-17,ZAC.,"FRESNILLO, ZAC.",11,2,13,8,0,15,
16-ago-17,MEX.,"CHIMALHUACAN, MEX.",9,4,13,0,1,145,
18-oct-17,ZAC.,"FRESNILLO, ZAC.",7,6,13,0,0,80,
28-nov-17,GTO.,"CELAYA, GTO.",2,11,13,0,0,0,
06-dic-17,GTO.,"LEON, GTO.",6,7,13,0,0,0,
16-ago-18,D.F.,"BENITO JUAREZ, D.F.",8,5,13,0,3,99,
25-sep-18,MEX.,"IXTAPALUCA, MEX.",11,2,13,36,0,0,
15-oct-18,GTO.,"LEON, GTO.",8,5,13,0,4,0,
28-feb-19,CD. MÉX.,"CUAUHTEMOC, CD. MÉX.",12,1,13,0,1,4947,
12-mar-19,CD. MÉX.,"BENITO JUAREZ, CD. MÉX.",7,6,13,0,0,104,
09-abr-19,CD. MÉX.,"MIGUEL HGO., CD. MÉX.",11,2,13,0,1,1579,
24-abr-19,CD. MÉX.,"ALVARO OBREGON, CD. MÉX.",7,6,13,0,0,963,
23-jul-19,CHIH.,"DELICIAS, CHIH.",11,2,13,5,0,200,
03-oct-19,MÉX.,"CHIMALHUACAN, MEX.",8,5,13,3,4,198,
28-ene-20,CD. MÉX.,"GUSTAVO A. MADERO, CD. MÉX.",13,0,13,0,0,515,
31-ene-20,CD. MÉX.,"GUSTAVO A. MADERO, CD. MÉX.",11,2,13,0,1,534,
07-feb-20,CD. MÉX.,"IZTAPALAPA, CD. MÉX.",10,3,13,0,1,189,
19-feb-20,SIN.,"GUASAVE, SIN.",3,10,13,0,0,0,
10-mar-20,CHIH.,"JUÁREZ, CHIH.",12,1,13,25,0,324,
26-nov-21,CHIH.,"JUÁREZ, CHIH.",8,5,13,3,1,508,
18-mar-23,México,"ECATEPEC DE MORELOS, MEX.",13,0,13,0,0,343,
12-may-23,Sinaloa,"NAVOLATO, SIN.",12,1,13,0,0,"2,156",
14-ago-23,Sinaloa,"SALVADOR ALVARADO, SIN.",11,2,13,0,1,174,
06-feb-13,CAMP.,"CAMP., CAMP.",10,2,12,0,0,0,
15-feb-13,D.F.,"MIGUEL HGO., D.F.",9,3,12,0,2,0,
22-feb-13,HGO.,"TULANCINGO DE BRAVO, HGO.",9,3,12,0,0,0,
25-feb-13,CHIS.,"SAN CRISTOBAL DE LAS CASAS, CHIS.",3,9,12,2,0,106,
26-feb-13,MEX.,"COACALCO DE BERRIOZABAL, MEX.",9,3,12,2,4,229,
03-mar-13,MEX.,"IXTAPALUCA, MEX.",9,3,12,4,0,28,
05-mar-13,N.L.,"SAN NICOLAS DE LOS GARZA, N.L.",5,7,12,4,0,2250,
15-mar-13,MEX.,"CUAUTITLAN, MEX.",1,11,12,2,0,46,
01-abr-13,MICH.,"MORELIA, MICH.",9,3,12,0,0,0,
01-abr-13,MEX.,"HUEHUETOCA, MEX.",10,2,12,0,0,0,
09-abr-13,MEX.,"ATLACOMULCO, MEX.",12,0,12,0,0,9,
12-abr-13,QRO.,"QUERETARO, QRO.",8,4,12,0,0,0,
12-abr-13,MEX.,"ATLACOMULCO, MEX.",8,4,12,0,0,0,
15-abr-13,MICH.,"APATZINGAN, MICH.",9,3,12,0,0,0,
15-may-13,MICH.,"URUAPAN, MICH.",6,6,12,0,0,0,
20-may-13,VER.,"VER., VER.",10,2,12,0,0,169,
26-may-13,MICH.,"HUETAMO, MICH.",8,4,12,8,0,0,
27-may-13,D.F.,"MILPA ALTA, D.F.",8,4,12,0,0,0,
02-jun-13,MICH.,"ZITACUARO, MICH.",10,2,12,3,0,0,
04-jun-13,N.L.,"ANAHUAC, N.L.",1,11,12,25,0,1157,
21-jun-13,MEX.,"NAUCALPAN DE JUAREZ, MEX.",7,5,12,3,0,300,
23-jun-13,MEX.,"NAUCALPAN DE JUAREZ, MEX.",12,0,12,4,6,499,
05-jul-13,GTO.,"LEON, GTO.",5,7,12,0,0,0,
16-jul-13,PUE.,"PUE., PUE.",8,4,12,2,1,0,
30-jul-13,N.L.,"MONTERREY, N.L.",6,6,12,50,0,1394,
30-jul-13,QRO.,"QUERETARO, QRO.",4,8,12,0,0,0,
06-ago-13,D.F.,"TLAHUAC, D.F.",9,3,12,2,2,29,
08-ago-13,JAL.,"ZAPOPAN, JAL.",8,4,12,0,0,0,
10-ago-13,QRO.,"TEQUISQUIAPAN, QRO.",7,5,12,0,0,0,
13-ago-13,HGO.,"IXMIQUILPAN, HGO.",12,0,12,0,0,200,
15-ago-13,COAH.,"RAMOS ARIZPE, COAH.",8,4,12,0,0,0,
22-ago-13,N.L.,"VALLECILLO, N.L.",1,11,12,0,0,110,
23-ago-13,N.L.,"ITURBIDE, N.L.",2,10,12,34,0,533,
01-sep-13,GTO.,"CELAYA, GTO.",11,1,12,0,0,0,
09-sep-13,B.C.,"MEXICALI, B.C.",10,2,12,0,0,0,
30-sep-13,D.F.,"AZCAPOTZALCO, D.F.",7,5,12,2,2,20,
15-oct-13,COAH.,"PIEDRAS NEGRAS, COAH.",3,9,12,1,0,417,
21-oct-13,D.F.,"BENITO JUAREZ, D.F.",9,3,12,0,4,40,
25-nov-13,N.L.,"MONTERREY, N.L.",4,8,12,0,0,1930,
10-dic-13,SON.,"HERMOSILLO, SON.",6,6,12,33,0,1450,
15-dic-13,D.F.,"CUAUHTEMOC, D.F.",12,0,12,3,0,0,
14-ene-14,PUE.,"PUE., PUE.",12,0,12,4,0,283,
05-mar-14,D.F.,"MIGUEL HGO., D.F.",12,0,12,2,27,250,
11-mar-14,VER.,"VER., VER.",9,3,12,0,1,11,
24-mar-14,MEX.,"CHICOLOAPAN, MEX.",8,4,12,0,0,0,
25-mar-14,MEX.,"TECAMAC, MEX.",9,3,12,0,10,0,
29-mar-14,QRO.,"SAN JUAN DEL RIO, QRO.",6,6,12,0,3,0,
31-mar-14,MEX.,"TULTITLAN, MEX.",10,2,12,5,0,114,
03-abr-14,MEX.,"TULTITLAN, MEX.",9,3,12,1,1,58,
05-abr-14,MEX.,"NICOLAS ROMERO, MEX.",7,5,12,5,0,111,
09-abr-14,MEX.,"CUAUTITLAN IZCALLI, MEX.",9,3,12,2,2,46,
10-abr-14,MEX.,"CUAUTITLAN IZCALLI, MEX.",12,0,12,1,0,162,
18-abr-14,DGO.,"DGO., DGO.",10,2,12,22,1,0,
22-abr-14,MEX.,"HUIXQUILUCAN, MEX.",5,7,12,153,6,153,
02-may-14,DGO.,"DGO., DGO.",10,2,12,11,0,0,
02-may-14,MEX.,"HUEHUETOCA, MEX.",9,3,12,0,0,0,
06-may-14,SIN.,"AHOME, SIN.",9,3,12,0,10,0,
07-may-14,MEX.,"TEXCOCO, MEX.",12,0,12,0,0,0,
10-may-14,MEX.,"IXTAPALUCA, MEX.",10,2,12,0,0,0,
12-may-14,MEX.,"CHALCO, MEX.",10,2,12,5,1,170,
17-may-14,MEX.,"CHALCO, MEX.",9,3,12,1,0,0,
26-may-14,MEX.,"ZINACANTEPEC, MEX.",10,2,12,2,2,0,
26-may-14,SIN.,"EL FUERTE, SIN.",7,5,12,0,2,0,
28-may-14,SIN.,"CULIACAN, SIN.",10,2,12,0,0,0,
30-may-14,MEX.,"ZINACANTEPEC, MEX.",9,3,12,0,0,0,
06-jun-14,MEX.,"TEQUIXQUIAC, MEX.",10,2,12,0,0,0,
10-jun-14,SIN.,"SIN., SIN.",5,7,12,0,2,0,
13-jun-14,SIN.,"CHOIX, SIN.",0,12,12,0,0,0,
20-jun-14,MEX.,"CUAUTITLAN IZCALLI, MEX.",11,1,12,0,1,158,
21-jun-14,TAMPS.,"MATAMOROS, TAMPS.",4,8,12,0,0,0,
24-jun-14,MEX.,"TLALNEPANTLA DE BAZ, MEX.",9,3,12,0,0,500,
07-ago-14,SIN.,"MAZATLAN, SIN.",9,3,12,0,7,0,
25-ago-14,AGS.,"JESÚS MARÍA, AGS.",9,3,12,0,0,107,
30-ago-14,MICH.,"MORELIA, MICH.",7,5,12,6,0,0,
12-sep-14,TAMPS.,"MATAMOROS, TAMPS.",6,6,12,0,0,0,
26-sep-14,AGS.,"AGS., AGS.",8,4,12,7,0,262,
01-oct-14,B.C.,"MEXICALI, B.C.",5,7,12,0,0,0,
04-oct-14,TAMPS.,"MATAMOROS, TAMPS.",9,3,12,0,0,0,
04-oct-14,B.C.,"TIJUANA, B.C.",7,5,12,0,0,0,
14-oct-14,SON.,"HERMOSILLO, SON.",11,1,12,12,0,154,
19-oct-14,CHIS.,"COMITAN DE DOMÍNGUEZ, CHIS.",5,7,12,0,0,669,
21-oct-14,CHIS.,"VILLAFLORES, CHIS.",7,5,12,2,0,0,
25-oct-14,CHIS.,"COMITAN DE DOMÍNGUEZ, CHIS.",8,4,12,2,0,27,
28-oct-14,CHIS.,"VILLAFLORES, CHIS.",5,7,12,0,0,0,
30-oct-14,CHIS.,"TAPACHULA, CHIS.",9,3,12,0,0,1677,
06-nov-14,CHIS.,"TUXTLA GUTIÉRREZ, CHIS.",9,3,12,4,5,2451,
11-nov-14,CHIS.,"COMITAN DE DOMÍNGUEZ, CHIS.",10,2,12,0,0,181,
12-nov-14,CHIS.,"TUXTLA GUTIÉRREZ, CHIS.",9,3,12,5,0,404,
13-dic-14,TAMPS.,"MATAMOROS, TAMPS.",7,5,12,0,0,0,
24-dic-14,DGO.,"DGO., DGO.",11,1,12,10,5,0,
31-ene-15,TAMPS.,"MATAMOROS, TAMPS.",5,7,12,0,0,0,
01-feb-15,B.C.,"TIJUANA, B.C.",5,7,12,0,0,0,
25-mar-15,DGO.,"GOMEZ PALACIO, DGO.",12,0,12,0,0,0,
08-ago-15,MEX.,"TEXCOCO, MEX.",8,4,12,0,1,0,
12-ago-15,SIN.,"MAZATLAN, SIN.",3,9,12,0,0,0,
13-ago-15,SIN.,"MAZATLAN, SIN.",10,2,12,0,5,0,
14-ago-15,MEX.,"TLALNEPANTLA DE BAZ, MEX.",9,3,12,0,3,0,
14-ago-15,COAH.,"SALTILLO, COAH.",10,2,12,2,2,53,
18-ago-15,COAH.,"SALTILLO, COAH.",9,3,12,0,1,0,
18-ago-15,MEX.,"LERMA, MEX.",10,2,12,2,0,0,
21-ago-15,SIN.,"CULIACAN, SIN.",10,2,12,0,10,0,
21-ago-15,MEX.,"LERMA, MEX.",7,5,12,0,5,0,
24-ago-15,COAH.,"SALTILLO, COAH.",6,6,12,2,0,420,
25-ago-15,COAH.,"MONCLOVA, COAH.",10,2,12,11,0,100,
02-sep-15,COAH.,"PIEDRAS NEGRAS, COAH.",7,5,12,0,3,103,
08-sep-15,B.C.,"ENSENADA, B.C.",8,4,12,0,0,0,
17-sep-15,B.C.,"TIJUANA, B.C.",7,5,12,0,0,0,
24-sep-15,SIN.,"MAZATLAN, SIN.",10,2,12,0,3,0,
26-sep-15,B.C.,"MEXICALI, B.C.",3,9,12,0,0,0,
29-sep-15,COAH.,"MONCLOVA, COAH.",3,9,12,6,0,151,
29-sep-15,SIN.,"EL FUERTE, SIN.",6,6,12,0,7,0,
30-sep-15,COAH.,"SALTILLO, COAH.",10,2,12,0,1,76,
05-oct-15,SIN.,"EL FUERTE, SIN.",11,1,12,0,5,0,
07-oct-15,MEX.,"ECATEPEC DE MOR., MEX.",12,0,12,0,0,523,
19-oct-15,D.F.,"ALVARO OBREGON, D.F.",5,7,12,0,0,5,
04-nov-15,SIN.,"GUASAVE, SIN.",4,8,12,0,0,0,
10-nov-15,MEX.,"TECAMAC, MEX.",10,2,12,2,2,171,
12-nov-15,N.L.,"MONTERREY, N.L.",7,5,12,5,0,1050,
12-nov-15,MEX.,"TECAMAC, MEX.",7,5,12,7,1,129,
13-nov-15,GRO.,"AJUCHITLAN DEL PROGRESO, GRO.",8,4,12,0,0,40,
09-dic-15,S.L.P.,"SAN LUIS POTOSI, S.L.P.",10,2,12,2,0,242,
12-dic-15,SON.,"NAVOJOA, SON.",9,3,12,1,0,50,
27-ene-16,CHIH.,"NUEVO CASAS GRANDES, CHIH.",7,5,12,0,0,37,
02-mar-16,COAH.,"SALTILLO, COAH.",7,5,12,0,0,0,
03-abr-16,TAMPS.,"MATAMOROS, TAMPS.",8,4,12,0,0,0,
11-abr-16,D.F.,"IZTAPALAPA, D.F.",5,7,12,221,0,41,
08-jun-16,D.F.,"VENUSTIANO CARRANZA, D.F.",10,2,12,324,4,107,
28-jun-16,SIN.,"MAZATLAN, SIN.",11,1,12,0,4,0,
29-jun-16,SIN.,"MAZATLAN, SIN.",8,4,12,0,16,0,
01-jul-16,SIN.,"AHOME, SIN.",8,4,12,0,2,0,
18-ago-16,MEX.,"TLALNEPANTLA DE BAZ, MEX.",7,5,12,5,0,77,
30-ago-16,CHIS.,"TUXTLA GUTIÉRREZ, CHIS.",1,11,12,0,0,0,
23-sep-16,SIN.,"SIN., SIN.",10,2,12,0,2,0,
04-oct-16,SIN.,"CHOIX, SIN.",7,5,12,0,4,0,
09-nov-16,MEX.,"NEZAHUALCOYOTL, MEX.",5,7,12,0,0,0,
17-nov-16,MEX.,"TECAMAC, MEX.",9,3,12,13,0,0,
20-nov-16,MEX.,"TECAMAC, MEX.",7,5,12,5,0,0,
12-dic-16,GTO.,"LEON, GTO.",8,4,12,0,7,0,
03-ene-17,B.C.,"TIJUANA, B.C.",0,12,12,0,0,0,
21-abr-17,TAMPS.,"MATAMOROS, TAMPS.",9,3,12,4,0,260,
03-may-17,GTO.,"SALAMANCA, GTO.",10,2,12,0,0,0,
02-jun-17,SIN.,"SIN., SIN.",9,3,12,0,0,0,
12-ago-17,MEX.,"ATIZAPAN, MEX.",9,3,12,5,0,532,
12-sep-17,GTO.,"GTO., GTO.",11,1,12,0,0,13,
13-sep-17,ZAC.,"FRESNILLO, ZAC.",11,1,12,0,0,90,
28-oct-17,TAMPS.,"REYNOSA, TAMPS.",9,3,12,0,0,158,
16-nov-17,SON.,"HERMOSILLO, SON.",12,0,12,0,0,0,
05-dic-17,GTO.,"LEON, GTO.",4,8,12,0,0,0,
13-feb-18,ZAC.,"FRESNILLO, ZAC.",8,4,12,4,0,32,
28-mar-18,QRO.,"QUERETARO, QRO.",9,3,12,0,1,0,
08-ago-18,CHIS.,"TUXTLA GUTIÉRREZ, CHIS.",5,7,12,1,1,106,
16-ago-18,MEX.,"ATIZAPAN, MEX.",8,4,12,2,0,131,
18-ago-18,MEX.,"ATIZAPAN, MEX.",3,9,12,0,0,164,
19-ago-18,CHIS.,"TUXTLA GUTIÉRREZ, CHIS.",7,5,12,0,0,119,
10-oct-18,GTO.,"LEON, GTO.",9,3,12,0,0,0,
25-oct-18,CHIH.,"JUÁREZ, CHIH.",2,10,12,4,0,374,
27-feb-19,CD. MÉX.,"CUAUHTEMOC, CD. MÉX.",11,1,12,0,0,482,
07-mar-19,CD. MÉX.,"BENITO JUAREZ, CD. MÉX.",9,3,12,0,1,1261,
30-abr-19,CHIH.,"JUÁREZ, CHIH.",4,8,12,0,0,474,
21-may-19,CD. MÉX.,"VENUSTIANO CARRANZA, CD. MÉX.",11,1,12,0,0,236,
21-may-19,CD. MÉX.,"IZTAPALAPA, CD. MÉX.",9,3,12,0,0,42,
24-may-19,CD. MÉX.,"VENUSTIANO CARRANZA, CD. MÉX.",10,2,12,0,0,123,
26-jul-19,CHIH.,"DELICIAS, CHIH.",8,4,12,7,0,254,
01-ago-19,MOR.,"CUERNAVACA, MOR.",8,4,12,1,0,711,
05-ago-19,CD. MÉX.,"BENITO JUAREZ, CD. MÉX.",11,1,12,0,0,197,
10-oct-19,MÉX.,"CHIMALHUACAN, MEX.",10,2,12,4,0,164,
22-nov-19,CD. MÉX.,"CUAUHTEMOC, CD. MÉX.",5,7,12,0,0,959,
17-dic-19,CD. MÉX.,"IZTAPALAPA, CD. MÉX.",1,11,12,0,0,0,
06-mar-20,CHIH.,"CHIH., CHIH.",10,2,12,1,0,176,
10-jul-20,CD. MÉX.,"GUSTAVO A. MADERO, CD. MÉX.",1,11,12,0,0,2534,
10-dic-21,CHIH.,"CHIH., CHIH.",10,2,12,0,1,572,
14-dic-21,CHIH.,"JUÁREZ, CHIH.",9,3,12,21,0,1000,
28-ene-22,CD. MÉX.,"MIGUEL HGO., CD. MÉX.",10,2,12,0,0,456,
07-jun-22,SIN.,"AHOME, SIN.",8,4,12,4,0,109,
22-jun-22,JAL.,"GUADALAJARA, JAL.",12,0,12,4,0,371,
09-sep-22,ZAC.,"FRESNILLO, ZAC.",8,4,12,24,1,1027,
20-oct-22,MOR.,"PUENTE DE IXTLA, MOR.",8,4,12,0,0,0,
09-nov-22,GTO.,"LEON, GTO.",8,4,12,0,0,0,
12-nov-22,GTO.,"LEON, GTO.",5,7,12,0,5,0,
21-mar-23,Chihuahua,"CHIHUAHUA, CHIH.",7,5,12,32,0,574,
05-may-23,Sinaloa,"CULIACAN, SIN.",9,3,12,0,0,140,
13-jun-23,México,"LA PAZ, MEX.",12,0,12,0,0,32,
16-jun-23,México,"LA PAZ, MEX.",11,1,12,0,0,127,
29-jun-23,Guanajuato,"SALVATIERRA, GTO.",5,7,12,6,2,18,
03-jul-23,México,"VALLE DE CHALCO SOLIDARIDAD, MEX.",10,2,12,0,0,0,
03-oct-23,Tamaulipas,"VICTORIA, TAMPS.",9,3,12,0,0,0,
25-mar-24,Cd. de México,"GUSTAVO A. MADERO, CD. MÉX.",9,3,12,0,0,436,
14-jun-24,Michoacán,"APATZINGAN, MICH.",7,5,12,45,0,0,
30-ene-13,TAMPS.,"GUSTAVO DIAZ ORDAZ, TAMPS.",5,6,11,0,0,0,
04-feb-13,B.C.,"TIJUANA, B.C.",4,7,11,0,0,0,
09-feb-13,TAMPS.,"MATAMOROS, TAMPS.",7,4,11,0,0,41,
03-mar-13,N.L.,"GRAL. ESCOBEDO, N.L.",6,5,11,4,1,198,
08-mar-13,N.L.,"SANTA CATARINA, N.L.",2,9,11,0,0,1923,
14-mar-13,S.L.P.,"CIUDAD VALLES, S.L.P.",5,6,11,2,0,46,
01-abr-13,MEX.,"ZINACANTEPEC, MEX.",8,3,11,0,0,24,
03-abr-13,MEX.,"HUEHUETOCA, MEX.",10,1,11,0,0,0,
03-abr-13,MICH.,"ZAMORA, MICH.",10,1,11,0,0,0,
07-abr-13,MEX.,"ZINACANTEPEC, MEX.",6,5,11,0,0,198,
08-abr-13,MEX.,"TEJUPILCO, MEX.",8,3,11,3,0,0,
09-abr-13,MICH.,"ZAMORA, MICH.",7,4,11,0,0,0,
10-abr-13,N.L.,"LOS HERRERAS, N.L.",2,9,11,10,0,50,
11-abr-13,MEX.,"TEOTIHUACAN, MEX.",6,5,11,3,2,183,
11-abr-13,MEX.,"TEOTIHUACAN, MEX.",6,5,11,3,2,183,
12-abr-13,MEX.,"MALINALCO, MEX.",5,6,11,2,0,0,
16-abr-13,MEX.,"AMECAMECA, MEX.",9,2,11,3,0,105,
16-abr-13,MICH.,"APATZINGAN, MICH.",9,2,11,0,0,0,
17-abr-13,MEX.,"TENANGO DEL VALLE, MEX.",9,2,11,2,0,0,
20-abr-13,QRO.,"EZEQUIEL MONTES, QRO.",8,3,11,0,1,0,
22-abr-13,D.F.,"COYOACAN, D.F.",11,0,11,0,0,208,
25-abr-13,OAX.,"TLACOLULA DE MATAMOROS, OAX.",7,4,11,0,0,0,
27-abr-13,OAX.,"SAN ANTONIO DE LA CAL, OAX.",5,6,11,7,0,0,
30-abr-13,MICH.,"ZACAPU, MICH.",8,3,11,0,0,0,
02-may-13,MICH.,"ZACAPU, MICH.",8,3,11,0,0,0,
07-may-13,MICH.,"ZACAPU, MICH.",5,6,11,0,0,0,
08-may-13,MICH.,"ZACAPU, MICH.",6,5,11,0,0,0,
08-may-13,SIN.,"CHOIX, SIN.",10,1,11,0,0,0,
17-may-13,MICH.,"URUAPAN, MICH.",7,4,11,0,0,0,
18-may-13,Q. ROO,"BENITO JUAREZ, Q. ROO",10,1,11,7,8,617,
19-may-13,S.L.P.,"SAN LUIS POTOSI, S.L.P.",1,10,11,0,3,50,
31-may-13,MICH.,"ZITACUARO, MICH.",7,4,11,2,1,0,
08-jun-13,MICH.,"APATZINGAN, MICH.",3,8,11,0,1,0,
20-jun-13,MEX.,"NAUCALPAN DE JUAREZ, MEX.",5,6,11,2,0,426,
20-jun-13,TAMPS.,"EL MANTE, TAMPS.",11,0,11,0,0,0,
22-jun-13,COAH.,"TORREÓN, COAH.",6,5,11,0,0,0,
24-jun-13,GTO.,"LEON, GTO.",8,3,11,0,0,0,
27-jun-13,PUE.,"TEHUACAN, PUE.",7,4,11,0,0,0,
27-jun-13,MEX.,"NAUCALPAN DE JUAREZ, MEX.",6,5,11,3,0,79,
29-jun-13,MEX.,"NAUCALPAN DE JUAREZ, MEX.",9,2,11,2,0,74,
06-jul-13,CHIS.,"TAPACHULA, CHIS.",7,4,11,0,0,85,
13-jul-13,B.C.,"TIJUANA, B.C.",3,8,11,0,0,0,
26-jul-13,CHIS.,"TUXTLA GUTIÉRREZ, CHIS.",6,5,11,0,4,2021,
16-ago-13,COAH.,"RAMOS ARIZPE, COAH.",9,2,11,0,0,0,
12-sep-13,B.C.,"MEXICALI, B.C.",9,2,11,0,0,0,
14-nov-13,D.F.,"MILPA ALTA, D.F.",6,5,11,0,0,150,
25-nov-13,SON.,"CABORCA, SON.",5,6,11,2,0,0,
13-dic-13,D.F.,"CUAUHTEMOC, D.F.",10,1,11,0,0,250,
16-dic-13,SON.,"EMPALME, SON.",11,0,11,0,0,0,
07-feb-14,VER.,"BOCA DEL RIO, VER.",11,0,11,0,0,0,
07-abr-14,MEX.,"NAUCALPAN DE JUAREZ, MEX.",9,2,11,3,0,150,
11-abr-14,TAMPS.,"MATAMOROS, TAMPS.",1,10,11,0,0,300,
12-abr-14,MEX.,"NAUCALPAN DE JUAREZ, MEX.",8,3,11,5,0,520,
14-abr-14,MEX.,"ECATEPEC DE MOR., MEX.",8,3,11,0,0,0,
19-abr-14,DGO.,"DGO., DGO.",7,4,11,1,0,0,
21-abr-14,SIN.,"AHOME, SIN.",7,4,11,0,0,0,
21-abr-14,MEX.,"CHIMALHUACAN, MEX.",8,3,11,0,0,548,
24-abr-14,MEX.,"OCOYOACAC, MEX.",9,2,11,3,0,143,
26-abr-14,TAMPS.,"MATAMOROS, TAMPS.",2,9,11,0,0,0,
29-abr-14,MEX.,"TEOLOYUCAN, MEX.",8,3,11,0,0,0,
29-abr-14,SIN.,"SALVADOR ALVARADO, SIN.",6,5,11,0,0,0,
09-may-14,MEX.,"IXTAPALUCA, MEX.",11,0,11,0,0,500,
09-may-14,SIN.,"GUASAVE, SIN.",8,3,11,0,0,0,
12-may-14,MEX.,"AMECAMECA, MEX.",9,2,11,0,0,0,
14-may-14,MEX.,"AMECAMECA, MEX.",4,7,11,0,3,0,
06-jun-14,MEX.,"TOLUCA, MEX.",10,1,11,0,0,102,
07-jun-14,MEX.,"TEQUIXQUIAC, MEX.",10,1,11,0,0,0,
11-jun-14,SIN.,"SIN., SIN.",3,8,11,0,12,0,
11-jun-14,MEX.,"IXTLAHUACA, MEX.",7,4,11,0,0,0,
18-jun-14,MEX.,"CUAUTITLAN IZCALLI, MEX.",9,2,11,0,1,149,
19-jun-14,MEX.,"VALLE DE CHALCO SOLIDARIDAD, MEX.",8,3,11,0,0,0,
19-jun-14,MEX.,"CUAUTITLAN IZCALLI, MEX.",9,2,11,0,0,0,
19-jun-14,MEX.,"TULTITLAN, MEX.",7,4,11,1,0,5,
24-jun-14,SIN.,"SIN., SIN.",1,10,11,0,0,0,
24-jun-14,MEX.,"CHALCO, MEX.",7,4,11,0,1,0,
27-jun-14,TAMPS.,"MATAMOROS, TAMPS.",5,6,11,0,0,0,
30-jun-14,D.F.,"LA MAGDALENA CONTRERAS, D.F.",10,1,11,0,1,300,
11-jul-14,CHIH.,"JUÁREZ, CHIH.",7,4,11,0,0,0,
19-jul-14,TAMPS.,"MATAMOROS, TAMPS.",9,2,11,0,0,128,
19-jul-14,N.L.,"ANAHUAC, N.L.",3,8,11,0,0,50,
21-jul-14,CHIH.,"JUÁREZ, CHIH.",9,2,11,0,0,0,
25-jul-14,CHIH.,"JUÁREZ, CHIH.",6,5,11,0,0,0,
01-ago-14,CHIH.,"JUÁREZ, CHIH.",4,7,11,0,0,0,
12-ago-14,SIN.,"MAZATLAN, SIN.",10,1,11,0,4,0,
19-ago-14,B.C.,"MEXICALI, B.C.",1,10,11,0,0,0,
20-ago-14,SIN.,"COSALA, SIN.",4,7,11,0,0,0,
26-ago-14,PUE.,"SAN PEDRO CHOLULA, PUE.",11,0,11,2,1,97,
22-sep-14,AGS.,"AGS., AGS.",8,3,11,0,0,163,
30-sep-14,B.C.,"MEXICALI, B.C.",3,8,11,0,0,0,
17-oct-14,CHIS.,"TAPACHULA, CHIS.",8,3,11,0,1,67,
20-oct-14,CHIS.,"OCOZOCOAUTLA DE ESPINOSA, CHIS.",8,3,11,0,0,5,
21-oct-14,MICH.,"ARIO, MICH.",5,6,11,0,0,0,
24-oct-14,CHIS.,"COMITAN DE DOMÍNGUEZ, CHIS.",3,8,11,1,1,445,
30-oct-14,CHIS.,"OCOZOCOAUTLA DE ESPINOSA, CHIS.",6,5,11,1,0,951,
08-nov-14,TAMPS.,"MATAMOROS, TAMPS.",5,6,11,0,0,0,
12-nov-14,CHIS.,"OCOZOCOAUTLA DE ESPINOSA, CHIS.",9,2,11,0,0,23,
13-nov-14,CHIS.,"TUXTLA GUTIÉRREZ, CHIS.",8,3,11,4,1,875,
08-dic-14,N.L.,"MONTERREY, N.L.",8,3,11,49,0,5370,
16-dic-14,DGO.,"DGO., DGO.",11,0,11,6,3,0,
20-dic-14,DGO.,"GOMEZ PALACIO, DGO.",4,7,11,4,0,0,
28-dic-14,DGO.,"DGO., DGO.",9,2,11,0,0,0,
31-dic-14,DGO.,"LERDO, DGO.",10,1,11,2,0,0,
06-ene-15,DGO.,"GOMEZ PALACIO, DGO.",8,3,11,0,0,0,
09-ene-15,TAMPS.,"MATAMOROS, TAMPS.",5,6,11,0,0,0,
24-ene-15,TAMPS.,"MATAMOROS, TAMPS.",2,9,11,0,0,0,
25-mar-15,OAX.,"OAX. DE JUAREZ, OAX.",3,8,11,0,0,216,
25-mar-15,YUC.,"MERIDA, YUC.",8,3,11,0,0,403,
05-ago-15,D.F.,"MIGUEL HGO., D.F.",11,0,11,0,3,0,
11-ago-15,SIN.,"CULIACAN, SIN.",8,3,11,0,0,0,
20-ago-15,SIN.,"MAZATLAN, SIN.",9,2,11,0,4,0,
25-ago-15,COAH.,"SALTILLO, COAH.",8,3,11,2,0,929,
28-ago-15,MEX.,"CHICONCUAC, MEX.",8,3,11,0,0,0,
29-ago-15,MEX.,"CHICONCUAC, MEX.",10,1,11,0,9,0,
29-ago-15,COAH.,"PIEDRAS NEGRAS, COAH.",2,9,11,0,0,30,
31-ago-15,MEX.,"COYOTEPEC, MEX.",9,2,11,2,0,68,
02-sep-15,COAH.,"SALTILLO, COAH.",9,2,11,0,2,390,
03-sep-15,COAH.,"TORREÓN, COAH.",5,6,11,0,0,16,
03-sep-15,COAH.,"TORREÓN, COAH.",5,6,11,0,0,16,
05-sep-15,MEX.,"COYOTEPEC, MEX.",9,2,11,0,0,0,
09-sep-15,SIN.,"MAZATLAN, SIN.",9,2,11,0,0,0,
14-sep-15,B.C.,"TIJUANA, B.C.",8,3,11,0,0,0,
21-sep-15,DGO.,"DGO., DGO.",2,9,11,5,0,0,
22-sep-15,B.C.,"MEXICALI, B.C.",5,6,11,0,0,0,
25-sep-15,B.C.S.,"LA PAZ, B.C.S.",7,4,11,0,0,0,
25-sep-15,SIN.,"MAZATLAN, SIN.",9,2,11,0,8,0,
30-sep-15,SIN.,"BADIRAGUATO, SIN.",6,5,11,0,0,0,
09-oct-15,SIN.,"EL FUERTE, SIN.",9,2,11,0,5,0,
05-nov-15,MEX.,"CAPULHUAC, MEX.",5,6,11,10,0,249,
09-nov-15,COAH.,"SALTILLO, COAH.",11,0,11,0,0,49,
11-nov-15,COAH.,"MÚZQUIZ, COAH.",1,10,11,0,0,0,
11-nov-15,COAH.,"ACUÑA, COAH.",1,10,11,1,7,3,
13-nov-15,COAH.,"SALTILLO, COAH.",11,0,11,0,8,429,
13-nov-15,SIN.,"SIN., SIN.",11,0,11,0,4,0,
11-dic-15,CHIH.,"HGO. DEL PARRAL, CHIH.",10,1,11,5,0,287,
15-dic-15,D.F.,"CUAUHTEMOC, D.F.",7,4,11,0,10,27,
23-feb-16,OAX.,"OAX. DE JUAREZ, OAX.",3,8,11,0,0,0,
03-mar-16,COAH.,"SALTILLO, COAH.",8,3,11,0,0,620,
06-abr-16,S.L.P.,"SAN LUIS POTOSI, S.L.P.",10,1,11,0,1,0,
24-jun-16,SIN.,"MAZATLAN, SIN.",6,5,11,0,11,0,
11-ago-16,S.L.P.,"SAN LUIS POTOSI, S.L.P.",7,4,11,1,0,0,
16-ago-16,MEX.,"AMECAMECA, MEX.",8,3,11,7,0,356,
01-sep-16,CHIS.,"PUEBLO NUEVO SOLISTAHUACÁN, CHIS.",6,5,11,0,0,234,
02-sep-16,CHIS.,"SAN CRISTOBAL DE LAS CASAS, CHIS.",3,8,11,1,1,0,
30-sep-16,SIN.,"SIN., SIN.",9,2,11,0,4,0,
05-oct-16,SIN.,"CHOIX, SIN.",7,4,11,0,8,0,
31-oct-16,SIN.,"GUASAVE, SIN.",10,1,11,0,8,0,
09-nov-16,MEX.,"TEJUPILCO, MEX.",7,4,11,0,5,0,
11-nov-16,MEX.,"NEZAHUALCOYOTL, MEX.",8,3,11,0,0,86,
12-nov-16,MEX.,"NEZAHUALCOYOTL, MEX.",9,2,11,0,0,35,
15-nov-16,MEX.,"TECAMAC, MEX.",8,3,11,2,2,247,
08-ene-17,B.C.,"TIJUANA, B.C.",5,6,11,0,0,0,
31-may-17,SIN.,"SIN., SIN.",9,2,11,0,2,0,
10-ago-17,MEX.,"ATIZAPAN, MEX.",9,2,11,0,0,95,
11-ago-17,MEX.,"ATIZAPAN, MEX.",10,1,11,3,0,96,
22-ago-17,N.L.,"MONTERREY, N.L.",6,5,11,4,0,946,
04-nov-17,TAMPS.,"REYNOSA, TAMPS.",7,4,11,0,1,210,
26-ene-18,GTO.,"IRAPUATO, GTO.",6,5,11,0,2,7,
27-feb-18,COAH.,"SALTILLO, COAH.",9,2,11,2,0,235,
12-mar-18,COAH.,"SALTILLO, COAH.",9,2,11,2,0,85,
09-ago-18,CHIS.,"CHICOASÉN, CHIS.",9,2,11,4,0,186,
15-ago-18,D.F.,"BENITO JUAREZ, D.F.",10,1,11,0,0,185,
17-ago-18,MEX.,"ATIZAPAN, MEX.",6,5,11,1,4,1161,
25-ago-18,MEX.,"CHIMALHUACAN, MEX.",7,4,11,3,0,11,
20-sep-18,D.F.,"XOCHIMILCO, D.F.",11,0,11,0,0,1256,
05-feb-19,CD. MÉX.,"GUSTAVO A. MADERO, CD. MÉX.",11,0,11,0,2,32290,
21-feb-19,CD. MÉX.,"CUAUHTEMOC, CD. MÉX.",9,2,11,0,1,376,
07-mar-19,CHIS.,"TUXTLA GUTIÉRREZ, CHIS.",8,3,11,0,7,2318,
02-abr-19,CD. MÉX.,"MIGUEL HGO., CD. MÉX.",8,3,11,0,0,62,
08-abr-19,ZAC.,"FRESNILLO, ZAC.",0,11,11,0,0,0,
10-abr-19,CD. MÉX.,"MIGUEL HGO., CD. MÉX.",10,1,11,0,0,330,
16-abr-19,CD. MÉX.,"ALVARO OBREGON, CD. MÉX.",8,3,11,0,0,373,
22-may-19,CHIH.,"JUÁREZ, CHIH.",6,5,11,29,0,1578,
07-jun-19,MÉX.,"ECATEPEC DE MOR., MEX.",6,5,11,4,4,4916,
06-ago-19,CD. MÉX.,"BENITO JUAREZ, CD. MÉX.",10,1,11,0,0,820,
06-ago-19,MÉX.,"ATIZAPAN, MEX.",8,3,11,2,0,104,
22-ago-19,CD. MÉX.,"MIGUEL HGO., CD. MÉX.",11,0,11,0,0,35,
10-sep-19,CD. MÉX.,"IZTAPALAPA, CD. MÉX.",7,4,11,0,0,243,
23-sep-19,CD. MÉX.,"LA MAGDALENA CONTRERAS, CD. MÉX.",10,1,11,0,0,113,
26-sep-19,MÉX.,"CHIMALHUACAN, MEX.",9,2,11,3,0,0,
15-nov-19,CD. MÉX.,"BENITO JUAREZ, CD. MÉX.",6,5,11,0,0,1112,
29-nov-19,GTO.,"LEON, GTO.",9,2,11,0,0,0,
03-dic-19,CD. MÉX.,"XOCHIMILCO, CD. MÉX.",2,9,11,0,0,44,
13-dic-19,CD. MÉX.,"IZTAPALAPA, CD. MÉX.",3,8,11,0,0,275,
16-dic-19,CD. MÉX.,"IZTAPALAPA, CD. MÉX.",2,9,11,0,0,53,
09-mar-20,CD. MÉX.,"BENITO JUAREZ, CD. MÉX.",10,1,11,0,0,537,
13-mar-20,CHIH.,"JUÁREZ, CHIH.",7,4,11,7,1,837,
20-mar-20,CHIH.,"JUÁREZ, CHIH.",9,2,11,13,0,420,
23-oct-20,CD. MÉX.,"CUAUHTEMOC, CD. MÉX.",10,1,11,0,0,87,
30-sep-21,CHIH.,"DELICIAS, CHIH.",8,3,11,11,1,221,
31-ene-22,CD. MÉX.,"MIGUEL HGO., CD. MÉX.",9,2,11,0,0,1661,
08-jul-22,DGO.,"DGO., DGO.",11,0,11,0,2,0,
21-jul-22,VER.,"VER., VER.",2,9,11,0,0,0,
09-sep-22,MÉX.,"ECATEPEC DE MOR., MEX.",9,2,11,0,3,628,
13-oct-22,SIN.,"MAZATLAN, SIN.",7,4,11,0,0,307,
22-oct-22,MÉX.,"LA PAZ, MEX.",11,0,11,0,0,415,
08-dic-22,CHIH.,"NUEVO CASAS GRANDES, CHIH.",7,4,11,18,0,0,
22-mar-23,México,"SAN MATEO ATENCO, MEX.",11,0,11,0,0,90,
09-may-23,Sinaloa,"NAVOLATO, SIN.",9,2,11,0,1,62,
07-jun-23,Sinaloa,"EL FUERTE, SIN.",7,4,11,0,0,36,
24-jun-23,Michoacán,"ZAMORA, MICH.",8,3,11,11,0,214,
02-sep-23,Michoacán,"ZITACUARO, MICH.",4,7,11,9,0,100,
16-ene-13,D.F.,"IZTAPALAPA, D.F.",6,4,10,0,0,30,
31-ene-13,B.C.,"TECATE, B.C.",1,9,10,0,0,0,
06-feb-13,D.F.,"IZTAPALAPA, D.F.",7,3,10,0,1,0,
08-feb-13,CAMP.,"CAMP., CAMP.",8,2,10,0,1,0,
13-feb-13,D.F.,"MIGUEL HGO., D.F.",7,3,10,0,0,50,
14-feb-13,TAMPS.,"MATAMOROS, TAMPS.",4,6,10,0,0,0,
15-feb-13,TAMPS.,"CIUDAD MADERO, TAMPS.",10,0,10,0,0,0,
21-feb-13,MEX.,"TULTITLAN, MEX.",7,3,10,2,1,124,
21-feb-13,GRO.,"ACAPULCO DE JUAREZ, GRO.",3,7,10,0,0,0,
02-mar-13,N.L.,"SAN PEDRO GARZA GARCIA, N.L.",9,1,10,0,0,591,
03-mar-13,B.C.,"TECATE, B.C.",1,9,10,0,0,0,
04-mar-13,N.L.,"APODACA, N.L.",5,5,10,2,1,256,
05-mar-13,N.L.,"MONTERREY, N.L.",7,3,10,19,0,719,
05-mar-13,N.L.,"SANTA CATARINA, N.L.",9,1,10,0,0,3521,
12-mar-13,MEX.,"CUAUTITLAN, MEX.",7,3,10,0,0,389,
16-mar-13,MEX.,"HUIXQUILUCAN, MEX.",7,3,10,0,4,56,
22-mar-13,MEX.,"ZUMPANGO, MEX.",7,3,10,2,2,34,
25-mar-13,AGS.,"AGS., AGS.",6,4,10,1,0,84,
02-abr-13,MEX.,"VALLE DE BRAVO, MEX.",8,2,10,0,0,2,
09-abr-13,MICH.,"SALVADOR ESCALANTE, MICH.",7,3,10,3,0,0,
11-abr-13,OAX.,"CIUDAD IXTEPEC, OAX.",4,6,10,0,0,0,
12-abr-13,MICH.,"SALVADOR ESCALANTE, MICH.",9,1,10,0,0,0,
14-abr-13,MICH.,"MORELIA, MICH.",5,5,10,0,0,0,
15-abr-13,MEX.,"AMECAMECA, MEX.",7,3,10,0,8,0,
18-abr-13,MICH.,"LA PIEDAD, MICH.",10,0,10,0,0,0,
21-abr-13,MEX.,"AMECAMECA, MEX.",6,4,10,0,0,0,
23-abr-13,MICH.,"APATZINGAN, MICH.",8,2,10,0,0,0,
23-abr-13,MICH.,"APATZINGAN, MICH.",8,2,10,0,1,0,
29-abr-13,OAX.,"SANTO DOMINGO TEHUANTEPEC, OAX.",9,1,10,7,0,13,
01-may-13,MICH.,"AGUILILLA, MICH.",9,1,10,0,0,0,
09-may-13,SIN.,"CHOIX, SIN.",5,5,10,0,0,0,
23-may-13,SIN.,"SALVADOR ALVARADO, SIN.",9,1,10,0,14,0,
23-may-13,MICH.,"URUAPAN, MICH.",10,0,10,0,0,0,
31-may-13,N.L.,"LAMPAZOS DE NARANJO, N.L.",5,5,10,5,0,1200,
09-jun-13,B.C.S.,"MULEGÉ, B.C.S.",5,5,10,0,0,0,
16-jun-13,MEX.,"NAUCALPAN DE JUAREZ, MEX.",8,2,10,3,3,132,
26-jun-13,PUE.,"TEHUACAN, PUE.",6,4,10,7,0,220,
02-jul-13,PUE.,"PUE., PUE.",5,5,10,4,1,172,
03-jul-13,MEX.,"NAUCALPAN DE JUAREZ, MEX.",5,5,10,0,2,294,
17-jul-13,MOR.,"CUERNAVACA, MOR.",6,4,10,0,2,107,
09-ago-13,B.C.,"MEXICALI, B.C.",6,4,10,0,0,0,
21-ago-13,TAMPS.,"VICTORIA, TAMPS.",7,3,10,0,0,0,
23-ago-13,MOR.,"CUAUTLA, MOR.",2,8,10,1,0,82,
24-ago-13,B.C.,"MEXICALI, B.C.",10,0,10,0,0,0,
30-ago-13,TLAX.,"TLAX., TLAX.",6,4,10,5,0,9,
02-oct-13,N.L.,"LAMPAZOS DE NARANJO, N.L.",4,6,10,1,0,40,
03-oct-13,SIN.,"ROSARIO, SIN.",3,7,10,0,1,0,
08-oct-13,D.F.,"LA MAGDALENA CONTRERAS, D.F.",9,1,10,3,0,350,
13-nov-13,D.F.,"MILPA ALTA, D.F.",8,2,10,0,0,150,
19-nov-13,GTO.,"IRAPUATO, GTO.",9,1,10,0,0,0,
26-nov-13,COAH.,"PIEDRAS NEGRAS, COAH.",0,10,10,4,0,398,
27-nov-13,COAH.,"PIEDRAS NEGRAS, COAH.",2,8,10,2,2,48,
05-dic-13,N.L.,"SAN NICOLAS DE LOS GARZA, N.L.",7,3,10,4,0,335,
11-ene-14,PUE.,"PUE., PUE.",10,0,10,0,0,65,
08-mar-14,N.L.,"MONTERREY, N.L.",3,7,10,23,0,8149,
26-mar-14,MEX.,"ZUMPANGO, MEX.",7,3,10,1,1,103,
27-mar-14,QRO.,"COLON, QRO.",9,1,10,0,0,0,
01-abr-14,MEX.,"TULTITLAN, MEX.",7,3,10,0,0,254,
09-abr-14,GTO.,"ACAMBARO, GTO.",8,2,10,0,1,0,
11-abr-14,MEX.,"NAUCALPAN DE JUAREZ, MEX.",8,2,10,4,7,50,
11-abr-14,B.C.,"MEXICALI, B.C.",6,4,10,0,0,0,
13-abr-14,N.L.,"GUADALUPE, N.L.",9,1,10,2,0,150,
02-may-14,MEX.,"VALLE DE BRAVO, MEX.",6,4,10,2,0,348,
12-may-14,SIN.,"EL FUERTE, SIN.",5,5,10,0,3,0,
13-may-14,MEX.,"CHALCO, MEX.",8,2,10,0,0,0,
13-may-14,DGO.,"DGO., DGO.",8,2,10,24,6,0,
14-may-14,MEX.,"CHALCO, MEX.",5,5,10,0,2,0,
16-may-14,MEX.,"TENANGO DEL VALLE, MEX.",8,2,10,0,0,0,
19-may-14,MEX.,"TULTEPEC, MEX.",10,0,10,3,0,0,
21-may-14,MEX.,"TIANGUISTENCO, MEX.",6,4,10,0,0,0,
23-may-14,MEX.,"VALLE DE CHALCO SOLIDARIDAD, MEX.",9,1,10,0,0,0,
27-may-14,NAY.,"SANTA MARIA DEL ORO, NAY.",0,10,10,0,0,0,
02-jun-14,CHIH.,"CHIH., CHIH.",7,3,10,0,0,50,
06-jun-14,NAY.,"SANTA MARIA DEL ORO, NAY.",10,0,10,0,0,0,
10-jun-14,NAY.,"SANTA MARIA DEL ORO, NAY.",10,0,10,4,0,0,
17-jun-14,SIN.,"SIN., SIN.",7,3,10,0,4,0,
18-jun-14,MEX.,"TECAMAC, MEX.",10,0,10,0,0,0,
19-jun-14,N.L.,"LOS ALDAMAS, N.L.",1,9,10,11,0,0,
22-jun-14,TAMPS.,"MATAMOROS, TAMPS.",2,8,10,0,0,0,
26-jul-14,CHIH.,"JUÁREZ, CHIH.",2,8,10,0,0,0,
27-jul-14,CHIH.,"JUÁREZ, CHIH.",7,3,10,0,0,0,
30-jul-14,CHIH.,"JUÁREZ, CHIH.",6,4,10,0,0,0,
06-ago-14,COL.,"COL., COL.",10,0,10,0,0,281,
08-ago-14,TAMPS.,"MATAMOROS, TAMPS.",6,4,10,0,0,0,
13-ago-14,SIN.,"MAZATLAN, SIN.",6,4,10,0,6,0,
02-sep-14,MICH.,"LAZARO CARDENAS, MICH.",8,2,10,5,0,117,
08-sep-14,MICH.,"ZITACUARO, MICH.",9,1,10,2,0,0,
13-sep-14,TAMPS.,"MATAMOROS, TAMPS.",7,3,10,0,0,0,
24-sep-14,AGS.,"AGS., AGS.",6,4,10,4,0,310,
07-oct-14,MICH.,"ZINAPECUARO, MICH.",6,4,10,3,0,14,
18-oct-14,MICH.,"PATZCUARO, MICH.",8,2,10,5,0,0,
20-oct-14,CHIS.,"TUXTLA GUTIÉRREZ, CHIS.",5,5,10,2,6,961,
21-oct-14,CHIS.,"TAPACHULA, CHIS.",7,3,10,0,1,114,
25-oct-14,MICH.,"MORELIA, MICH.",7,3,10,2,0,2914,
28-oct-14,MICH.,"MORELIA, MICH.",6,4,10,2,0,645,
28-oct-14,CHIS.,"TAPACHULA, CHIS.",6,4,10,0,1,3613,
11-nov-14,SIN.,"AHOME, SIN.",5,5,10,0,0,0,
13-nov-14,CHIS.,"VILLAFLORES, CHIS.",6,4,10,0,0,115,
15-nov-14,TAMPS.,"MATAMOROS, TAMPS.",6,4,10,0,0,0,
19-nov-14,SIN.,"MAZATLAN, SIN.",8,2,10,0,0,0,
28-nov-14,TAMPS.,"MATAMOROS, TAMPS.",3,7,10,0,0,0,
19-dic-14,DGO.,"GOMEZ PALACIO, DGO.",3,7,10,2,0,0,
22-dic-14,TAMPS.,"MATAMOROS, TAMPS.",7,3,10,0,0,0,
26-dic-14,DGO.,"GOMEZ PALACIO, DGO.",8,2,10,3,1,0,
29-dic-14,DGO.,"DGO., DGO.",7,3,10,2,0,1,
06-ene-15,DGO.,"DGO., DGO.",9,1,10,3,0,0,
18-ene-15,TAMPS.,"MATAMOROS, TAMPS.",5,5,10,0,0,0,
28-feb-15,TAMPS.,"MATAMOROS, TAMPS.",5,5,10,0,0,0,
14-mar-15,TAMPS.,"MATAMOROS, TAMPS.",3,7,10,0,5,656,
04-ago-15,CHIH.,"CUAUHTÉMOC, CHIH.",7,3,10,0,0,168,
06-ago-15,MEX.,"NAUCALPAN DE JUAREZ, MEX.",7,3,10,1,1,50,
07-ago-15,COAH.,"ACUÑA, COAH.",1,9,10,0,0,0,
08-ago-15,MEX.,"NAUCALPAN DE JUAREZ, MEX.",9,1,10,61,4,708,
11-ago-15,SIN.,"MAZATLAN, SIN.",8,2,10,0,0,0,
12-ago-15,COAH.,"PIEDRAS NEGRAS, COAH.",6,4,10,0,0,393,
12-ago-15,COAH.,"SABINAS, COAH.",10,0,10,0,0,0,
13-ago-15,DGO.,"DGO., DGO.",8,2,10,8,0,0,
17-ago-15,DGO.,"DGO., DGO.",8,2,10,9,7,0,
17-ago-15,COAH.,"SALTILLO, COAH.",5,5,10,3,0,182,
19-ago-15,COAH.,"PIEDRAS NEGRAS, COAH.",6,4,10,3,0,0,
22-ago-15,DGO.,"DGO., DGO.",5,5,10,22,0,0,
27-ago-15,COAH.,"MONCLOVA, COAH.",9,1,10,2,0,121,
28-ago-15,SIN.,"MAZATLAN, SIN.",8,2,10,0,7,0,
31-ago-15,COAH.,"SALTILLO, COAH.",9,1,10,0,3,444,
01-sep-15,DGO.,"DGO., DGO.",8,2,10,11,0,0,
03-sep-15,SIN.,"MAZATLAN, SIN.",9,1,10,0,5,0,
12-sep-15,MEX.,"CHALCO, MEX.",9,1,10,0,4,0,
17-sep-15,COAH.,"SALTILLO, COAH.",9,1,10,0,2,556,
18-sep-15,COAH.,"SALTILLO, COAH.",5,5,10,2,3,260,
21-sep-15,COAH.,"TORREÓN, COAH.",7,3,10,0,0,0,
24-sep-15,MEX.,"TENANGO DEL VALLE, MEX.",7,3,10,3,0,0,
30-sep-15,B.C.,"MEXICALI, B.C.",4,6,10,0,0,0,
13-oct-15,MEX.,"LA PAZ, MEX.",6,4,10,0,0,0,
19-oct-15,SON.,"HERMOSILLO, SON.",8,2,10,6,1,5091,
21-oct-15,N.L.,"SAN NICOLAS DE LOS GARZA, N.L.",8,2,10,197,0,21,
29-oct-15,COAH.,"SALTILLO, COAH.",7,3,10,0,0,217,
11-nov-15,N.L.,"GRAL. ESCOBEDO, N.L.",6,4,10,200,0,650,
20-nov-15,SIN.,"SIN., SIN.",10,0,10,0,0,0,
24-nov-15,COAH.,"SALTILLO, COAH.",8,2,10,0,20,735,
01-dic-15,GRO.,"IGUALA DE LA INDEPENDENCIA, GRO.",8,2,10,0,0,49,
05-dic-15,COAH.,"SALTILLO, COAH.",8,2,10,0,0,0,
08-dic-15,D.F.,"CUAUHTEMOC, D.F.",3,7,10,0,0,25,
08-dic-15,SON.,"HERMOSILLO, SON.",3,7,10,1,0,0,
12-dic-15,D.F.,"CUAUHTEMOC, D.F.",3,7,10,0,6,8,
16-ene-16,COAH.,"PIEDRAS NEGRAS, COAH.",5,5,10,0,0,0,
03-mar-16,OAX.,"OAX. DE JUAREZ, OAX.",0,10,10,0,0,0,
04-mar-16,OAX.,"OAX. DE JUAREZ, OAX.",1,9,10,0,1,0,
18-abr-16,D.F.,"IZTACALCO, D.F.",5,5,10,405,1,317,
23-may-16,N.L.,"MONTERREY, N.L.",6,4,10,0,3,200,
06-ago-16,S.L.P.,"SAN LUIS POTOSI, S.L.P.",6,4,10,1,0,105,
26-ago-16,MEX.,"CUAUTITLAN, MEX.",8,2,10,8,0,65,
26-ago-16,MEX.,"CHIMALHUACAN, MEX.",8,2,10,0,0,152,
01-oct-16,SON.,"GUAYMAS, SON.",5,5,10,11,0,304,
03-oct-16,SIN.,"CHOIX, SIN.",10,0,10,0,3,0,
18-oct-16,SIN.,"EL FUERTE, SIN.",10,0,10,0,13,0,
08-nov-16,MEX.,"NEZAHUALCOYOTL, MEX.",9,1,10,4,1,66,
16-nov-16,MEX.,"TECAMAC, MEX.",8,2,10,0,0,0,
24-ene-17,MICH.,"MORELIA, MICH.",9,1,10,5,0,0,
13-feb-17,D.F.,"TLAHUAC, D.F.",9,1,10,0,0,6,
07-mar-17,CHIH.,"HGO. DEL PARRAL, CHIH.",9,1,10,4,0,224,
16-mar-17,VER.,"VER., VER.",7,3,10,0,0,0,
17-mar-17,MEX.,"ECATEPEC DE MOR., MEX.",9,1,10,0,0,421,
18-mar-17,QRO.,"QUERETARO, QRO.",3,7,10,0,0,0,
21-mar-17,MEX.,"TECAMAC, MEX.",7,3,10,0,0,3,
22-mar-17,MEX.,"NAUCALPAN DE JUAREZ, MEX.",8,2,10,4,0,5676,
24-mar-17,MEX.,"NAUCALPAN DE JUAREZ, MEX.",6,4,10,4,0,1452,
21-abr-17,S.L.P.,"SAN LUIS POTOSI, S.L.P.",7,3,10,0,1,39,
02-may-17,GTO.,"SALAMANCA, GTO.",10,0,10,0,0,0,
12-jun-17,YUC.,"MERIDA, YUC.",6,4,10,0,0,30,
13-jun-17,MEX.,"NEZAHUALCOYOTL, MEX.",10,0,10,3,0,25,
14-jun-17,MEX.,"NEZAHUALCOYOTL, MEX.",8,2,10,2,0,281,
13-jul-17,SIN.,"EL FUERTE, SIN.",5,5,10,0,4,0,
08-ago-17,CHIS.,"TAPACHULA, CHIS.",6,4,10,2,0,165,
12-sep-17,ZAC.,"FRESNILLO, ZAC.",7,3,10,0,0,274,
06-oct-17,SIN.,"AHOME, SIN.",7,3,10,0,0,251,
11-oct-17,ZAC.,"FRESNILLO, ZAC.",9,1,10,0,0,0,
25-ene-18,D.F.,"CUAUHTEMOC, D.F.",7,3,10,0,1,228,
27-ene-18,GTO.,"IRAPUATO, GTO.",4,6,10,0,0,0,
10-feb-18,TAMPS.,"MATAMOROS, TAMPS.",4,6,10,2,0,89,
27-feb-18,COAH.,"TORREÓN, COAH.",3,7,10,0,3,154,
10-ago-18,CHIS.,"TUXTLA GUTIÉRREZ, CHIS.",5,5,10,1,0,190,
21-ago-18,MEX.,"TLALNEPANTLA DE BAZ, MEX.",7,3,10,2,0,2768,
21-sep-18,D.F.,"XOCHIMILCO, D.F.",8,2,10,0,0,1836,
09-oct-18,GTO.,"LEON, GTO.",7,3,10,0,2,1,
26-oct-18,CHIH.,"JUÁREZ, CHIH.",6,4,10,15,0,418,
21-ene-19,CD. MÉX.,"GUSTAVO A. MADERO, CD. MÉX.",9,1,10,0,3,93,
04-mar-19,CHIS.,"TUXTLA GUTIÉRREZ, CHIS.",2,8,10,3,9,561,
05-mar-19,CHIS.,"TUXTLA GUTIÉRREZ, CHIS.",4,6,10,1,4,424,
08-mar-19,CD. MÉX.,"BENITO JUAREZ, CD. MÉX.",9,1,10,0,0,265,
22-abr-19,CD. MÉX.,"ALVARO OBREGON, CD. MÉX.",7,3,10,0,0,108,
25-abr-19,CD. MÉX.,"VENUSTIANO CARRANZA, CD. MÉX.",8,2,10,0,0,956,
07-may-19,CD. MÉX.,"TLALPAN, CD. MÉX.",9,1,10,0,0,372,
27-may-19,CD. MÉX.,"IZTAPALAPA, CD. MÉX.",7,3,10,0,0,507,
28-may-19,CD. MÉX.,"VENUSTIANO CARRANZA, CD. MÉX.",8,2,10,0,0,432,
07-jun-19,CD. MÉX.,"AZCAPOTZALCO, CD. MÉX.",10,0,10,0,0,345,
23-jul-19,CD. MÉX.,"IZTAPALAPA, CD. MÉX.",6,4,10,0,0,30,
30-jul-19,CHIH.,"NUEVO CASAS GRANDES, CHIH.",9,1,10,4,1,555,
16-ago-19,CD. MÉX.,"IZTAPALAPA, CD. MÉX.",9,1,10,0,0,160,
16-ago-19,NAY.,"TEPIC, NAY.",7,3,10,0,0,0,
21-ago-19,CD. MÉX.,"GUSTAVO A. MADERO, CD. MÉX.",10,0,10,0,0,4434,
06-sep-19,GTO.,"IRAPUATO, GTO.",4,6,10,0,0,0,
20-sep-19,CD. MÉX.,"COYOACAN, CD. MÉX.",9,1,10,0,0,8379,
08-oct-19,MÉX.,"HUIXQUILUCAN, MEX.",6,4,10,0,0,0,
12-oct-19,MÉX.,"CHIMALHUACAN, MEX.",7,3,10,3,0,0,
10-dic-19,CD. MÉX.,"IZTAPALAPA, CD. MÉX.",1,9,10,0,0,500,
29-ene-20,CD. MÉX.,"GUSTAVO A. MADERO, CD. MÉX.",7,3,10,0,0,1123,
14-feb-20,CD. MÉX.,"IZTAPALAPA, CD. MÉX.",6,4,10,0,0,205,
28-feb-20,CD. MÉX.,"IZTAPALAPA, CD. MÉX.",7,3,10,0,0,0,
13-mar-20,SIN.,"AHOME, SIN.",8,2,10,0,5,0,
06-dic-21,SON.,"HERMOSILLO, SON.",7,3,10,11,1,257,
20-dic-21,CHIH.,"JUÁREZ, CHIH.",6,4,10,4,1,1914,
03-feb-22,GTO.,"PURISIMA DEL RINCON, GTO.",2,8,10,0,0,0,
09-jun-22,SIN.,"AHOME, SIN.",8,2,10,1,0,12,
23-jun-22,JAL.,"GUADALAJARA, JAL.",8,2,10,8,0,291,
23-jun-22,GRO.,"ATOYAC DE ALVAREZ, GRO.",6,4,10,0,0,0,
15-jul-22,CD. MÉX.,"BENITO JUAREZ, CD. MÉX.",8,2,10,0,0,775,
15-jul-22,CHIH.,"JUÁREZ, CHIH.",7,3,10,7,0,442,
26-ago-22,MÉX.,"CHIMALHUACAN, MEX.",8,2,10,5,0,0,
14-oct-22,CD. MÉX.,"VENUSTIANO CARRANZA, CD. MÉX.",10,0,10,0,0,726,
18-oct-22,MÉX.,"LA PAZ, MEX.",6,4,10,0,0,146,
19-oct-22,MÉX.,"LA PAZ, MEX.",9,1,10,0,0,185,
04-nov-22,MÉX.,"CHICOLOAPAN, MEX.",10,0,10,0,0,0,
12-nov-22,MÉX.,"IXTAPALUCA, MEX.",10,0,10,0,0,0,
15-mar-23,México,"COACALCO DE BERRIOZABAL, MEX.",10,0,10,0,0,0,
15-mar-23,México,"ATIZAPAN, MEX.",10,0,10,0,0,0,
16-mar-23,México,"COACALCO DE BERRIOZABAL, MEX.",10,0,10,0,0,0,
18-mar-23,México,"ATIZAPAN, MEX.",10,0,10,0,0,100,
22-mar-23,Chihuahua,"CHIHUAHUA, CHIH.",7,3,10,24,0,224,
21-abr-23,Cd. de México,"BENITO JUAREZ, CD. MÉX.",7,3,10,0,0,574,
10-may-23,Sinaloa,"NAVOLATO, SIN.",6,4,10,0,0,605,
05-jun-23,Sinaloa,"EL FUERTE, SIN.",5,5,10,0,0,0,
15-jun-23,México,"LA PAZ, MEX.",10,0,10,0,0,32,
23-jun-23,Michoacán,"ZAMORA, MICH.",5,5,10,3,0,182,
26-jun-23,México,"HUEHUETOCA, MEX.",10,0,10,0,15,0,
07-jul-23,Querétaro,"CORREGIDORA, QRO.",7,3,10,0,5,0,
10-jul-23,Michoacán,"URUAPAN, MICH.",6,4,10,38,0,296,
15-ago-23,Tamaulipas,"VICTORIA, TAMPS.",7,3,10,0,0,0,
01-sep-23,Querétaro,"QUERETARO, QRO.",6,4,10,176,0,124,
04-oct-23,Chihuahua,"JUÁREZ, CHIH.",9,1,10,4,0,325,
14-jun-24,Veracruz,"VERACRUZ, VER.",8,2,10,109,0,"4,021",
17-ene-13,D.F.,"IZTAPALAPA, D.F.",6,3,9,0,1,12,
23-ene-13,D.F.,"IZTAPALAPA, D.F.",7,2,9,0,0,30,
01-feb-13,B.C.,"TIJUANA, B.C.",7,2,9,0,0,0,
06-feb-13,CHIH.,"CHIH., CHIH.",6,3,9,1,0,328,
06-feb-13,TAMPS.,"VICTORIA, TAMPS.",8,1,9,0,0,0,
07-feb-13,CHIH.,"CHIH., CHIH.",6,3,9,0,0,0,
11-feb-13,CHIH.,"CHIH., CHIH.",8,1,9,1,0,440,
13-feb-13,CHIH.,"OJINAGA, CHIH.",5,4,9,0,0,0,
20-feb-13,TAMPS.,"MATAMOROS, TAMPS.",2,7,9,0,0,0,
21-feb-13,HGO.,"TULANCINGO DE BRAVO, HGO.",8,1,9,0,0,0,
21-feb-13,TAMPS.,"MATAMOROS, TAMPS.",4,5,9,0,0,0,
24-feb-13,MEX.,"TULTITLAN, MEX.",6,3,9,4,0,58,
27-feb-13,CHIS.,"SAN CRISTOBAL DE LAS CASAS, CHIS.",7,2,9,0,0,63,
02-mar-13,N.L.,"APODACA, N.L.",2,7,9,0,1,559,
04-mar-13,CHIH.,"CHIH., CHIH.",7,2,9,7,0,226,
11-mar-13,D.F.,"CUAJIMALPA DE MOR., D.F.",6,3,9,0,0,360,
14-mar-13,MEX.,"NICOLAS ROMERO, MEX.",9,0,9,4,0,38,
15-mar-13,MEX.,"NICOLAS ROMERO, MEX.",7,2,9,5,0,213,
16-mar-13,HGO.,"TEPEAPULCO, HGO.",7,2,9,0,0,20,
19-mar-13,MEX.,"ZUMPANGO, MEX.",8,1,9,3,0,37,
20-mar-13,N.L.,"CADEREYTA JIMENEZ, N.L.",7,2,9,2,0,0,
22-mar-13,N.L.,"CADEREYTA JIMENEZ, N.L.",5,4,9,3,0,110,
23-mar-13,HGO.,"TIZAYUCA, HGO.",7,2,9,0,0,70,
02-abr-13,MEX.,"IXTLAHUACA, MEX.",9,0,9,5,0,55,
04-abr-13,MICH.,"ZAMORA, MICH.",4,5,9,0,0,0,
05-abr-13,MICH.,"SALVADOR ESCALANTE, MICH.",6,3,9,0,0,0,
05-abr-13,MEX.,"ACOLMAN, MEX.",6,3,9,0,0,254,
08-abr-13,MICH.,"MORELIA, MICH.",7,2,9,2,1,0,
12-abr-13,MEX.,"ALMOLOYA DE JUAREZ, MEX.",7,2,9,6,0,0,
13-abr-13,B.C.,"MEXICALI, B.C.",2,7,9,0,0,0,
16-abr-13,QRO.,"TEQUISQUIAPAN, QRO.",6,3,9,0,0,0,
16-abr-13,MICH.,"MARAVATIO, MICH.",6,3,9,0,0,0,
16-abr-13,MICH.,"LA PIEDAD, MICH.",5,4,9,0,0,0,
28-abr-13,N.L.,"LINARES, N.L.",4,5,9,2,0,150,
30-abr-13,N.L.,"LINARES, N.L.",7,2,9,3,0,450,
02-may-13,SIN.,"EL FUERTE, SIN.",3,6,9,0,7,0,
06-may-13,MICH.,"JIQUILPAN, MICH.",7,2,9,0,0,0,
18-may-13,MICH.,"ZITACUARO, MICH.",8,1,9,0,0,0,
19-may-13,NAY.,"TEPIC, NAY.",5,4,9,0,0,0,
20-may-13,MICH.,"URUAPAN, MICH.",3,6,9,0,0,0,
21-may-13,MICH.,"ZITACUARO, MICH.",5,4,9,0,0,0,
02-jun-13,COAH.,"TORREÓN, COAH.",8,1,9,1,0,20,
07-jun-13,TAMPS.,"VICTORIA, TAMPS.",1,8,9,0,3,300,
08-jun-13,B.C.S.,"LA PAZ, B.C.S.",5,4,9,3,0,69,
14-jun-13,COAH.,"TORREÓN, COAH.",4,5,9,0,0,0,
16-jun-13,JAL.,"AUTLAN DE NAVARRO, JAL.",8,1,9,0,0,450,
27-jun-13,B.C.S.,"LA PAZ, B.C.S.",5,4,9,0,0,0,
03-jul-13,PUE.,"PUE., PUE.",6,3,9,0,1,1727,
04-jul-13,MOR.,"CUERNAVACA, MOR.",5,4,9,2,1,112,
04-jul-13,PUE.,"PUE., PUE.",6,3,9,0,1,1358,
05-jul-13,MOR.,"CUERNAVACA, MOR.",5,4,9,1,0,154,
09-jul-13,SIN.,"NAVOLATO, SIN.",6,3,9,0,1,0,
11-jul-13,B.C.,"MEXICALI, B.C.",4,5,9,0,0,0,
13-jul-13,N.L.,"APODACA, N.L.",4,5,9,9,0,24442,
16-jul-13,MOR.,"CUERNAVACA, MOR.",4,5,9,0,8,74,
19-jul-13,MOR.,"CUERNAVACA, MOR.",7,2,9,0,1,459,
23-jul-13,JAL.,"ZAPOTLAN EL GRANDE, JAL.",6,3,9,2,0,102,
31-jul-13,N.L.,"MONTERREY, N.L.",3,6,9,1,0,0,
14-ago-13,COAH.,"RAMOS ARIZPE, COAH.",5,4,9,0,0,0,
20-ago-13,MOR.,"CUAUTLA, MOR.",4,5,9,1,4,60,
23-ago-13,TLAX.,"TLAX., TLAX.",4,5,9,1,0,0,
24-sep-13,SIN.,"CULIACAN, SIN.",6,3,9,0,6,0,
04-oct-13,ZAC.,"FRESNILLO, ZAC.",6,3,9,4,0,0,
11-oct-13,COAH.,"SALTILLO, COAH.",8,1,9,0,0,133,
31-oct-13,ZAC.,"FRESNILLO, ZAC.",2,7,9,0,0,0,
04-nov-13,D.F.,"TLALPAN, D.F.",3,6,9,0,0,29,
13-nov-13,PUE.,"PUE., PUE.",7,2,9,1,0,284,
05-dic-13,TAMPS.,"TAMPICO, TAMPS.",9,0,9,6,0,435,
10-dic-13,D.F.,"CUAUHTEMOC, D.F.",9,0,9,0,7,450,
16-dic-13,TAMPS.,"VICTORIA, TAMPS.",8,1,9,15,0,0,
17-ene-14,TAMPS.,"CIUDAD MADERO, TAMPS.",6,3,9,9,0,225,
05-feb-14,COAH.,"TORREÓN, COAH.",7,2,9,0,0,0,
18-feb-14,D.F.,"CUAUHTEMOC, D.F.",8,1,9,0,0,320,
06-mar-14,N.L.,"SAN NICOLAS DE LOS GARZA, N.L.",8,1,9,6,0,535,
18-mar-14,B.C.,"MEXICALI, B.C.",7,2,9,0,0,0,
20-mar-14,N.L.,"MONTERREY, N.L.",6,3,9,0,0,100,
28-mar-14,B.C.,"TIJUANA, B.C.",5,4,9,0,0,0,
02-abr-14,MEX.,"TULTITLAN, MEX.",8,1,9,1,1,25,
10-abr-14,MEX.,"CUAUTITLAN, MEX.",8,1,9,0,0,38,
15-abr-14,MEX.,"NAUCALPAN DE JUAREZ, MEX.",7,2,9,0,0,10,
24-abr-14,MEX.,"CHIMALHUACAN, MEX.",9,0,9,0,0,0,
25-abr-14,TAMPS.,"MATAMOROS, TAMPS.",5,4,9,0,0,0,
29-abr-14,B.C.,"ENSENADA, B.C.",5,4,9,0,1,0,
30-abr-14,MEX.,"VALLE DE BRAVO, MEX.",3,6,9,2,0,41,
30-abr-14,MEX.,"TEOLOYUCAN, MEX.",6,3,9,0,0,0,
04-may-14,TAMPS.,"MATAMOROS, TAMPS.",4,5,9,1,0,2,
05-may-14,SIN.,"AHOME, SIN.",6,3,9,0,0,0,
08-may-14,B.C.,"MEXICALI, B.C.",2,7,9,0,0,0,
08-may-14,MEX.,"IXTAPALUCA, MEX.",7,2,9,0,0,0,
10-may-14,DGO.,"DGO., DGO.",7,2,9,2,0,0,
14-may-14,MEX.,"NOPALTEPEC, MEX.",6,3,9,0,0,0,
15-may-14,MEX.,"AMECAMECA, MEX.",6,3,9,0,5,0,
21-may-14,MEX.,"METEPEC, MEX.",9,0,9,1,0,0,
22-may-14,MEX.,"VALLE DE CHALCO SOLIDARIDAD, MEX.",8,1,9,0,0,0,
24-may-14,MEX.,"VALLE DE CHALCO SOLIDARIDAD, MEX.",8,1,9,0,0,0,
31-may-14,HGO.,"PACHUCA DE SOTO, HGO.",8,1,9,0,0,340,
05-jun-14,MEX.,"TOLUCA, MEX.",8,1,9,0,0,0,
05-jun-14,SIN.,"CHOIX, SIN.",2,7,9,0,0,0,
05-jun-14,MEX.,"HUEYPOXTLA, MEX.",9,0,9,0,0,22,
13-jun-14,SIN.,"SIN., SIN.",6,3,9,0,1,0,
13-jun-14,SIN.,"CULIACAN, SIN.",8,1,9,0,0,0,
14-jun-14,MEX.,"ALMOLOYA DE ALQUISIRAS, MEX.",9,0,9,0,0,0,
18-jun-14,SIN.,"SIN., SIN.",5,4,9,0,1,0,
15-jul-14,QRO.,"QUERETARO, QRO.",7,2,9,0,5,0,
18-jul-14,N.L.,"ANAHUAC, N.L.",4,5,9,0,0,50,
18-jul-14,QRO.,"QUERETARO, QRO.",5,4,9,0,7,0,
21-jul-14,QRO.,"QUERETARO, QRO.",7,2,9,0,8,0,
22-jul-14,QRO.,"QUERETARO, QRO.",8,1,9,0,0,0,
23-jul-14,NAY.,"JALA, NAY.",2,7,9,0,0,0,
23-jul-14,QRO.,"QUERETARO, QRO.",4,5,9,0,5,0,
23-jul-14,QRO.,"QUERETARO, QRO.",5,4,9,0,5,0,
01-ago-14,TAMPS.,"MATAMOROS, TAMPS.",9,0,9,0,0,0,
07-ago-14,COL.,"COL., COL.",6,3,9,0,0,182,
07-ago-14,B.C.,"TIJUANA, B.C.",5,4,9,0,0,0,
20-ago-14,QRO.,"CORREGIDORA, QRO.",7,2,9,0,1,0,
28-ago-14,SIN.,"COSALA, SIN.",9,0,9,0,0,0,
28-ago-14,MICH.,"MORELIA, MICH.",5,4,9,4,0,0,
28-ago-14,MICH.,"ZAMORA, MICH.",5,4,9,1,0,0,
29-ago-14,MICH.,"MORELIA, MICH.",5,4,9,3,1,42,
30-ago-14,MICH.,"TACAMBARO, MICH.",3,6,9,2,0,0,
01-sep-14,MICH.,"ZAMORA, MICH.",6,3,9,3,0,17,
26-sep-14,OAX.,"CIUDAD IXTEPEC, OAX.",5,4,9,29,0,53,
26-sep-14,B.C.,"TIJUANA, B.C.",7,2,9,0,0,0,
02-oct-14,B.C.,"MEXICALI, B.C.",4,5,9,0,0,0,
03-oct-14,N.L.,"MONTERREY, N.L.",5,4,9,0,0,624,
06-oct-14,AGS.,"AGS., AGS.",8,1,9,2,0,14,
07-oct-14,B.C.,"TIJUANA, B.C.",3,6,9,0,0,0,
10-oct-14,SIN.,"ESCUINAPA, SIN.",4,5,9,0,0,0,
11-oct-14,SON.,"HERMOSILLO, SON.",9,0,9,27,0,911,
17-oct-14,MICH.,"ARIO, MICH.",9,0,9,0,0,530,
18-oct-14,CHIS.,"COMITAN DE DOMÍNGUEZ, CHIS.",5,4,9,6,0,283,
21-oct-14,MICH.,"HGO., MICH.",8,1,9,3,0,12,
24-oct-14,CHIS.,"TAPACHULA, CHIS.",6,3,9,2,0,276,
03-nov-14,COAH.,"MÚZQUIZ, COAH.",8,1,9,0,0,24,
06-nov-14,GRO.,"FLORENCIO VILLARREAL, GRO.",5,4,9,0,1,0,
08-nov-14,CHIS.,"TAPACHULA, CHIS.",7,2,9,2,1,854,
08-nov-14,CHIS.,"TUXTLA GUTIÉRREZ, CHIS.",4,5,9,4,2,1419,
10-nov-14,CHIS.,"OCOZOCOAUTLA DE ESPINOSA, CHIS.",5,4,9,1,0,29,
11-nov-14,CHIS.,"TUXTLA GUTIÉRREZ, CHIS.",7,2,9,5,6,327,
03-dic-14,N.L.,"MONTERREY, N.L.",5,4,9,31,0,484,
13-dic-14,N.L.,"MONTERREY, N.L.",9,0,9,38,0,1520,
20-dic-14,TAMPS.,"MATAMOROS, TAMPS.",7,2,9,0,0,0,
23-dic-14,DGO.,"DGO., DGO.",8,1,9,4,0,0,
26-dic-14,DGO.,"LERDO, DGO.",3,6,9,0,1,0,
31-dic-14,DGO.,"GOMEZ PALACIO, DGO.",8,1,9,20,1,0,
02-ene-15,DGO.,"GOMEZ PALACIO, DGO.",4,5,9,0,0,0,
17-mar-15,OAX.,"OAX. DE JUAREZ, OAX.",3,6,9,3,0,693,
04-ago-15,MEX.,"NAUCALPAN DE JUAREZ, MEX.",7,2,9,0,1,0,
05-ago-15,MEX.,"TEXCOCO, MEX.",7,2,9,0,9,0,
07-ago-15,MEX.,"TEXCOCO, MEX.",7,2,9,0,33,88,
12-ago-15,MEX.,"ZUMPANGO, MEX.",8,1,9,0,6,5,
15-ago-15,TAMPS.,"MATAMOROS, TAMPS.",5,4,9,0,0,0,
17-ago-15,COAH.,"SABINAS, COAH.",6,3,9,0,0,0,
18-ago-15,SIN.,"AHOME, SIN.",6,3,9,0,1,0,
20-ago-15,COAH.,"TORREÓN, COAH.",8,1,9,0,0,191,
20-ago-15,COAH.,"TORREÓN, COAH.",9,0,9,3,0,35,
26-ago-15,DGO.,"DGO., DGO.",4,5,9,5,0,0,
26-ago-15,MEX.,"TULTEPEC, MEX.",9,0,9,0,1,0,
27-ago-15,COAH.,"SALTILLO, COAH.",6,3,9,1,2,387,
28-ago-15,MEX.,"SAN MATEO ATENCO, MEX.",7,2,9,0,0,0,
01-sep-15,COAH.,"TORREÓN, COAH.",8,1,9,0,0,209,
02-sep-15,SIN.,"CHOIX, SIN.",4,5,9,0,1,0,
14-sep-15,COAH.,"FRONTERA, COAH.",6,3,9,0,0,82,
17-sep-15,COAH.,"TORREÓN, COAH.",7,2,9,0,0,0,
22-sep-15,SIN.,"CHOIX, SIN.",5,4,9,0,0,0,
22-sep-15,MEX.,"TENANCINGO, MEX.",8,1,9,0,0,100,
23-sep-15,B.C.,"TIJUANA, B.C.",6,3,9,0,0,0,
28-sep-15,SIN.,"EL FUERTE, SIN.",6,3,9,0,6,0,
28-sep-15,MEX.,"OCOYOACAC, MEX.",5,4,9,4,0,0,
06-oct-15,COAH.,"SALTILLO, COAH.",6,3,9,1,1,88,
08-oct-15,MEX.,"ECATEPEC DE MOR., MEX.",8,1,9,2,3,885,
14-oct-15,MEX.,"LA PAZ, MEX.",8,1,9,0,0,0,
16-oct-15,D.F.,"ALVARO OBREGON, D.F.",4,5,9,0,7,23,
23-oct-15,COAH.,"SALTILLO, COAH.",7,2,9,2,1,131,
23-oct-15,B.C.,"MEXICALI, B.C.",3,6,9,0,0,0,
04-nov-15,D.F.,"COYOACAN, D.F.",5,4,9,0,2,0,
05-nov-15,SIN.,"GUASAVE, SIN.",2,7,9,0,5,0,
07-nov-15,MEX.,"TEJUPILCO, MEX.",8,1,9,5,0,91,
10-nov-15,SIN.,"SIN., SIN.",7,2,9,0,5,0,
10-nov-15,COAH.,"SALTILLO, COAH.",7,2,9,1,2,190,
19-nov-15,SIN.,"SIN., SIN.",8,1,9,0,1,0,
23-nov-15,COAH.,"PIEDRAS NEGRAS, COAH.",1,8,9,0,0,0,
28-nov-15,MEX.,"ALMOLOYA DE JUAREZ, MEX.",8,1,9,3,0,168,
28-nov-15,B.C.,"TIJUANA, B.C.",9,0,9,0,0,0,
04-dic-15,COAH.,"TORREÓN, COAH.",7,2,9,1,0,198,
14-dic-15,CHIH.,"HGO. DEL PARRAL, CHIH.",7,2,9,15,1,207,
16-dic-15,CHIH.,"HGO. DEL PARRAL, CHIH.",9,0,9,21,1,390,
23-ene-16,TAMPS.,"MATAMOROS, TAMPS.",6,3,9,0,0,0,
31-ene-16,CHIH.,"NUEVO CASAS GRANDES, CHIH.",5,4,9,0,0,88,
19-feb-16,OAX.,"OAX. DE JUAREZ, OAX.",3,6,9,6,0,0,
14-mar-16,D.F.,"TLAHUAC, D.F.",7,2,9,5,0,24,
12-abr-16,D.F.,"IZTACALCO, D.F.",5,4,9,133,0,0,
20-abr-16,D.F.,"IZTACALCO, D.F.",6,3,9,269,0,97,
27-jun-16,SIN.,"MAZATLAN, SIN.",6,3,9,0,12,0,
08-ago-16,S.L.P.,"CIUDAD VALLES, S.L.P.",8,1,9,4,0,266,
15-ago-16,MEX.,"TLALNEPANTLA DE BAZ, MEX.",7,2,9,1,6,40,
20-ago-16,MEX.,"TOLUCA, MEX.",7,2,9,4,0,18,
23-ago-16,MEX.,"CUAUTITLAN IZCALLI, MEX.",7,2,9,3,0,904,
01-sep-16,CHIS.,"SAN CRISTOBAL DE LAS CASAS, CHIS.",2,7,9,0,0,0,
24-oct-16,MEX.,"TEOTIHUACAN, MEX.",8,1,9,0,1,0,
22-dic-16,GTO.,"LEON, GTO.",4,5,9,0,0,0,
05-ene-17,DGO.,"GOMEZ PALACIO, DGO.",5,4,9,0,0,0,
20-ene-17,D.F.,"CUAUHTEMOC, D.F.",7,2,9,0,3,5,
22-ene-17,DGO.,"SANTIAGO PAPASQUIARO, DGO.",6,3,9,2,0,0,
27-feb-17,PUE.,"PUE., PUE.",6,3,9,4,0,467,
14-mar-17,QRO.,"QUERETARO, QRO.",1,8,9,0,1,0,
15-mar-17,TAMPS.,"NUEVO LAREDO, TAMPS.",6,3,9,0,0,244,
17-mar-17,MEX.,"ECATEPEC DE MOR., MEX.",6,3,9,0,3,89,
19-mar-17,QRO.,"QUERETARO, QRO.",2,7,9,0,0,0,
24-mar-17,MEX.,"TECAMAC, MEX.",8,1,9,0,0,787,
30-mar-17,QRO.,"QUERETARO, QRO.",2,7,9,0,0,0,
02-may-17,D.F.,"XOCHIMILCO, D.F.",6,3,9,0,1,1845,
11-may-17,GTO.,"ROMITA, GTO.",6,3,9,0,0,0,
19-may-17,D.F.,"IZTACALCO, D.F.",9,0,9,0,1,91,
31-may-17,D.F.,"BENITO JUAREZ, D.F.",9,0,9,0,2,1324,
08-jun-17,CHIS.,"TUXTLA GUTIÉRREZ, CHIS.",6,3,9,33,0,889,
08-jun-17,CHIS.,"SAN CRISTOBAL DE LAS CASAS, CHIS.",1,8,9,0,0,0,
10-jun-17,CHIS.,"COMITAN DE DOMÍNGUEZ, CHIS.",3,6,9,32,0,1755,
16-jun-17,MEX.,"NEZAHUALCOYOTL, MEX.",9,0,9,11,0,740,
21-jun-17,QRO.,"PEDRO ESCOBEDO, QRO.",6,3,9,0,0,0,
30-jun-17,D.F.,"IZTAPALAPA, D.F.",6,3,9,0,1,130,
06-jul-17,D.F.,"IZTAPALAPA, D.F.",9,0,9,0,0,30,
14-jul-17,SIN.,"EL FUERTE, SIN.",8,1,9,0,2,0,
10-ago-17,CHIS.,"TUXTLA GUTIÉRREZ, CHIS.",8,1,9,7,0,258,
18-ago-17,N.L.,"MONTERREY, N.L.",3,6,9,15,0,700,
27-ago-17,MEX.,"IXTAPALUCA, MEX.",6,3,9,0,0,292,
27-sep-17,SIN.,"AHOME, SIN.",4,5,9,0,1,0,
04-oct-17,ZAC.,"GUADALUPE, ZAC.",4,5,9,0,0,178,
05-oct-17,ZAC.,"GUADALUPE, ZAC.",4,5,9,0,0,178,
14-oct-17,COAH.,"ACUÑA, COAH.",5,4,9,0,0,0,
21-oct-17,TAMPS.,"REYNOSA, TAMPS.",8,1,9,2,0,132,
26-oct-17,ZAC.,"GUADALUPE, ZAC.",5,4,9,7,0,0,
01-dic-17,CHIH.,"JUÁREZ, CHIH.",6,3,9,1,1,419,
07-feb-18,COAH.,"SALTILLO, COAH.",9,0,9,0,0,34,
05-mar-18,CHIH.,"CHIH., CHIH.",5,4,9,0,0,23,
08-mar-18,D.F.,"MIGUEL HGO., D.F.",1,8,9,0,0,0,
09-mar-18,CHIH.,"CHIH., CHIH.",9,0,9,0,0,744,
21-mar-18,COAH.,"SALTILLO, COAH.",6,3,9,0,0,0,
30-jul-18,B.C.,"TIJUANA, B.C.",7,2,9,0,0,0,
02-ago-18,DGO.,"GOMEZ PALACIO, DGO.",5,4,9,1,2,12,
03-ago-18,B.C.,"TIJUANA, B.C.",9,0,9,0,0,0,
10-ago-18,TAMPS.,"MATAMOROS, TAMPS.",3,6,9,0,0,0,
13-ago-18,D.F.,"GUSTAVO A. MADERO, D.F.",9,0,9,0,0,24,
21-ago-18,B.C.,"ENSENADA, B.C.",6,3,9,0,2,0,
23-ago-18,B.C.,"TIJUANA, B.C.",3,6,9,0,1,0,
24-ago-18,MEX.,"CHIMALHUACAN, MEX.",5,4,9,5,70,899,
27-ago-18,TAMPS.,"NUEVO LAREDO, TAMPS.",8,1,9,4,4,255,
18-sep-18,D.F.,"XOCHIMILCO, D.F.",8,1,9,0,0,0,
03-oct-18,D.F.,"MIGUEL HGO., D.F.",7,2,9,0,0,426,
29-oct-18,CHIH.,"JUÁREZ, CHIH.",5,4,9,11,0,244,
18-feb-19,CD. MÉX.,"CUAUHTEMOC, CD. MÉX.",9,0,9,0,0,17023,
03-abr-19,CD. MÉX.,"MIGUEL HGO., CD. MÉX.",8,1,9,0,0,1814,
03-abr-19,CD. MÉX.,"XOCHIMILCO, CD. MÉX.",5,4,9,0,0,112,
15-abr-19,CD. MÉX.,"XOCHIMILCO, CD. MÉX.",6,3,9,0,0,2873,
25-abr-19,CD. MÉX.,"ALVARO OBREGON, CD. MÉX.",6,3,9,0,0,333,
10-may-19,CHIH.,"JUÁREZ, CHIH.",8,1,9,8,2,67,
15-may-19,CD. MÉX.,"AZCAPOTZALCO, CD. MÉX.",8,1,9,0,0,956,
22-may-19,CD. MÉX.,"VENUSTIANO CARRANZA, CD. MÉX.",5,4,9,0,2,331,
24-may-19,CD. MÉX.,"IZTAPALAPA, CD. MÉX.",8,1,9,0,3,403,
01-jun-19,MÉX.,"ECATEPEC DE MOR., MEX.",6,3,9,0,1,0,
04-jun-19,CD. MÉX.,"AZCAPOTZALCO, CD. MÉX.",8,1,9,0,0,231,
10-jun-19,CD. MÉX.,"AZCAPOTZALCO, CD. MÉX.",7,2,9,0,1,160,
19-jun-19,CD. MÉX.,"TLAHUAC, CD. MÉX.",8,1,9,0,0,48,
01-ago-19,CD. MÉX.,"CUAUHTEMOC, CD. MÉX.",4,5,9,0,0,1693,
22-ago-19,QRO.,"QUERETARO, QRO.",7,2,9,0,0,0,
05-sep-19,CD. MÉX.,"IZTAPALAPA, CD. MÉX.",6,3,9,0,0,311,
20-sep-19,CD. MÉX.,"IZTAPALAPA, CD. MÉX.",7,2,9,0,3,133,
20-sep-19,CD. MÉX.,"LA MAGDALENA CONTRERAS, CD. MÉX.",3,6,9,0,0,1613,
02-oct-19,MÉX.,"CHIMALHUACAN, MEX.",5,4,9,4,0,21,
07-oct-19,MÉX.,"CHIMALHUACAN, MEX.",3,6,9,3,0,76,
11-oct-19,MÉX.,"CHIMALHUACAN, MEX.",5,4,9,2,0,111,
25-oct-19,CD. MÉX.,"CUAJIMALPA DE MOR., CD. MÉX.",6,3,9,0,0,0,
06-nov-19,CD. MÉX.,"BENITO JUAREZ, CD. MÉX.",6,3,9,0,0,218,
15-nov-19,CHIS.,"TUXTLA GUTIÉRREZ, CHIS.",1,8,9,3,13,218,
21-nov-19,CD. MÉX.,"IZTAPALAPA, CD. MÉX.",3,6,9,0,0,0,
04-dic-19,GTO.,"LEON, GTO.",4,5,9,0,0,0,
06-dic-19,CD. MÉX.,"IZTAPALAPA, CD. MÉX.",1,8,9,0,0,0,
12-dic-19,CD. MÉX.,"IZTAPALAPA, CD. MÉX.",3,6,9,0,0,50,
18-dic-19,CD. MÉX.,"IZTACALCO, CD. MÉX.",2,7,9,0,0,0,
30-ene-20,CD. MÉX.,"GUSTAVO A. MADERO, CD. MÉX.",7,2,9,0,0,2007,
13-feb-20,CD. MÉX.,"IZTAPALAPA, CD. MÉX.",8,1,9,0,0,0,
25-feb-20,NAY.,"TEPIC, NAY.",9,0,9,7,10,435,
07-mar-20,VER.,"XALAPA, VER.",8,1,9,13,0,1103,
10-mar-20,VER.,"VER., VER.",9,0,9,49,0,386,
13-mar-20,VER.,"VER., VER.",9,0,9,9,0,1127,
10-jul-20,CD. MÉX.,"CUAUHTEMOC, CD. MÉX.",8,1,9,0,0,307,
03-dic-21,CHIH.,"JUÁREZ, CHIH.",8,1,9,2,0,497,
13-jun-22,SIN.,"AHOME, SIN.",4,5,9,0,0,64,
15-jun-22,CD. MÉX.,"ALVARO OBREGON, CD. MÉX.",6,3,9,0,0,288,
18-jun-22,SIN.,"AHOME, SIN.",7,2,9,0,0,0,
21-jun-22,N.L.,"MONTERREY, N.L.",7,2,9,2,0,272,
29-jun-22,CHIH.,"JUÁREZ, CHIH.",9,0,9,26,0,335,
11-jul-22,TAMPS.,"CIUDAD MADERO, TAMPS.",6,3,9,0,0,0,
26-jul-22,CD. MÉX.,"BENITO JUAREZ, CD. MÉX.",6,3,9,0,1,1,
23-ago-22,MÉX.,"CHIMALHUACAN, MEX.",9,0,9,0,0,26,
29-ago-22,MÉX.,"CHIMALHUACAN, MEX.",7,2,9,0,0,5,
31-ago-22,N.L.,"APODACA, N.L.",4,5,9,0,0,40,
02-sep-22,ZAC.,"ZAC., ZAC.",5,4,9,29,0,207,
02-sep-22,CD. MÉX.,"COYOACAN, CD. MÉX.",8,1,9,0,0,336,
06-sep-22,MÉX.,"CUAUTITLAN IZCALLI, MEX.",6,3,9,0,0,21,
06-sep-22,ZAC.,"FRESNILLO, ZAC.",7,2,9,17,0,363,
07-sep-22,ZAC.,"FRESNILLO, ZAC.",7,2,9,23,3,747,
07-sep-22,MÉX.,"ECATEPEC DE MOR., MEX.",8,1,9,1,18,281,
08-sep-22,MÉX.,"ECATEPEC DE MOR., MEX.",5,4,9,0,0,371,
08-sep-22,ZAC.,"FRESNILLO, ZAC.",9,0,9,8,0,655,
17-sep-22,MÉX.,"ECATEPEC DE MOR., MEX.",8,1,9,0,0,307,
29-sep-22,MÉX.,"NEZAHUALCOYOTL, MEX.",9,0,9,0,0,0,
10-oct-22,MÉX.,"VALLE DE CHALCO SOLIDARIDAD, MEX.",7,2,9,2,0,417,
11-oct-22,SIN.,"MAZATLAN, SIN.",9,0,9,0,0,2977,
14-oct-22,CD. MÉX.,"ALVARO OBREGON, CD. MÉX.",5,4,9,0,0,384,
14-oct-22,SIN.,"MAZATLAN, SIN.",7,2,9,4,0,520,
19-oct-22,SIN.,"MAZATLAN, SIN.",7,2,9,3,0,1014,
26-oct-22,MÉX.,"COYOTEPEC, MEX.",8,1,9,0,0,62,
07-nov-22,MOR.,"AYALA, MOR.",8,1,9,0,0,0,
28-nov-22,N.L.,"LINARES, N.L.",6,3,9,1,0,1223,
29-nov-22,CD. MÉX.,"AZCAPOTZALCO, CD. MÉX.",6,3,9,0,0,123,
02-dic-22,CHIS.,"CHENALHÓ, CHIS.",3,6,9,11,0,5,
08-dic-22,CHIH.,"CHIH., CHIH.",8,1,9,28,0,1304,
08-mar-23,México,"NEZAHUALCOYOTL, MEX.",8,1,9,0,0,273,
11-mar-23,México,"NEZAHUALCOYOTL, MEX.",7,2,9,0,0,164,
18-mar-23,Chihuahua,"CHIHUAHUA, CHIH.",5,4,9,9,0,9,
21-mar-23,México,"SAN MATEO ATENCO, MEX.",8,1,9,0,0,0,
24-mar-23,México,"TOLUCA, MEX.",4,5,9,0,0,"1,159",
02-jun-23,Cd. de México,"CUAUHTEMOC, CD. MÉX.",5,4,9,0,1,270,
14-jun-23,Guanajuato,"LEON, GTO.",7,2,9,0,0,261,
30-jun-23,Guanajuato,"SALVATIERRA, GTO.",5,4,9,9,0,876,
04-jul-23,Michoacán,"ZAMORA, MICH.",3,6,9,43,0,62,
05-jul-23,Sinaloa,"AHOME, SIN.",7,2,9,0,0,86,
05-jul-23,México,"XALATLACO, MEX.",1,8,9,0,0,0,
08-ago-23,Chiapas,"CHENALHÓ, CHIS.",1,8,9,0,0,0,
06-oct-23,Chihuahua,"CHIHUAHUA, CHIH.",8,1,9,0,1,714,
12-oct-23,Chihuahua,"CUAUHTÉMOC, CHIH.",4,5,9,0,0,264,
18-jun-24,Sinaloa,"NAVOLATO, SIN.",9,0,9,0,0,349,
03-feb-13,TAMPS.,"TAMPICO, TAMPS.",8,0,8,0,0,0,
06-feb-13,VER.,"COATZACOALCOS, VER.",7,1,8,0,0,0,
09-feb-13,TAMPS.,"CIUDAD MADERO, TAMPS.",7,1,8,0,0,0,
13-feb-13,CAMP.,"CAMP., CAMP.",6,2,8,0,0,0,
21-feb-13,HGO.,"PACHUCA DE SOTO, HGO.",6,2,8,0,2,215,
22-feb-13,HGO.,"TULA DE ALLENDE, HGO.",7,1,8,0,0,200,
22-feb-13,TAMPS.,"CIUDAD MADERO, TAMPS.",8,0,8,6,1,455,
01-mar-13,CHIS.,"SAN CRISTOBAL DE LAS CASAS, CHIS.",6,2,8,0,0,184,
02-mar-13,N.L.,"JUAREZ, N.L.",6,2,8,0,0,100,
02-mar-13,N.L.,"SANTA CATARINA, N.L.",4,4,8,1,0,583,
03-mar-13,N.L.,"SAN PEDRO GARZA GARCIA, N.L.",8,0,8,0,0,499,
04-mar-13,MEX.,"TEXCOCO, MEX.",6,2,8,0,0,55,
04-mar-13,HGO.,"PACHUCA DE SOTO, HGO.",4,4,8,0,0,0,
04-mar-13,HGO.,"TULANCINGO DE BRAVO, HGO.",8,0,8,0,0,0,
11-mar-13,MEX.,"NICOLAS ROMERO, MEX.",8,0,8,9,0,781,
12-mar-13,AGS.,"AGS., AGS.",8,0,8,0,0,9,
14-mar-13,COAH.,"NUEVA ROSITA, COAH.",2,6,8,1,1,26,
14-mar-13,MEX.,"HUIXQUILUCAN, MEX.",6,2,8,2,3,67,
15-mar-13,S.L.P.,"CIUDAD VALLES, S.L.P.",8,0,8,3,0,0,
20-mar-13,HGO.,"TIZAYUCA, HGO.",7,1,8,0,0,328,
21-mar-13,N.L.,"SABINAS HGO., N.L.",0,8,8,0,0,130,
28-mar-13,CHIH.,"ASCENSIÓN, CHIH.",3,5,8,0,0,0,
03-abr-13,MEX.,"IXTLAHUACA, MEX.",7,1,8,5,0,135,
07-abr-13,MICH.,"ZAMORA, MICH.",6,2,8,0,0,0,
08-abr-13,MEX.,"ATLACOMULCO, MEX.",5,3,8,0,1,0,
09-abr-13,MEX.,"ALMOLOYA DE JUAREZ, MEX.",4,4,8,1,0,0,
14-abr-13,MEX.,"ATLACOMULCO, MEX.",7,1,8,1,0,0,
15-abr-13,MICH.,"MARAVATIO, MICH.",3,5,8,0,0,0,
16-abr-13,MEX.,"ATIZAPAN, MEX.",7,1,8,3,0,95,
18-abr-13,MEX.,"TENANGO DEL VALLE, MEX.",6,2,8,1,0,25,
18-abr-13,OAX.,"TRINIDAD ZAACHILA, OAX.",3,5,8,1,0,0,
24-abr-13,B.C.,"TIJUANA, B.C.",4,4,8,0,0,0,
25-abr-13,SIN.,"GUASAVE, SIN.",4,4,8,0,3,0,
26-abr-13,MICH.,"MARAVATIO, MICH.",4,4,8,0,0,0,
26-abr-13,MICH.,"LA PIEDAD, MICH.",4,4,8,0,0,0,
29-abr-13,MICH.,"ZACAPU, MICH.",3,5,8,0,0,0,
03-may-13,SIN.,"EL FUERTE, SIN.",4,4,8,0,9,0,
06-may-13,MICH.,"ZACAPU, MICH.",6,2,8,0,0,0,
08-may-13,N.L.,"HIGUERAS, N.L.",1,7,8,1,0,1700,
09-may-13,MICH.,"TURICATO, MICH.",2,6,8,0,0,0,
10-may-13,SIN.,"CHOIX, SIN.",6,2,8,0,6,0,
13-may-13,N.L.,"GRAL. BRAVO, N.L.",2,6,8,1,0,450,
16-may-13,MICH.,"LAZARO CARDENAS, MICH.",6,2,8,0,1,0,
22-may-13,SIN.,"SALVADOR ALVARADO, SIN.",6,2,8,0,0,0,
25-may-13,MICH.,"ZITACUARO, MICH.",6,2,8,3,1,0,
27-may-13,TAB.,"BALANCAN, TAB.",5,3,8,0,0,0,
28-may-13,MICH.,"URUAPAN, MICH.",4,4,8,0,0,0,
30-may-13,MICH.,"ZITACUARO, MICH.",5,3,8,2,0,0,
01-jun-13,N.L.,"LAMPAZOS DE NARANJO, N.L.",2,6,8,0,0,0,
03-jun-13,N.L.,"ANAHUAC, N.L.",0,8,8,2,0,150,
04-jun-13,B.C.,"MEXICALI, B.C.",5,3,8,0,0,0,
08-jun-13,B.C.S.,"LA PAZ, B.C.S.",6,2,8,0,0,0,
08-jun-13,JAL.,"AUTLAN DE NAVARRO, JAL.",4,4,8,0,0,31,
14-jun-13,B.C.S.,"LORETO, B.C.S.",3,5,8,0,0,0,
22-jun-13,MEX.,"NAUCALPAN DE JUAREZ, MEX.",5,3,8,1,0,136,
24-jun-13,PUE.,"PUE., PUE.",6,2,8,0,3,160,
25-jun-13,B.C.,"MEXICALI, B.C.",3,5,8,0,0,0,
27-jun-13,TAMPS.,"VICTORIA, TAMPS.",3,5,8,0,0,300,
01-jul-13,CHIS.,"TAPACHULA, CHIS.",5,3,8,0,0,78,
02-jul-13,CHIS.,"TAPACHULA, CHIS.",4,4,8,0,0,10,
09-jul-13,N.L.,"APODACA, N.L.",5,3,8,3,0,4320,
11-jul-13,MOR.,"CUERNAVACA, MOR.",7,1,8,0,1,281,
12-jul-13,MEX.,"NAUCALPAN DE JUAREZ, MEX.",3,5,8,0,0,0,
14-jul-13,GRO.,"CHILPANCINGO DE LOS BRAVO, GRO.",4,4,8,0,6,30,
18-jul-13,MOR.,"CUERNAVACA, MOR.",7,1,8,0,0,127,
24-jul-13,B.C.,"MEXICALI, B.C.",1,7,8,0,0,0,
28-jul-13,GRO.,"ATENANGO DEL RIO, GRO.",5,3,8,0,0,86,
30-jul-13,B.C.,"TIJUANA, B.C.",5,3,8,0,0,0,
02-ago-13,N.L.,"MONTERREY, N.L.",7,1,8,0,0,637,
06-ago-13,N.L.,"GUADALUPE, N.L.",4,4,8,7,0,1051,
14-ago-13,HGO.,"PACHUCA DE SOTO, HGO.",6,2,8,0,0,0,
16-ago-13,HGO.,"PACHUCA DE SOTO, HGO.",6,2,8,0,0,100,
18-ago-13,QRO.,"TEQUISQUIAPAN, QRO.",2,6,8,0,0,0,
22-ago-13,TLAX.,"TLAX., TLAX.",6,2,8,1,0,0,
27-ago-13,SIN.,"MAZATLAN, SIN.",7,1,8,0,4,0,
29-ago-13,JAL.,"GUADALAJARA, JAL.",5,3,8,6,0,36,
30-ago-13,GTO.,"CELAYA, GTO.",5,3,8,0,0,0,
31-ago-13,TAMPS.,"VICTORIA, TAMPS.",8,0,8,2,0,367,
03-sep-13,N.L.,"AGUALEGUAS, N.L.",1,7,8,2,0,0,
05-sep-13,SON.,"SAN LUIS RIO COLORADO, SON.",4,4,8,0,0,8,
25-sep-13,SIN.,"CULIACAN, SIN.",8,0,8,0,7,0,
02-oct-13,ZAC.,"FRESNILLO, ZAC.",8,0,8,1,0,0,
07-oct-13,CHIS.,"TAPACHULA, CHIS.",5,3,8,0,0,0,
11-oct-13,SIN.,"ESCUINAPA, SIN.",3,5,8,0,0,0,
14-oct-13,SIN.,"CONCORDIA, SIN.",2,6,8,0,0,0,
14-oct-13,COAH.,"PIEDRAS NEGRAS, COAH.",5,3,8,0,0,342,
16-oct-13,ZAC.,"FRESNILLO, ZAC.",8,0,8,0,0,500,
23-oct-13,COAH.,"PIEDRAS NEGRAS, COAH.",7,1,8,0,0,1230,
26-oct-13,HGO.,"TULANCINGO DE BRAVO, HGO.",6,2,8,0,0,0,
26-nov-13,SON.,"GENERAL PLUTARCO ELIAS CALLES, SON.",6,2,8,3,0,3,
06-dic-13,SON.,"NOGALES, SON.",6,2,8,0,2,21,
14-dic-13,D.F.,"CUAUHTEMOC, D.F.",6,2,8,0,0,20,
18-dic-13,N.L.,"MONTEMOR., N.L.",2,6,8,0,0,150,
27-dic-13,TAMPS.,"MATAMOROS, TAMPS.",6,2,8,2,0,618,
07-ene-14,PUE.,"PUE., PUE.",8,0,8,0,2,292,
06-feb-14,COAH.,"PIEDRAS NEGRAS, COAH.",2,6,8,0,0,181,
10-feb-14,D.F.,"CUAUHTEMOC, D.F.",6,2,8,0,3,50,
25-feb-14,D.F.,"MIGUEL HGO., D.F.",5,3,8,0,0,263,
06-mar-14,N.L.,"MONTERREY, N.L.",5,3,8,49,0,2550,
18-mar-14,D.F.,"IZTAPALAPA, D.F.",8,0,8,1,0,10,
20-mar-14,TAMPS.,"MATAMOROS, TAMPS.",4,4,8,0,0,673,
22-mar-14,TAMPS.,"MATAMOROS, TAMPS.",4,4,8,0,0,673,
25-mar-14,MEX.,"ZUMPANGO, MEX.",8,0,8,0,0,0,
27-mar-14,MEX.,"ZUMPANGO, MEX.",7,1,8,0,0,49,
31-mar-14,ZAC.,"SOMBRERETE, ZAC.",8,0,8,0,0,0,
01-abr-14,QRO.,"PEDRO ESCOBEDO, QRO.",6,2,8,0,0,0,
03-abr-14,MEX.,"COACALCO DE BERRIOZABAL, MEX.",8,0,8,0,0,31,
09-abr-14,D.F.,"MILPA ALTA, D.F.",7,1,8,0,0,0,
14-abr-14,B.C.,"MEXICALI, B.C.",5,3,8,0,0,0,
14-abr-14,JAL.,"ZAPOPAN, JAL.",8,0,8,0,0,0,
21-abr-14,MEX.,"NAUCALPAN DE JUAREZ, MEX.",3,5,8,0,0,52,
23-abr-14,SIN.,"SALVADOR ALVARADO, SIN.",3,5,8,0,0,0,
24-abr-14,JAL.,"ZAPOPAN, JAL.",3,5,8,0,0,0,
24-abr-14,MEX.,"HUIXQUILUCAN, MEX.",6,2,8,2,0,200,
25-abr-14,MEX.,"OCOYOACAC, MEX.",6,2,8,0,0,0,
28-abr-14,MEX.,"TEOLOYUCAN, MEX.",7,1,8,1,0,0,
02-may-14,MEX.,"TEOLOYUCAN, MEX.",4,4,8,0,0,5,
07-may-14,MEX.,"NAUCALPAN DE JUAREZ, MEX.",8,0,8,2,0,0,
15-may-14,MEX.,"TENANGO DEL VALLE, MEX.",6,2,8,0,0,0,
19-may-14,MEX.,"NAUCALPAN DE JUAREZ, MEX.",7,1,8,3,0,100,
21-may-14,MEX.,"NAUCALPAN DE JUAREZ, MEX.",7,1,8,0,0,90,
21-may-14,MEX.,"TULTEPEC, MEX.",8,0,8,1,0,1,
23-may-14,NAY.,"SANTA MARIA DEL ORO, NAY.",0,8,8,0,0,0,
23-may-14,MEX.,"METEPEC, MEX.",6,2,8,2,0,800,
24-may-14,MEX.,"ACOLMAN, MEX.",5,3,8,0,3,0,
26-may-14,NAY.,"SANTA MARIA DEL ORO, NAY.",0,8,8,0,0,0,
27-may-14,MEX.,"ZINACANTEPEC, MEX.",8,0,8,1,0,0,
28-may-14,NAY.,"ACAPONETA, NAY.",4,4,8,0,0,0,
28-may-14,CHIH.,"CHIH., CHIH.",6,2,8,14,0,329,
04-jun-14,MEX.,"TEJUPILCO, MEX.",8,0,8,4,0,0,
04-jun-14,B.C.,"TIJUANA, B.C.",3,5,8,0,0,0,
07-jun-14,MEX.,"HUEYPOXTLA, MEX.",5,3,8,0,0,0,
09-jun-14,SIN.,"CULIACAN, SIN.",2,6,8,0,3,0,
16-jun-14,MEX.,"VALLE DE CHALCO SOLIDARIDAD, MEX.",8,0,8,0,0,0,
20-jun-14,MEX.,"TULTITLAN, MEX.",8,0,8,0,0,50,
23-jun-14,SIN.,"SIN., SIN.",1,7,8,0,0,0,
23-jun-14,MEX.,"ECATEPEC DE MOR., MEX.",7,1,8,0,2,0,
11-jul-14,NAY.,"ACAPONETA, NAY.",4,4,8,0,0,0,
17-jul-14,CHIH.,"JUÁREZ, CHIH.",4,4,8,0,0,0,
20-jul-14,TAMPS.,"MATAMOROS, TAMPS.",3,5,8,0,0,0,
29-jul-14,B.C.,"TIJUANA, B.C.",5,3,8,0,0,0,
14-ago-14,N.L.,"MONTERREY, N.L.",7,1,8,29,0,703,
27-ago-14,SIN.,"COSALA, SIN.",8,0,8,0,0,0,
29-ago-14,TAMPS.,"MATAMOROS, TAMPS.",6,2,8,0,0,0,
29-ago-14,MICH.,"ZAMORA, MICH.",6,2,8,4,0,403,
02-oct-14,N.L.,"MONTERREY, N.L.",7,1,8,106,0,1875,
06-oct-14,B.C.,"TIJUANA, B.C.",5,3,8,0,0,0,
10-oct-14,B.C.,"MEXICALI, B.C.",4,4,8,0,0,0,
17-oct-14,MICH.,"ZACAPU, MICH.",5,3,8,2,0,100,
17-oct-14,MOR.,"CUERNAVACA, MOR.",4,4,8,0,1,23,
18-oct-14,MICH.,"PATZCUARO, MICH.",4,4,8,1,0,0,
18-oct-14,CHIS.,"OCOZOCOAUTLA DE ESPINOSA, CHIS.",4,4,8,0,0,138,
21-oct-14,CHIS.,"COMITAN DE DOMÍNGUEZ, CHIS.",7,1,8,6,0,587,
22-oct-14,MICH.,"ARIO, MICH.",5,3,8,0,0,0,
23-oct-14,MICH.,"MORELIA, MICH.",5,3,8,2,0,220,
25-oct-14,TAMPS.,"MATAMOROS, TAMPS.",3,5,8,0,0,0,
27-oct-14,CHIS.,"TAPACHULA, CHIS.",6,2,8,1,0,653,
27-oct-14,CHIS.,"OCOZOCOAUTLA DE ESPINOSA, CHIS.",4,4,8,5,0,346,
28-oct-14,CHIS.,"OCOZOCOAUTLA DE ESPINOSA, CHIS.",2,6,8,3,0,376,
29-oct-14,MICH.,"MORELIA, MICH.",7,1,8,4,0,447,
29-oct-14,CHIS.,"OCOZOCOAUTLA DE ESPINOSA, CHIS.",3,5,8,3,0,628,
31-oct-14,CHIS.,"OCOZOCOAUTLA DE ESPINOSA, CHIS.",3,5,8,0,1,146,
05-nov-14,CHIS.,"VILLAFLORES, CHIS.",4,4,8,2,0,163,
07-nov-14,CHIS.,"SAN CRISTOBAL DE LAS CASAS, CHIS.",8,0,8,2,0,85,
08-nov-14,CHIS.,"SAN CRISTOBAL DE LAS CASAS, CHIS.",7,1,8,1,0,0,
18-nov-14,SIN.,"CHOIX, SIN.",4,4,8,0,0,0,
18-nov-14,SIN.,"MAZATLAN, SIN.",7,1,8,0,0,0,
02-dic-14,N.L.,"MONTERREY, N.L.",2,6,8,2,0,470,
04-dic-14,N.L.,"ANAHUAC, N.L.",2,6,8,4,0,204,
06-dic-14,N.L.,"MONTERREY, N.L.",2,6,8,50,0,364,
27-dic-14,DGO.,"DGO., DGO.",7,1,8,0,1,0,
28-dic-14,DGO.,"GOMEZ PALACIO, DGO.",1,7,8,1,2,0,
30-dic-14,DGO.,"DGO., DGO.",4,4,8,0,0,0,
26-ene-15,B.C.,"TIJUANA, B.C.",5,3,8,0,0,0,
14-feb-15,B.C.,"MEXICALI, B.C.",2,6,8,0,0,0,
18-feb-15,B.C.,"TIJUANA, B.C.",4,4,8,0,0,0,
21-feb-15,TAMPS.,"MATAMOROS, TAMPS.",0,8,8,0,0,0,
05-ago-15,MEX.,"METEPEC, MEX.",8,0,8,1,0,121,
07-ago-15,MEX.,"NAUCALPAN DE JUAREZ, MEX.",6,2,8,1,15,0,
09-ago-15,DGO.,"DGO., DGO.",5,3,8,16,0,0,
09-ago-15,DGO.,"TLAHUALILO, DGO.",4,4,8,0,0,0,
09-ago-15,TAMPS.,"VICTORIA, TAMPS.",7,1,8,5,0,356,
11-ago-15,SIN.,"SALVADOR ALVARADO, SIN.",3,5,8,0,0,0,
11-ago-15,COAH.,"SALTILLO, COAH.",8,0,8,10,2,385,
13-ago-15,COAH.,"TORREÓN, COAH.",6,2,8,0,0,0,
13-ago-15,COAH.,"TORREÓN, COAH.",6,2,8,0,0,0,
13-ago-15,MEX.,"AMECAMECA, MEX.",5,3,8,0,0,0,
14-ago-15,MEX.,"TOLUCA, MEX.",6,2,8,1,1,0,
17-ago-15,COAH.,"MONCLOVA, COAH.",5,3,8,0,0,100,
18-ago-15,COAH.,"TORREÓN, COAH.",7,1,8,0,0,1400,
19-ago-15,COAH.,"SALTILLO, COAH.",1,7,8,3,0,217,
19-ago-15,SIN.,"MAZATLAN, SIN.",7,1,8,0,12,0,
19-ago-15,SIN.,"CULIACAN, SIN.",5,3,8,0,2,0,
19-ago-15,DGO.,"GOMEZ PALACIO, DGO.",4,4,8,0,0,0,
20-ago-15,SIN.,"CULIACAN, SIN.",6,2,8,0,0,0,
21-ago-15,MEX.,"CUAUTITLAN, MEX.",4,4,8,4,0,0,
22-ago-15,MEX.,"CUAUTITLAN IZCALLI, MEX.",8,0,8,0,0,53,
24-ago-15,SIN.,"MAZATLAN, SIN.",7,1,8,0,2,0,
24-ago-15,SIN.,"SALVADOR ALVARADO, SIN.",6,2,8,0,0,0,
24-ago-15,SIN.,"CULIACAN, SIN.",7,1,8,0,11,0,
25-ago-15,DGO.,"GOMEZ PALACIO, DGO.",3,5,8,0,0,0,
26-ago-15,COAH.,"SALTILLO, COAH.",6,2,8,0,2,400,
26-ago-15,ZAC.,"ZAC., ZAC.",8,0,8,0,0,268,
27-ago-15,SON.,"HERMOSILLO, SON.",5,3,8,0,0,0,
27-ago-15,DGO.,"GOMEZ PALACIO, DGO.",4,4,8,1,0,0,
28-ago-15,COAH.,"SALTILLO, COAH.",4,4,8,3,3,403,
28-ago-15,SIN.,"SALVADOR ALVARADO, SIN.",3,5,8,0,0,8,
28-ago-15,DGO.,"GOMEZ PALACIO, DGO.",8,0,8,3,0,0,
01-sep-15,COAH.,"SALTILLO, COAH.",8,0,8,3,2,173,
02-sep-15,OAX.,"OAX. DE JUAREZ, OAX.",2,6,8,3,0,86,
03-sep-15,DGO.,"GOMEZ PALACIO, DGO.",7,1,8,0,0,0,
04-sep-15,MEX.,"COACALCO DE BERRIOZABAL, MEX.",7,1,8,0,5,0,
08-sep-15,MEX.,"CHALCO, MEX.",8,0,8,0,0,460,
09-sep-15,B.C.,"TIJUANA, B.C.",7,1,8,0,0,0,
10-sep-15,DGO.,"GOMEZ PALACIO, DGO.",5,3,8,0,0,0,
10-sep-15,B.C.,"TIJUANA, B.C.",7,1,8,0,0,0,
11-sep-15,B.C.,"TIJUANA, B.C.",6,2,8,0,0,0,
11-sep-15,COAH.,"SALTILLO, COAH.",3,5,8,0,1,325,
18-sep-15,COAH.,"PIEDRAS NEGRAS, COAH.",4,4,8,0,0,0,
21-sep-15,COAH.,"SALTILLO, COAH.",7,1,8,0,0,12,
21-sep-15,COAH.,"MONCLOVA, COAH.",5,3,8,1,0,11,
21-sep-15,SIN.,"MAZATLAN, SIN.",4,4,8,0,7,0,
21-sep-15,SIN.,"CHOIX, SIN.",3,5,8,0,0,0,
22-sep-15,MEX.,"TLALMANALCO, MEX.",8,0,8,0,1,210,
28-sep-15,SIN.,"BADIRAGUATO, SIN.",5,3,8,0,0,0,
02-oct-15,SIN.,"BADIRAGUATO, SIN.",5,3,8,0,0,0,
02-oct-15,B.C.,"TIJUANA, B.C.",5,3,8,0,0,0,
02-oct-15,COAH.,"SALTILLO, COAH.",6,2,8,1,1,121,
05-oct-15,COAH.,"SALTILLO, COAH.",5,3,8,5,1,397,
15-oct-15,D.F.,"ALVARO OBREGON, D.F.",1,7,8,0,3,70,
16-oct-15,COAH.,"PIEDRAS NEGRAS, COAH.",4,4,8,1,0,40,
17-oct-15,B.C.,"MEXICALI, B.C.",3,5,8,0,0,0,
28-oct-15,D.F.,"ALVARO OBREGON, D.F.",5,3,8,0,0,0,
03-nov-15,SIN.,"GUASAVE, SIN.",4,4,8,0,4,0,
04-nov-15,B.C.,"MEXICALI, B.C.",4,4,8,0,0,0,
04-nov-15,COAH.,"PIEDRAS NEGRAS, COAH.",5,3,8,1,0,38,
04-nov-15,COAH.,"MONCLOVA, COAH.",4,4,8,1,0,36,
10-nov-15,COAH.,"TORREÓN, COAH.",7,1,8,0,0,0,
11-nov-15,N.L.,"MONTERREY, N.L.",8,0,8,2,0,950,
11-nov-15,COAH.,"SALTILLO, COAH.",7,1,8,4,2,79,
11-nov-15,MEX.,"TECAMAC, MEX.",7,1,8,0,0,90,
23-nov-15,COAH.,"TORREÓN, COAH.",7,1,8,0,0,0,
05-dic-15,SON.,"HERMOSILLO, SON.",3,5,8,5,0,0,
07-dic-15,S.L.P.,"RIOVERDE, S.L.P.",5,3,8,0,0,100,
10-dic-15,B.C.,"MEXICALI, B.C.",2,6,8,0,0,0,
11-dic-15,SON.,"HERMOSILLO, SON.",5,3,8,54,0,300,
23-ene-16,COAH.,"PIEDRAS NEGRAS, COAH.",5,3,8,0,0,47,
25-ene-16,COAH.,"SALTILLO, COAH.",8,0,8,1,1,254,
14-feb-16,TAMPS.,"MATAMOROS, TAMPS.",8,0,8,0,0,0,
21-feb-16,TAMPS.,"MATAMOROS, TAMPS.",5,3,8,0,0,0,
29-feb-16,COAH.,"SALTILLO, COAH.",5,3,8,0,0,322,
22-mar-16,GTO.,"SALAMANCA, GTO.",6,2,8,0,4,0,
08-abr-16,S.L.P.,"SAN LUIS POTOSI, S.L.P.",6,2,8,0,0,0,
11-abr-16,S.L.P.,"SOLEDAD DE GRACIANO SANCHEZ, S.L.P.",2,6,8,0,0,0,
19-abr-16,D.F.,"IZTACALCO, D.F.",6,2,8,78,0,0,
24-may-16,COAH.,"MONCLOVA, COAH.",5,3,8,1,1,30,
24-may-16,COAH.,"FRANCISCO I. MADERO, COAH.",5,3,8,25,2,0,
27-may-16,N.L.,"GUADALUPE, N.L.",7,1,8,0,0,138,
22-jun-16,SIN.,"MAZATLAN, SIN.",5,3,8,0,12,0,
12-ago-16,MEX.,"ACOLMAN, MEX.",7,1,8,0,1,4,
19-ago-16,MEX.,"ZUMPANGO, MEX.",7,1,8,3,0,12,
22-ago-16,MEX.,"CUAUTITLAN IZCALLI, MEX.",4,4,8,6,1,51,
27-ago-16,MEX.,"CUAUTITLAN IZCALLI, MEX.",7,1,8,2,0,292,
29-ago-16,CHIS.,"CHAMULA, CHIS.",4,4,8,0,0,0,
31-ago-16,B.C.,"TIJUANA, B.C.",2,6,8,0,0,0,
01-sep-16,N.L.,"SAN NICOLAS DE LOS GARZA, N.L.",6,2,8,55,0,400,
12-sep-16,SON.,"CAJEME, SON.",6,2,8,21,0,0,
29-sep-16,CHIS.,"VILLAFLORES, CHIS.",5,3,8,1,0,657,
12-oct-16,MEX.,"ECATEPEC DE MOR., MEX.",6,2,8,2,0,706,
14-oct-16,MEX.,"IXTAPALUCA, MEX.",5,3,8,3,0,1,
25-oct-16,MEX.,"TEOTIHUACAN, MEX.",5,3,8,5,1,0,
29-oct-16,MEX.,"TEOTIHUACAN, MEX.",5,3,8,1,0,0,
24-nov-16,SON.,"CAJEME, SON.",4,4,8,0,0,0,
30-nov-16,SON.,"BENITO JUAREZ, SON.",0,8,8,0,0,0,
03-dic-16,S.L.P.,"SAN LUIS POTOSI, S.L.P.",8,0,8,3,0,0,
10-dic-16,TAMPS.,"MATAMOROS, TAMPS.",4,4,8,3,0,85,
11-dic-16,GTO.,"IRAPUATO, GTO.",5,3,8,0,0,0,
14-ene-17,B.C.,"TIJUANA, B.C.",2,6,8,0,0,0,
14-feb-17,B.C.,"TIJUANA, B.C.",2,6,8,0,0,0,
14-mar-17,VER.,"VER., VER.",7,1,8,0,0,0,
18-mar-17,MEX.,"TEMOAYA, MEX.",3,5,8,0,0,1,
19-mar-17,MEX.,"ECATEPEC DE MOR., MEX.",6,2,8,0,5,44,
22-mar-17,ZAC.,"NORIA DE ANGELES, ZAC.",3,5,8,0,0,0,
26-mar-17,QRO.,"QUERETARO, QRO.",2,6,8,0,0,0,
27-mar-17,QRO.,"QUERETARO, QRO.",7,1,8,0,0,0,
26-abr-17,S.L.P.,"SAN LUIS POTOSI, S.L.P.",8,0,8,9,7,0,
26-abr-17,JAL.,"GUADALAJARA, JAL.",8,0,8,0,0,0,
27-abr-17,SIN.,"SIN., SIN.",4,4,8,0,0,0,
26-may-17,SIN.,"SIN., SIN.",7,1,8,0,1,0,
03-jun-17,CHIH.,"HGO. DEL PARRAL, CHIH.",6,2,8,6,0,5740,
09-jun-17,YUC.,"MERIDA, YUC.",5,3,8,0,0,381,
09-jun-17,B.C.,"TIJUANA, B.C.",0,8,8,0,3,0,
14-jun-17,D.F.,"GUSTAVO A. MADERO, D.F.",7,1,8,0,0,106,
15-jun-17,MEX.,"NEZAHUALCOYOTL, MEX.",8,0,8,4,6,51,
15-jun-17,MEX.,"CUAUTITLAN IZCALLI, MEX.",7,1,8,8,1,10,
27-jun-17,MEX.,"JOCOTITLAN, MEX.",1,7,8,0,0,0,
28-jul-17,MEX.,"CHAPA DE MOTA, MEX.",4,4,8,0,0,0,
05-ago-17,CHIS.,"TUXTLA GUTIÉRREZ, CHIS.",6,2,8,2,0,143,
10-ago-17,SIN.,"EL FUERTE, SIN.",6,2,8,0,0,0,
15-ago-17,MEX.,"CHIMALHUACAN, MEX.",6,2,8,0,0,42,
22-ago-17,S.L.P.,"SAN LUIS POTOSI, S.L.P.",4,4,8,2,0,0,
09-sep-17,QRO.,"PINAL DE AMOLES, QRO.",7,1,8,0,0,0,
05-dic-17,CHIH.,"JUÁREZ, CHIH.",3,5,8,15,0,802,
15-dic-17,TAMPS.,"MATAMOROS, TAMPS.",1,7,8,1,0,77,
26-ene-18,D.F.,"CUAUHTEMOC, D.F.",6,2,8,0,0,799,
13-feb-18,ZAC.,"GUADALUPE, ZAC.",7,1,8,8,0,0,
15-feb-18,COAH.,"SALTILLO, COAH.",5,3,8,1,0,686,
20-feb-18,COAH.,"TORREÓN, COAH.",7,1,8,0,0,163,
18-mar-18,QRO.,"QUERETARO, QRO.",6,2,8,2,0,0,
17-jul-18,N.L.,"MONTERREY, N.L.",8,0,8,2,0,0,
03-ago-18,TAMPS.,"MATAMOROS, TAMPS.",5,3,8,0,0,36,
06-ago-18,TAMPS.,"TAMPICO, TAMPS.",5,3,8,0,1,86,
09-ago-18,MEX.,"CHALCO, MEX.",7,1,8,0,0,461,
17-ago-18,D.F.,"GUSTAVO A. MADERO, D.F.",4,4,8,0,8,342,
25-ago-18,MEX.,"TLALNEPANTLA DE BAZ, MEX.",7,1,8,0,0,261,
28-ago-18,ZAC.,"ZAC., ZAC.",7,1,8,0,0,9,
29-ago-18,ZAC.,"FRESNILLO, ZAC.",5,3,8,0,0,0,
06-sep-18,ZAC.,"FRESNILLO, ZAC.",8,0,8,0,0,0,
20-sep-18,MEX.,"NEZAHUALCOYOTL, MEX.",7,1,8,0,1,26,
19-oct-18,MEX.,"ATIZAPAN, MEX.",6,2,8,0,0,0,
21-nov-18,D.F.,"CUAJIMALPA DE MOR., D.F.",7,1,8,0,0,277,
11-dic-18,SIN.,"BADIRAGUATO, SIN.",2,6,8,0,0,0,
08-feb-19,CD. MÉX.,"IZTAPALAPA, CD. MÉX.",6,2,8,0,0,52690,
28-feb-19,GTO.,"ACAMBARO, GTO.",7,1,8,0,0,0,
11-mar-19,CD. MÉX.,"BENITO JUAREZ, CD. MÉX.",7,1,8,0,0,221,
18-mar-19,CD. MÉX.,"BENITO JUAREZ, CD. MÉX.",5,3,8,0,0,727,
04-abr-19,CD. MÉX.,"MIGUEL HGO., CD. MÉX.",4,4,8,0,0,613,
10-abr-19,ZAC.,"FRESNILLO, ZAC.",6,2,8,5,0,65,
16-abr-19,CD. MÉX.,"IZTAPALAPA, CD. MÉX.",6,2,8,0,0,559,
26-abr-19,CD. MÉX.,"VENUSTIANO CARRANZA, CD. MÉX.",8,0,8,0,0,839,
30-abr-19,CD. MÉX.,"IZTAPALAPA, CD. MÉX.",6,2,8,0,1,191,
14-may-19,CD. MÉX.,"TLALPAN, CD. MÉX.",8,0,8,0,0,478,
20-may-19,CD. MÉX.,"VENUSTIANO CARRANZA, CD. MÉX.",5,3,8,0,0,491,
23-may-19,CHIH.,"JUÁREZ, CHIH.",3,5,8,19,0,547,
28-may-19,CD. MÉX.,"IZTAPALAPA, CD. MÉX.",6,2,8,0,3,2950,
30-may-19,CD. MÉX.,"IZTAPALAPA, CD. MÉX.",6,2,8,0,0,485,
06-jun-19,CD. MÉX.,"AZCAPOTZALCO, CD. MÉX.",3,5,8,0,0,450,
18-jun-19,CD. MÉX.,"IZTACALCO, CD. MÉX.",5,3,8,0,0,366,
19-jun-19,CD. MÉX.,"IZTACALCO, CD. MÉX.",7,1,8,0,0,236,
22-jul-19,CD. MÉX.,"IZTAPALAPA, CD. MÉX.",6,2,8,0,0,94,
26-jul-19,NAY.,"XALISCO, NAY.",4,4,8,0,0,0,
09-sep-19,CD. MÉX.,"COYOACAN, CD. MÉX.",8,0,8,0,0,100,
10-sep-19,CD. MÉX.,"COYOACAN, CD. MÉX.",7,1,8,0,0,5796,
13-sep-19,CD. MÉX.,"IZTAPALAPA, CD. MÉX.",6,2,8,0,0,0,
23-sep-19,MÉX.,"CHIMALHUACAN, MEX.",7,1,8,4,0,76,
27-sep-19,MÉX.,"CHIMALHUACAN, MEX.",4,4,8,1,0,56,
27-sep-19,CD. MÉX.,"IZTAPALAPA, CD. MÉX.",2,6,8,0,0,3205,
04-nov-19,CD. MÉX.,"BENITO JUAREZ, CD. MÉX.",1,7,8,0,0,67,
19-nov-19,CD. MÉX.,"IZTAPALAPA, CD. MÉX.",4,4,8,0,0,972,
27-nov-19,GTO.,"LEON, GTO.",3,5,8,0,0,0,
29-nov-19,CD. MÉX.,"IZTAPALAPA, CD. MÉX.",1,7,8,0,0,7,
04-dic-19,CD. MÉX.,"IZTAPALAPA, CD. MÉX.",1,7,8,0,0,129,
12-dic-19,CD. MÉX.,"IZTACALCO, CD. MÉX.",2,6,8,0,4,55,
06-feb-20,CD. MÉX.,"IZTAPALAPA, CD. MÉX.",7,1,8,0,0,52,
12-feb-20,CD. MÉX.,"IZTAPALAPA, CD. MÉX.",3,5,8,0,0,76,
24-feb-20,CD. MÉX.,"TLALPAN, CD. MÉX.",8,0,8,0,0,151,
17-mar-20,CHIH.,"JUÁREZ, CHIH.",7,1,8,13,0,306,
31-jul-20,CD. MÉX.,"GUSTAVO A. MADERO, CD. MÉX.",4,4,8,0,2,562,
11-dic-20,CD. MÉX.,"CUAUHTEMOC, CD. MÉX.",0,8,8,0,0,0,
14-sep-21,B.C.,"MEXICALI, B.C.",3,5,8,0,0,0,
27-sep-21,CHIH.,"DELICIAS, CHIH.",7,1,8,0,0,0,
02-dic-21,SON.,"HERMOSILLO, SON.",7,1,8,4,0,15,
27-ene-22,CD. MÉX.,"CUAUHTEMOC, CD. MÉX.",5,3,8,0,0,216,
26-may-22,CD. MÉX.,"VENUSTIANO CARRANZA, CD. MÉX.",2,6,8,0,0,198,
01-jun-22,VER.,"XALAPA, VER.",6,2,8,60,0,2030,
16-jun-22,CD. MÉX.,"ALVARO OBREGON, CD. MÉX.",7,1,8,0,0,94,
17-jun-22,CD. MÉX.,"TLALPAN, CD. MÉX.",5,3,8,0,0,490,
21-jun-22,CHIH.,"JUÁREZ, CHIH.",6,2,8,9,0,422,
23-jun-22,JAL.,"GUADALAJARA, JAL.",5,3,8,1,0,188,
23-jun-22,B.C.,"SAN FELIPE, B.C.",3,5,8,15,0,3253,
30-jun-22,JAL.,"ZAPOTLAN EL GRANDE, JAL.",4,4,8,2,0,73,
05-jul-22,JAL.,"TLAQUEPAQUE, JAL.",7,1,8,0,0,21,
06-jul-22,JAL.,"TLAQUEPAQUE, JAL.",4,4,8,5,2,122,
11-jul-22,CD. MÉX.,"BENITO JUAREZ, CD. MÉX.",4,4,8,0,0,138,
14-jul-22,GRO.,"TECPAN DE GALEANA, GRO.",5,3,8,0,0,0,
11-ago-22,COAH.,"ARTEAGA, COAH.",5,3,8,0,0,0,
24-ago-22,MÉX.,"CHIMALHUACAN, MEX.",7,1,8,3,0,0,
25-ago-22,MÉX.,"ATIZAPAN, MEX.",5,3,8,2,1,3,
30-ago-22,MÉX.,"CHIMALHUACAN, MEX.",8,0,8,3,0,100,
01-sep-22,N.L.,"APODACA, N.L.",6,2,8,7,0,170,
02-sep-22,MOR.,"CUERNAVACA, MOR.",8,0,8,13,0,386,
02-sep-22,MÉX.,"CHIMALHUACAN, MEX.",4,4,8,3,0,80,
03-sep-22,MÉX.,"TEPETLAOXTOC, MEX.",5,3,8,0,2,0,
03-sep-22,MÉX.,"CHIMALHUACAN, MEX.",6,2,8,0,0,36,
24-sep-22,MÉX.,"TLALNEPANTLA DE BAZ, MEX.",8,0,8,0,0,38,
18-oct-22,SIN.,"MAZATLAN, SIN.",3,5,8,0,2,63,
27-oct-22,N.L.,"MONTERREY, N.L.",6,2,8,0,0,65,
28-oct-22,GRO.,"IGUALA DE LA INDEPENDENCIA, GRO.",4,4,8,9,0,490,
13-nov-22,GTO.,"LEON, GTO.",8,0,8,0,0,0,
16-dic-22,MICH.,"ZAMORA, MICH.",3,5,8,1,0,182,
22-mar-23,México,"CUAUTITLAN, MEX.",8,0,8,0,0,273,
28-mar-23,México,"TLALNEPANTLA DE BAZ, MEX.",1,7,8,0,0,14,
01-abr-23,México,"TLALNEPANTLA DE BAZ, MEX.",7,1,8,0,0,658,
10-abr-23,Cd. de México,"ALVARO OBREGON, CD. MÉX.",7,1,8,0,0,"1,002",
14-abr-23,Cd. de México,"BENITO JUAREZ, CD. MÉX.",6,2,8,0,0,"1,636",
14-abr-23,Cd. de México,"CUAUHTEMOC, CD. MÉX.",6,2,8,0,0,427,
08-may-23,Cd. de México,"CUAUHTEMOC, CD. MÉX.",4,4,8,0,0,79,
08-jun-23,Sinaloa,"EL FUERTE, SIN.",4,4,8,0,0,0,
09-jun-23,Sinaloa,"CHOIX, SIN.",2,6,8,0,0,0,
22-jun-23,Guanajuato,"SALAMANCA, GTO.",7,1,8,1,0,833,
27-jun-23,México,"VALLE DE CHALCO SOLIDARIDAD, MEX.",7,1,8,0,2,183,
28-jun-23,Guanajuato,"CELAYA, GTO.",7,1,8,4,0,202,
30-jun-23,Guanajuato,"CELAYA, GTO.",5,3,8,1,2,"1,160",
30-jun-23,Querétaro,"QUERETARO, QRO.",4,4,8,0,1,83,
03-jul-23,Sinaloa,"AHOME, SIN.",5,3,8,0,0,10,
03-jul-23,México,"CHIMALHUACAN, MEX.",7,1,8,0,0,5,
04-jul-23,Sinaloa,"AHOME, SIN.",6,2,8,0,0,66,
01-ago-23,Cd. de México,"CUAUHTEMOC, CD. MÉX.",3,5,8,5,1,25,
02-ago-23,Chihuahua,"JUÁREZ, CHIH.",5,3,8,2,0,815,
09-ago-23,Tamaulipas,"VICTORIA, TAMPS.",5,3,8,0,0,0,
17-ago-23,Chihuahua,"JUÁREZ, CHIH.",8,0,8,4,0,206,
18-ago-23,Chihuahua,"JUÁREZ, CHIH.",6,2,8,16,0,393,
12-oct-23,Sinaloa,"ROSARIO, SIN.",4,4,8,0,0,0,
11-jun-24,Michoacán,"APATZINGAN, MICH.",5,3,8,16,0,"1,994",
15-jun-24,Veracruz,"VERACRUZ, VER.",6,2,8,22,0,"3,030",
21-jun-24,Sinaloa,"SALVADOR ALVARADO, SIN.",8,0,8,0,0,0,
24-jun-24,Sinaloa,"SALVADOR ALVARADO, SIN.",7,1,8,0,3,284,
27-jun-24,Sinaloa,"CULIACAN, SIN.",8,0,8,0,0,324,
26-jun-24,Sinaloa,"CULIACAN, SIN.",8,0,8,0,0,350,
02-feb-13,TAMPS.,"TAMPICO, TAMPS.",5,2,7,1,0,210,
05-feb-13,D.F.,"IZTAPALAPA, D.F.",3,4,7,0,0,10,
08-feb-13,D.F.,"IZTAPALAPA, D.F.",3,4,7,0,0,120,
08-feb-13,TAMPS.,"TAMPICO, TAMPS.",5,2,7,11,2,595,
11-feb-13,MEX.,"NAUCALPAN DE JUAREZ, MEX.",4,3,7,0,4,400,
12-feb-13,CHIH.,"CHIH., CHIH.",6,1,7,0,2,248,
12-feb-13,CHIH.,"OJINAGA, CHIH.",2,5,7,0,0,0,
14-feb-13,CHIH.,"CHIH., CHIH.",5,2,7,0,0,131,
15-feb-13,TAMPS.,"TAMPICO, TAMPS.",5,2,7,0,0,0,
22-feb-13,GRO.,"ACAPULCO DE JUAREZ, GRO.",6,1,7,2,2,361,
25-feb-13,HGO.,"PACHUCA DE SOTO, HGO.",6,1,7,0,0,87,
28-feb-13,CHIS.,"SAN CRISTOBAL DE LAS CASAS, CHIS.",2,5,7,0,0,381,
01-mar-13,N.L.,"GARCIA, N.L.",5,2,7,1,0,113,
07-mar-13,HGO.,"TULANCINGO DE BRAVO, HGO.",4,3,7,0,0,634,
09-mar-13,N.L.,"SAN NICOLAS DE LOS GARZA, N.L.",1,6,7,1,0,2026,
11-mar-13,VER.,"TUXPAM, VER.",3,4,7,0,0,31,
11-mar-13,VER.,"TUXPAM, VER.",4,3,7,0,0,972,
12-mar-13,MEX.,"HUIXQUILUCAN, MEX.",5,2,7,1,2,526,
13-mar-13,CHIH.,"CUAUHTÉMOC, CHIH.",5,2,7,1,0,138,
19-mar-13,S.L.P.,"SOLEDAD DE GRACIANO SANCHEZ, S.L.P.",7,0,7,2,0,23,
21-mar-13,N.L.,"CADEREYTA JIMENEZ, N.L.",5,2,7,3,0,0,
27-mar-13,HGO.,"TEPEAPULCO, HGO.",3,4,7,0,3,0,
03-abr-13,N.L.,"MELCHOR OCAMPO, N.L.",4,3,7,0,0,0,
06-abr-13,MEX.,"ZINACANTEPEC, MEX.",5,2,7,0,1,0,
06-abr-13,MICH.,"SALVADOR ESCALANTE, MICH.",4,3,7,0,0,0,
07-abr-13,MEX.,"IXTLAHUACA, MEX.",6,1,7,0,0,0,
12-abr-13,OAX.,"CIUDAD IXTEPEC, OAX.",6,1,7,0,0,0,
13-abr-13,QRO.,"AMEALCO DE BONFIL, QRO.",5,2,7,0,0,0,
13-abr-13,MEX.,"MALINALCO, MEX.",4,3,7,0,0,0,
14-abr-13,MICH.,"SALVADOR ESCALANTE, MICH.",4,3,7,0,1,0,
14-abr-13,MEX.,"TEOTIHUACAN, MEX.",6,1,7,0,4,0,
14-abr-13,MEX.,"IXTAPAN DE LA SAL, MEX.",6,1,7,1,0,341,
15-abr-13,NAY.,"TEPIC, NAY.",3,4,7,0,0,0,
15-abr-13,SIN.,"GUASAVE, SIN.",3,4,7,0,1,0,
15-abr-13,B.C.,"TECATE, B.C.",2,5,7,0,0,0,
17-abr-13,QRO.,"COLON, QRO.",6,1,7,0,0,0,
17-abr-13,SIN.,"GUASAVE, SIN.",4,3,7,0,8,0,
19-abr-13,QRO.,"EZEQUIEL MONTES, QRO.",3,4,7,0,2,0,
22-abr-13,SIN.,"GUASAVE, SIN.",2,5,7,0,0,0,
23-abr-13,N.L.,"GRAL. TERAN, N.L.",3,4,7,4,0,300,
23-abr-13,MICH.,"LA PIEDAD, MICH.",5,2,7,0,0,0,
26-abr-13,SIN.,"GUASAVE, SIN.",2,5,7,0,10,0,
27-abr-13,MICH.,"APATZINGAN, MICH.",6,1,7,0,1,0,
28-abr-13,N.L.,"GRAL. ZUAZUA, N.L.",6,1,7,2,0,0,
28-abr-13,MICH.,"LA PIEDAD, MICH.",3,4,7,0,0,0,
29-abr-13,N.L.,"LINARES, N.L.",3,4,7,2,0,50,
04-may-13,N.L.,"ITURBIDE, N.L.",3,4,7,9,0,0,
10-may-13,MICH.,"ZACAPU, MICH.",6,1,7,0,0,0,
15-may-13,MICH.,"ZITACUARO, MICH.",6,1,7,0,0,0,
17-may-13,SIN.,"SIN., SIN.",7,0,7,0,14,0,
21-may-13,TAMPS.,"REYNOSA, TAMPS.",3,4,7,0,11,9203,
21-may-13,MICH.,"URUAPAN, MICH.",7,0,7,0,0,0,
21-may-13,TAMPS.,"VICTORIA, TAMPS.",4,3,7,0,0,0,
21-may-13,TAMPS.,"VICTORIA, TAMPS.",4,3,7,0,0,0,
22-may-13,N.L.,"AGUALEGUAS, N.L.",1,6,7,0,0,0,
23-may-13,B.C.,"TIJUANA, B.C.",6,1,7,0,0,0,
24-may-13,SIN.,"SALVADOR ALVARADO, SIN.",4,3,7,0,9,0,
27-may-13,SIN.,"SALVADOR ALVARADO, SIN.",5,2,7,0,9,0,
30-may-13,MICH.,"HUETAMO, MICH.",2,5,7,5,0,0,
30-may-13,B.C.,"TIJUANA, B.C.",2,5,7,0,0,0,
02-jun-13,MICH.,"HUETAMO, MICH.",4,3,7,7,0,0,
07-jun-13,B.C.,"MEXICALI, B.C.",4,3,7,0,0,0,
10-jun-13,MICH.,"APATZINGAN, MICH.",0,7,7,0,0,0,
18-jun-13,MEX.,"NAUCALPAN DE JUAREZ, MEX.",3,4,7,5,0,92,
18-jun-13,COAH.,"TORREÓN, COAH.",6,1,7,0,0,0,
20-jun-13,B.C.,"TIJUANA, B.C.",4,3,7,0,0,0,
20-jun-13,B.C.,"MEXICALI, B.C.",5,2,7,0,0,0,
20-jun-13,COAH.,"TORREÓN, COAH.",6,1,7,0,0,0,
27-jun-13,TAMPS.,"VICTORIA, TAMPS.",4,3,7,0,4,546,
02-jul-13,MEX.,"NAUCALPAN DE JUAREZ, MEX.",6,1,7,2,1,504,
03-jul-13,CHIS.,"TONALÁ, CHIS.",2,5,7,0,0,0,
04-jul-13,SIN.,"NAVOLATO, SIN.",7,0,7,1,0,0,
06-jul-13,MEX.,"NAUCALPAN DE JUAREZ, MEX.",6,1,7,10,0,707,
07-jul-13,MOR.,"CUERNAVACA, MOR.",6,1,7,0,0,74,
09-jul-13,MOR.,"CUERNAVACA, MOR.",5,2,7,0,4,386,
09-jul-13,MEX.,"NAUCALPAN DE JUAREZ, MEX.",3,4,7,0,0,0,
10-jul-13,N.L.,"APODACA, N.L.",5,2,7,8,0,1437,
12-jul-13,GRO.,"CHILPANCINGO DE LOS BRAVO, GRO.",3,4,7,0,5,45,
13-jul-13,GRO.,"CHILPANCINGO DE LOS BRAVO, GRO.",3,4,7,4,7,437,
15-jul-13,PUE.,"PUE., PUE.",1,6,7,0,0,760,
17-jul-13,PUE.,"PUE., PUE.",1,6,7,0,2,555,
23-jul-13,CHIS.,"ARRIAGA, CHIS.",3,4,7,0,1,6,
24-jul-13,MOR.,"PUENTE DE IXTLA, MOR.",5,2,7,3,0,90,
05-ago-13,COAH.,"TORREÓN, COAH.",4,3,7,0,2,0,
06-ago-13,JAL.,"ZAPOPAN, JAL.",3,4,7,4,0,190,
07-ago-13,N.L.,"GUADALUPE, N.L.",6,1,7,1,0,4480,
12-ago-13,D.F.,"MIGUEL HGO., D.F.",7,0,7,0,0,51,
13-ago-13,HGO.,"PACHUCA DE SOTO, HGO.",7,0,7,0,1,0,
13-ago-13,MOR.,"CUAUTLA, MOR.",6,1,7,6,0,2449,
14-ago-13,MOR.,"CUAUTLA, MOR.",4,3,7,2,2,0,
15-ago-13,MOR.,"CUAUTLA, MOR.",2,5,7,0,5,0,
16-ago-13,TLAX.,"TLAX., TLAX.",3,4,7,1,0,22,
16-ago-13,B.C.,"MEXICALI, B.C.",4,3,7,0,0,0,
21-ago-13,SIN.,"MAZATLAN, SIN.",5,2,7,0,0,0,
21-ago-13,GTO.,"SAN FRANCISCO DEL RINCON, GTO.",3,4,7,0,0,0,
24-ago-13,N.L.,"VALLECILLO, N.L.",1,6,7,6,0,450,
31-ago-13,TLAX.,"TLAX., TLAX.",4,3,7,1,0,0,
01-sep-13,MOR.,"CUERNAVACA, MOR.",1,6,7,0,6,2213,
05-sep-13,N.L.,"AGUALEGUAS, N.L.",0,7,7,2,0,65,
07-sep-13,N.L.,"GRAL. BRAVO, N.L.",3,4,7,1,0,0,
07-sep-13,SON.,"SAN LUIS RIO COLORADO, SON.",4,3,7,1,0,0,
14-sep-13,SON.,"SAN LUIS RIO COLORADO, SON.",2,5,7,3,1,0,
26-sep-13,SIN.,"CULIACAN, SIN.",7,0,7,2,0,51,
02-oct-13,SIN.,"ROSARIO, SIN.",2,5,7,0,0,0,
09-oct-13,COAH.,"SALTILLO, COAH.",7,0,7,11,0,488,
15-oct-13,ZAC.,"FRESNILLO, ZAC.",7,0,7,10,0,25,
16-oct-13,ZAC.,"RIO GRANDE, ZAC.",7,0,7,1,0,0,
17-oct-13,COAH.,"PIEDRAS NEGRAS, COAH.",3,4,7,0,0,410,
23-oct-13,AGS.,"AGS., AGS.",7,0,7,9,3,360,
13-nov-13,TAMPS.,"TAMPICO, TAMPS.",2,5,7,0,0,666,
14-nov-13,HGO.,"TEPEJI DEL RIO DE OCAMPO, HGO.",4,3,7,0,0,0,
19-nov-13,D.F.,"CUAUHTEMOC, D.F.",6,1,7,1,0,25,
22-nov-13,SON.,"NAVOJOA, SON.",6,1,7,2,1,0,
25-nov-13,SON.,"CAJEME, SON.",3,4,7,2,0,0,
28-nov-13,COAH.,"PIEDRAS NEGRAS, COAH.",5,2,7,2,0,72,
05-dic-13,TAMPS.,"VICTORIA, TAMPS.",6,1,7,3,0,100,
20-dic-13,CHIH.,"OJINAGA, CHIH.",3,4,7,0,0,0,
27-dic-13,TAMPS.,"NUEVO LAREDO, TAMPS.",6,1,7,12,0,950,
02-feb-14,TAMPS.,"REYNOSA, TAMPS.",4,3,7,0,0,300,
06-feb-14,VER.,"BOCA DEL RIO, VER.",2,5,7,0,0,0,
06-feb-14,COAH.,"TORREÓN, COAH.",7,0,7,0,1,100,
07-feb-14,COAH.,"PIEDRAS NEGRAS, COAH.",5,2,7,0,0,14,
10-feb-14,COAH.,"TORREÓN, COAH.",7,0,7,0,0,198,
13-feb-14,COAH.,"PIEDRAS NEGRAS, COAH.",4,3,7,0,0,240,
19-feb-14,COAH.,"PIEDRAS NEGRAS, COAH.",3,4,7,0,0,0,
24-feb-14,D.F.,"MIGUEL HGO., D.F.",6,1,7,1,0,250,
12-mar-14,B.C.,"MEXICALI, B.C.",3,4,7,0,0,0,
14-mar-14,VER.,"VER., VER.",5,2,7,3,1,92,
14-mar-14,B.C.,"TIJUANA, B.C.",5,2,7,0,0,0,
14-mar-14,N.L.,"MONTERREY, N.L.",5,2,7,17,0,1470,
18-mar-14,N.L.,"MONTERREY, N.L.",6,1,7,30,0,135,
20-mar-14,VER.,"SAN RAFAEL, VER.",1,6,7,0,0,0,
25-mar-14,ZAC.,"SOMBRERETE, ZAC.",6,1,7,2,0,0,
28-mar-14,B.C.,"TIJUANA, B.C.",6,1,7,0,0,0,
28-mar-14,QRO.,"EZEQUIEL MONTES, QRO.",4,3,7,0,2,0,
28-mar-14,MEX.,"ZUMPANGO, MEX.",6,1,7,0,2,124,
30-mar-14,B.C.,"MEXICALI, B.C.",7,0,7,0,0,0,
31-mar-14,QRO.,"QUERETARO, QRO.",3,4,7,0,4,0,
31-mar-14,MEX.,"COACALCO DE BERRIOZABAL, MEX.",5,2,7,0,0,136,
01-abr-14,AGS.,"AGS., AGS.",4,3,7,3,0,46,
01-abr-14,MEX.,"NICOLAS ROMERO, MEX.",6,1,7,0,1,60,
03-abr-14,B.C.,"MEXICALI, B.C.",6,1,7,0,0,0,
07-abr-14,MEX.,"CUAUTITLAN IZCALLI, MEX.",6,1,7,0,1,0,
08-abr-14,B.C.,"ENSENADA, B.C.",4,3,7,0,0,0,
08-abr-14,JAL.,"TLAQUEPAQUE, JAL.",7,0,7,0,1,0,
11-abr-14,GTO.,"ACAMBARO, GTO.",5,2,7,0,2,0,
22-abr-14,MEX.,"OCOYOACAC, MEX.",7,0,7,3,0,17,
23-abr-14,MEX.,"OCOYOACAC, MEX.",6,1,7,0,0,146,
25-abr-14,MEX.,"HUIXQUILUCAN, MEX.",7,0,7,0,0,100,
26-abr-14,MEX.,"OCOYOACAC, MEX.",7,0,7,1,0,0,
30-abr-14,SIN.,"GUASAVE, SIN.",5,2,7,0,0,0,
13-may-14,B.C.,"MEXICALI, B.C.",3,4,7,0,0,0,
17-may-14,MEX.,"AMECAMECA, MEX.",7,0,7,0,0,0,
17-may-14,DGO.,"DGO., DGO.",6,1,7,6,2,0,
19-may-14,MEX.,"CHALCO, MEX.",7,0,7,2,1,47,
19-may-14,MEX.,"CHALCO, MEX.",7,0,7,2,1,47,
22-may-14,MEX.,"METEPEC, MEX.",4,3,7,1,5,0,
26-may-14,SIN.,"CHOIX, SIN.",2,5,7,0,0,0,
28-may-14,MEX.,"ZINACANTEPEC, MEX.",4,3,7,7,0,184,
29-may-14,CHIH.,"CHIH., CHIH.",7,0,7,0,0,52,
02-jun-14,SIN.,"CHOIX, SIN.",4,3,7,0,0,0,
02-jun-14,OAX.,"OAX. DE JUAREZ, OAX.",0,7,7,0,0,0,
05-jun-14,MEX.,"TEQUIXQUIAC, MEX.",5,2,7,0,0,0,
06-jun-14,MEX.,"TEJUPILCO, MEX.",6,1,7,5,0,23,
06-jun-14,MEX.,"HUEYPOXTLA, MEX.",7,0,7,0,0,74,
08-jun-14,TAMPS.,"MATAMOROS, TAMPS.",1,6,7,0,0,0,
09-jun-14,TAMPS.,"MATAMOROS, TAMPS.",1,6,7,0,0,0,
09-jun-14,MEX.,"IXTLAHUACA, MEX.",6,1,7,3,0,0,
10-jun-14,SIN.,"CULIACAN, SIN.",6,1,7,0,0,0,
11-jun-14,SIN.,"CULIACAN, SIN.",6,1,7,0,0,0,
11-jun-14,MEX.,"ALMOLOYA DE ALQUISIRAS, MEX.",5,2,7,0,0,0,
12-jun-14,MEX.,"SAN FELIPE DEL PROGRESO, MEX.",6,1,7,0,0,0,
13-jun-14,S.L.P.,"MATEHUALA, S.L.P.",4,3,7,0,0,276,
18-jun-14,N.L.,"LOS ALDAMAS, N.L.",2,5,7,7,0,278,
20-jun-14,HGO.,"TULANCINGO DE BRAVO, HGO.",3,4,7,0,0,0,
20-jun-14,MEX.,"VALLE DE CHALCO SOLIDARIDAD, MEX.",6,1,7,0,0,0,
20-jun-14,MEX.,"IXTAPALUCA, MEX.",4,3,7,0,0,0,
26-jun-14,MEX.,"CHALCO, MEX.",5,2,7,0,0,72,
27-jun-14,SIN.,"SIN., SIN.",3,4,7,0,5,0,
03-jul-14,SIN.,"NAVOLATO, SIN.",3,4,7,0,0,0,
08-jul-14,B.C.,"TIJUANA, B.C.",7,0,7,0,0,0,
14-jul-14,B.C.,"TIJUANA, B.C.",1,6,7,0,0,0,
14-jul-14,CHIH.,"JUÁREZ, CHIH.",4,3,7,0,0,0,
28-jul-14,CHIH.,"JUÁREZ, CHIH.",4,3,7,0,0,0,
31-jul-14,NAY.,"JALA, NAY.",5,2,7,0,0,0,
02-ago-14,CHIH.,"JUÁREZ, CHIH.",4,3,7,0,4,0,
05-ago-14,B.C.,"MEXICALI, B.C.",2,5,7,0,0,0,
14-ago-14,B.C.,"TIJUANA, B.C.",4,3,7,0,0,0,
18-ago-14,N.L.,"MONTERREY, N.L.",4,3,7,63,0,721,
22-ago-14,SIN.,"COSALA, SIN.",3,4,7,0,0,0,
22-ago-14,B.C.,"MEXICALI, B.C.",3,4,7,0,0,0,
26-ago-14,CHIH.,"JUÁREZ, CHIH.",4,3,7,0,0,0,
03-sep-14,MICH.,"LAZARO CARDENAS, MICH.",7,0,7,3,0,79,
04-sep-14,TAMPS.,"VICTORIA, TAMPS.",6,1,7,0,0,38,
23-sep-14,B.C.,"TIJUANA, B.C.",5,2,7,0,0,0,
25-sep-14,AGS.,"AGS., AGS.",5,2,7,8,0,1214,
26-sep-14,MICH.,"LA HUACANA, MICH.",5,2,7,4,0,6,
28-sep-14,B.C.,"MEXICALI, B.C.",2,5,7,0,0,0,
02-oct-14,B.C.,"TIJUANA, B.C.",2,5,7,0,0,0,
06-oct-14,MICH.,"URUAPAN, MICH.",3,4,7,1,0,157,
10-oct-14,N.L.,"MONTERREY, N.L.",6,1,7,131,0,4570,
14-oct-14,SON.,"SAN LUIS RIO COLORADO, SON.",2,5,7,2,0,176,
15-oct-14,TAMPS.,"RIO BRAVO, TAMPS.",3,4,7,0,0,400,
17-oct-14,CHIS.,"OCOZOCOAUTLA DE ESPINOSA, CHIS.",4,3,7,0,0,11,
19-oct-14,B.C.,"TIJUANA, B.C.",4,3,7,0,0,0,
20-oct-14,SON.,"SAN LUIS RIO COLORADO, SON.",4,3,7,2,1,33,
22-oct-14,CHIS.,"COMITAN DE DOMÍNGUEZ, CHIS.",4,3,7,2,0,294,
22-oct-14,CHIS.,"TAPACHULA, CHIS.",6,1,7,10,0,611,
24-oct-14,MICH.,"ZAMORA, MICH.",5,2,7,3,0,4815,
28-oct-14,CHIS.,"PALENQUE, CHIS.",1,6,7,4,0,210,
31-oct-14,CHIS.,"SAN CRISTOBAL DE LAS CASAS, CHIS.",5,2,7,1,0,0,
01-nov-14,SON.,"SAN LUIS RIO COLORADO, SON.",0,7,7,4,0,0,
03-nov-14,CHIS.,"TUXTLA GUTIÉRREZ, CHIS.",4,3,7,8,1,1221,
04-nov-14,CHIS.,"OCOZOCOAUTLA DE ESPINOSA, CHIS.",6,1,7,1,0,629,
05-nov-14,CHIS.,"COMITAN DE DOMÍNGUEZ, CHIS.",4,3,7,0,0,23,
05-nov-14,AGS.,"AGS., AGS.",4,3,7,1,0,0,
05-nov-14,CHIS.,"COMITAN DE DOMÍNGUEZ, CHIS.",4,3,7,0,0,23,
10-nov-14,CHIS.,"TUXTLA GUTIÉRREZ, CHIS.",6,1,7,3,0,1587,
10-nov-14,B.C.,"TIJUANA, B.C.",4,3,7,0,0,0,
20-nov-14,SIN.,"CHOIX, SIN.",4,3,7,0,0,0,
21-nov-14,SIN.,"CHOIX, SIN.",3,4,7,0,0,0,
01-dic-14,N.L.,"MONTERREY, N.L.",7,0,7,5,0,1077,
18-dic-14,N.L.,"MONTERREY, N.L.",3,4,7,89,0,19520,
20-dic-14,N.L.,"MONTERREY, N.L.",4,3,7,113,0,38125,
22-dic-14,DGO.,"DGO., DGO.",5,2,7,1,3,0,
10-ene-15,TAMPS.,"MATAMOROS, TAMPS.",0,7,7,0,0,0,
16-ene-15,TAMPS.,"MATAMOROS, TAMPS.",5,2,7,1,0,0,
18-ene-15,DGO.,"DGO., DGO.",6,1,7,3,0,0,
05-feb-15,B.C.,"MEXICALI, B.C.",3,4,7,0,0,0,
09-feb-15,B.C.,"TIJUANA, B.C.",5,2,7,0,0,0,
12-feb-15,B.C.,"TIJUANA, B.C.",4,3,7,0,0,0,
15-feb-15,B.C.,"MEXICALI, B.C.",7,0,7,0,0,0,
17-feb-15,B.C.,"TIJUANA, B.C.",5,2,7,0,0,0,
13-mar-15,DGO.,"GOMEZ PALACIO, DGO.",7,0,7,0,0,0,
24-mar-15,DGO.,"GOMEZ PALACIO, DGO.",4,3,7,0,0,0,
03-ago-15,MEX.,"NAUCALPAN DE JUAREZ, MEX.",7,0,7,1,1,11,
06-ago-15,MEX.,"TEXCOCO, MEX.",5,2,7,0,11,0,
08-ago-15,TAMPS.,"MATAMOROS, TAMPS.",4,3,7,0,0,10,
11-ago-15,DGO.,"GOMEZ PALACIO, DGO.",5,2,7,0,3,0,
11-ago-15,MEX.,"ZUMPANGO, MEX.",4,3,7,0,0,7,
12-ago-15,OAX.,"OAX. DE JUAREZ, OAX.",0,7,7,0,0,400,
12-ago-15,COAH.,"SALTILLO, COAH.",6,1,7,0,0,117,
12-ago-15,DGO.,"GOMEZ PALACIO, DGO.",4,3,7,0,0,0,
12-ago-15,SIN.,"SALVADOR ALVARADO, SIN.",4,3,7,0,1,0,
12-ago-15,MEX.,"AMECAMECA, MEX.",5,2,7,0,0,0,
13-ago-15,MEX.,"TOLUCA, MEX.",5,2,7,2,0,0,
13-ago-15,CHIH.,"OJINAGA, CHIH.",1,6,7,0,0,237,
14-ago-15,MEX.,"ZUMPANGO, MEX.",7,0,7,0,0,100,
14-ago-15,COAH.,"MONCLOVA, COAH.",6,1,7,0,0,37,
18-ago-15,DGO.,"DGO., DGO.",5,2,7,3,4,0,
18-ago-15,COAH.,"MONCLOVA, COAH.",5,2,7,0,0,164,
18-ago-15,MEX.,"CUAUTITLAN, MEX.",7,0,7,0,1,0,
19-ago-15,COAH.,"TORREÓN, COAH.",4,3,7,2,0,0,
19-ago-15,COAH.,"MONCLOVA, COAH.",5,2,7,0,0,164,
19-ago-15,MEX.,"CUAUTITLAN IZCALLI, MEX.",6,1,7,0,1,0,
20-ago-15,OAX.,"OAX. DE JUAREZ, OAX.",0,7,7,0,0,0,
20-ago-15,MEX.,"CUAUTITLAN, MEX.",7,0,7,0,5,50,
24-ago-15,COAH.,"PIEDRAS NEGRAS, COAH.",3,4,7,2,0,118,
24-ago-15,MEX.,"TULTEPEC, MEX.",7,0,7,3,0,50,
25-ago-15,DGO.,"DGO., DGO.",3,4,7,60,1,0,
25-ago-15,COAH.,"TORREÓN, COAH.",6,1,7,0,0,38,
29-ago-15,TAMPS.,"RIO BRAVO, TAMPS.",4,3,7,0,0,22,
31-ago-15,SIN.,"COSALA, SIN.",3,4,7,0,0,0,
01-sep-15,OAX.,"OAX. DE JUAREZ, OAX.",0,7,7,0,0,0,
03-sep-15,SIN.,"CULIACAN, SIN.",7,0,7,0,0,0,
03-sep-15,COAH.,"MONCLOVA, COAH.",7,0,7,3,0,326,
04-sep-15,SIN.,"CHOIX, SIN.",0,7,7,0,0,0,
08-sep-15,MEX.,"TULTITLAN, MEX.",7,0,7,4,0,138,
08-sep-15,B.C.,"TIJUANA, B.C.",4,3,7,0,0,0,
09-sep-15,COAH.,"TORREÓN, COAH.",7,0,7,0,0,100,
09-sep-15,MEX.,"CHALCO, MEX.",6,1,7,0,1,0,
10-sep-15,COAH.,"TORREÓN, COAH.",4,3,7,0,0,32,
12-sep-15,N.L.,"MONTERREY, N.L.",3,4,7,1,0,0,
15-sep-15,COAH.,"PIEDRAS NEGRAS, COAH.",3,4,7,0,0,52,
18-sep-15,COAH.,"TORREÓN, COAH.",2,5,7,5,0,0,
18-sep-15,B.C.,"MEXICALI, B.C.",4,3,7,0,0,0,
21-sep-15,MEX.,"TLALMANALCO, MEX.",6,1,7,0,4,31,
22-sep-15,COAH.,"PIEDRAS NEGRAS, COAH.",3,4,7,5,0,49,
22-sep-15,QRO.,"QUERETARO, QRO.",4,3,7,0,1,0,
23-sep-15,COAH.,"PIEDRAS NEGRAS, COAH.",6,1,7,0,0,255,
23-sep-15,COAH.,"SALTILLO, COAH.",4,3,7,0,1,398,
25-sep-15,COAH.,"SALTILLO, COAH.",3,4,7,1,1,72,
28-sep-15,B.C.,"TIJUANA, B.C.",5,2,7,0,0,0,
01-oct-15,TAMPS.,"CIUDAD MADERO, TAMPS.",6,1,7,2,1,702,
02-oct-15,COAH.,"TORREÓN, COAH.",7,0,7,0,0,0,
06-oct-15,SIN.,"EL FUERTE, SIN.",5,2,7,0,3,0,
06-oct-15,B.C.,"TIJUANA, B.C.",4,3,7,0,0,0,
07-oct-15,COAH.,"PIEDRAS NEGRAS, COAH.",4,3,7,1,0,49,
08-oct-15,COAH.,"SALTILLO, COAH.",5,2,7,0,3,55,
08-oct-15,B.C.,"TIJUANA, B.C.",7,0,7,0,0,0,
09-oct-15,COAH.,"TORREÓN, COAH.",6,1,7,2,0,103,
09-oct-15,COAH.,"MONCLOVA, COAH.",5,2,7,0,0,84,
09-oct-15,B.C.,"MEXICALI, B.C.",0,7,7,0,0,0,
12-oct-15,COAH.,"SALTILLO, COAH.",5,2,7,0,0,93,
12-oct-15,COAH.,"MONCLOVA, COAH.",4,3,7,0,0,158,
16-oct-15,SIN.,"EL FUERTE, SIN.",6,1,7,0,2,0,
16-oct-15,COAH.,"SALTILLO, COAH.",3,4,7,2,2,260,
19-oct-15,COAH.,"SALTILLO, COAH.",7,0,7,6,1,0,
22-oct-15,D.F.,"ALVARO OBREGON, D.F.",2,5,7,0,5,0,
26-oct-15,COAH.,"SALTILLO, COAH.",7,0,7,0,0,453,
06-nov-15,B.C.,"TIJUANA, B.C.",5,2,7,0,0,0,
12-nov-15,SIN.,"SIN., SIN.",4,3,7,0,3,0,
27-nov-15,GRO.,"IGUALA DE LA INDEPENDENCIA, GRO.",6,1,7,0,0,65,
28-nov-15,MOR.,"CUERNAVACA, MOR.",6,1,7,0,9,1000,
02-dic-15,COAH.,"SALTILLO, COAH.",4,3,7,1,0,138,
02-dic-15,COAH.,"MONCLOVA, COAH.",4,3,7,1,0,267,
04-dic-15,SON.,"HUATABAMPO, SON.",5,2,7,1,0,0,
05-dic-15,DGO.,"DGO., DGO.",5,2,7,22,1,0,
09-dic-15,SON.,"HERMOSILLO, SON.",3,4,7,0,0,0,
09-dic-15,CHIH.,"HGO. DEL PARRAL, CHIH.",4,3,7,1,0,154,
10-ene-16,TAMPS.,"MATAMOROS, TAMPS.",5,2,7,0,0,0,
29-ene-16,B.C.,"MEXICALI, B.C.",2,5,7,0,0,0,
04-feb-16,COAH.,"SALTILLO, COAH.",6,1,7,0,0,112,
07-feb-16,TAMPS.,"MATAMOROS, TAMPS.",7,0,7,1,0,30,
08-feb-16,OAX.,"OAX. DE JUAREZ, OAX.",1,6,7,0,0,0,
08-feb-16,COAH.,"SALTILLO, COAH.",5,2,7,23,0,0,
11-feb-16,COAH.,"TORREÓN, COAH.",6,1,7,50,0,82,
19-mar-16,GTO.,"SALAMANCA, GTO.",5,2,7,0,0,0,
28-mar-16,TAMPS.,"MATAMOROS, TAMPS.",7,0,7,0,0,0,
29-mar-16,GTO.,"SALAMANCA, GTO.",6,1,7,0,3,0,
30-mar-16,COAH.,"SALTILLO, COAH.",5,2,7,0,0,0,
31-mar-16,COAH.,"TORREÓN, COAH.",6,1,7,0,0,0,
07-abr-16,S.L.P.,"SAN LUIS POTOSI, S.L.P.",1,6,7,0,0,0,
11-abr-16,COAH.,"PIEDRAS NEGRAS, COAH.",3,4,7,1,0,117,
13-abr-16,D.F.,"IZTAPALAPA, D.F.",5,2,7,302,0,848,
13-abr-16,S.L.P.,"CIUDAD VALLES, S.L.P.",7,0,7,0,0,0,
04-may-16,COAH.,"TORREÓN, COAH.",7,0,7,0,0,0,
24-may-16,COAH.,"SALTILLO, COAH.",4,3,7,1,1,320,
04-jun-16,COAH.,"TORREÓN, COAH.",7,0,7,0,0,0,
07-jun-16,ZAC.,"ZAC., ZAC.",5,2,7,1,0,62,
08-jul-16,ZAC.,"GUADALUPE, ZAC.",6,1,7,0,0,0,
02-ago-16,S.L.P.,"SAN LUIS POTOSI, S.L.P.",7,0,7,2,0,134,
04-ago-16,S.L.P.,"SAN LUIS POTOSI, S.L.P.",7,0,7,0,0,382,
09-ago-16,S.L.P.,"SAN LUIS POTOSI, S.L.P.",5,2,7,0,0,37,
10-ago-16,MEX.,"METEPEC, MEX.",6,1,7,0,0,0,
16-ago-16,MEX.,"TLALNEPANTLA DE BAZ, MEX.",7,0,7,3,0,29,
18-ago-16,MEX.,"AMECAMECA, MEX.",6,1,7,1,0,5,
24-ago-16,MEX.,"CUAUTITLAN IZCALLI, MEX.",5,2,7,3,1,189,
24-ago-16,MEX.,"CHIMALHUACAN, MEX.",3,4,7,0,0,137,
27-ago-16,MEX.,"CUAUTITLAN, MEX.",7,0,7,0,1,202,
29-ago-16,MEX.,"SAN MATEO ATENCO, MEX.",6,1,7,1,0,0,
30-ago-16,SIN.,"MOCORITO, SIN.",4,3,7,0,0,0,
31-ago-16,SIN.,"MOCORITO, SIN.",4,3,7,0,4,0,
04-sep-16,B.C.,"ENSENADA, B.C.",1,6,7,0,0,0,
04-sep-16,MEX.,"TULTEPEC, MEX.",6,1,7,5,0,4,
07-sep-16,MEX.,"COACALCO DE BERRIOZABAL, MEX.",3,4,7,1,0,16,
09-sep-16,MEX.,"VILLA VICTORIA, MEX.",5,2,7,0,0,0,
10-sep-16,MEX.,"VILLA VICTORIA, MEX.",6,1,7,2,0,3,
11-sep-16,MEX.,"COACALCO DE BERRIOZABAL, MEX.",4,3,7,1,0,270,
22-sep-16,MEX.,"CHALCO, MEX.",3,4,7,0,2,0,
26-sep-16,CHIS.,"VILLAFLORES, CHIS.",4,3,7,0,0,0,
01-oct-16,B.C.,"MEXICALI, B.C.",4,3,7,0,0,0,
02-oct-16,B.C.,"MEXICALI, B.C.",4,3,7,0,0,0,
07-oct-16,SIN.,"CHOIX, SIN.",7,0,7,0,0,0,
10-oct-16,MEX.,"IXTAPALUCA, MEX.",7,0,7,1,0,5,
13-oct-16,MEX.,"IXTAPALUCA, MEX.",5,2,7,6,1,123,
13-oct-16,SIN.,"SALVADOR ALVARADO, SIN.",4,3,7,0,3,0,
07-nov-16,GRO.,"CHILPANCINGO DE LOS BRAVO, GRO.",6,1,7,0,0,0,
29-nov-16,B.C.,"TIJUANA, B.C.",2,5,7,0,0,0,
02-dic-16,S.L.P.,"SAN LUIS POTOSI, S.L.P.",7,0,7,2,0,50,
05-dic-16,S.L.P.,"SAN LUIS POTOSI, S.L.P.",4,3,7,0,1,0,
07-dic-16,S.L.P.,"SAN LUIS POTOSI, S.L.P.",6,1,7,6,1,649,
10-dic-16,GTO.,"IRAPUATO, GTO.",7,0,7,0,0,0,
11-dic-16,GTO.,"IRAPUATO, GTO.",0,7,7,0,0,0,
21-dic-16,GTO.,"LEON, GTO.",5,2,7,0,0,0,
23-dic-16,D.F.,"CUAUHTEMOC, D.F.",7,0,7,0,0,397,
10-ene-17,B.C.,"TIJUANA, B.C.",1,6,7,0,0,0,
26-ene-17,D.F.,"COYOACAN, D.F.",6,1,7,0,0,18,
29-ene-17,TAMPS.,"MATAMOROS, TAMPS.",3,4,7,0,0,294,
10-mar-17,MEX.,"TOLUCA, MEX.",4,3,7,1,1,44,
11-mar-17,MEX.,"TLALNEPANTLA DE BAZ, MEX.",3,4,7,1,0,0,
14-mar-17,MEX.,"ECATEPEC DE MOR., MEX.",5,2,7,0,1,64,
16-mar-17,QRO.,"QUERETARO, QRO.",3,4,7,0,0,0,
21-mar-17,MEX.,"NAUCALPAN DE JUAREZ, MEX.",3,4,7,0,0,79,
23-mar-17,ZAC.,"SOMBRERETE, ZAC.",1,6,7,0,0,0,
24-mar-17,QRO.,"QUERETARO, QRO.",1,6,7,0,0,0,
31-mar-17,N.L.,"MONTERREY, N.L.",7,0,7,83,0,0,
24-abr-17,S.L.P.,"SAN LUIS POTOSI, S.L.P.",6,1,7,3,3,91,
28-abr-17,SIN.,"MAZATLAN, SIN.",5,2,7,0,0,0,
05-may-17,SIN.,"BADIRAGUATO, SIN.",2,5,7,0,4,0,
22-may-17,SIN.,"SIN., SIN.",7,0,7,0,5,0,
25-may-17,SIN.,"SIN., SIN.",4,3,7,0,0,0,
31-may-17,TAMPS.,"NUEVO LAREDO, TAMPS.",5,2,7,6,0,297,
01-jun-17,SIN.,"CONCORDIA, SIN.",4,3,7,0,0,0,
06-jun-17,CHIS.,"SAN CRISTOBAL DE LAS CASAS, CHIS.",3,4,7,4,0,0,
09-jun-17,CHIS.,"VILLAFLORES, CHIS.",3,4,7,0,0,710,
12-jun-17,D.F.,"GUSTAVO A. MADERO, D.F.",7,0,7,0,5,89,
12-jun-17,COAH.,"SALTILLO, COAH.",4,3,7,0,0,0,
13-jun-17,MEX.,"CUAUTITLAN IZCALLI, MEX.",7,0,7,2,1,1,
05-jul-17,B.C.,"TIJUANA, B.C.",0,7,7,0,0,0,
02-ago-17,B.C.,"TIJUANA, B.C.",0,7,7,0,0,0,
08-ago-17,SIN.,"EL FUERTE, SIN.",3,4,7,0,1,0,
11-ago-17,CHIS.,"TUXTLA GUTIÉRREZ, CHIS.",3,4,7,0,0,55,
13-ago-17,MEX.,"ATIZAPAN, MEX.",7,0,7,1,0,86,
13-ago-17,MEX.,"TONANITLA, MEX.",5,2,7,0,0,0,
15-ago-17,MEX.,"TEXCOCO, MEX.",6,1,7,0,0,214,
17-ago-17,MEX.,"CHIMALHUACAN, MEX.",6,1,7,0,0,39,
18-ago-17,MEX.,"TEXCOCO, MEX.",6,1,7,0,0,0,
24-ago-17,N.L.,"MONTERREY, N.L.",2,5,7,0,1,33,
24-ago-17,MEX.,"IXTAPALUCA, MEX.",6,1,7,0,0,0,
03-sep-17,MEX.,"CHICOLOAPAN, MEX.",5,2,7,0,0,72,
05-sep-17,GTO.,"GTO., GTO.",7,0,7,0,0,99,
03-oct-17,SIN.,"AHOME, SIN.",6,1,7,0,2,0,
23-oct-17,ZAC.,"GUADALUPE, ZAC.",6,1,7,5,0,121,
25-oct-17,ZAC.,"FRESNILLO, ZAC.",4,3,7,0,0,0,
29-nov-17,GTO.,"CELAYA, GTO.",3,4,7,0,0,0,
01-dic-17,GTO.,"CELAYA, GTO.",0,7,7,0,0,0,
20-dic-17,D.F.,"CUAUHTEMOC, D.F.",3,4,7,0,3,162,
22-ene-18,COAH.,"SALTILLO, COAH.",5,2,7,1,0,0,
31-ene-18,DGO.,"GOMEZ PALACIO, DGO.",5,2,7,0,0,0,
31-ene-18,ZAC.,"GUADALUPE, ZAC.",7,0,7,3,0,0,
31-ene-18,ZAC.,"ZAC., ZAC.",6,1,7,2,0,38,
14-feb-18,COAH.,"SALTILLO, COAH.",4,3,7,0,0,0,
16-feb-18,COAH.,"SALTILLO, COAH.",5,2,7,0,0,165,
17-feb-18,GRO.,"ACAPULCO DE JUAREZ, GRO.",6,1,7,0,5,119,
21-feb-18,COAH.,"SALTILLO, COAH.",4,3,7,4,0,0,
19-jul-18,CHIH.,"HGO. DEL PARRAL, CHIH.",3,4,7,0,0,241,
23-jul-18,GTO.,"CELAYA, GTO.",3,4,7,0,0,118,
24-jul-18,ZAC.,"GUADALUPE, ZAC.",4,3,7,0,0,0,
26-jul-18,ZAC.,"GUADALUPE, ZAC.",3,4,7,6,0,235,
16-ago-18,CHIS.,"CHICOASÉN, CHIS.",5,2,7,0,0,36,
20-ago-18,MEX.,"TLALNEPANTLA DE BAZ, MEX.",5,2,7,2,0,255,
21-ago-18,MEX.,"CHIMALHUACAN, MEX.",7,0,7,2,0,0,
23-ago-18,MEX.,"CHIMALHUACAN, MEX.",4,3,7,3,0,58,
24-ago-18,MEX.,"TLALNEPANTLA DE BAZ, MEX.",7,0,7,0,0,473,
24-ago-18,CHIH.,"HGO. DEL PARRAL, CHIH.",4,3,7,7,0,1850,
28-ago-18,MEX.,"CHIMALHUACAN, MEX.",5,2,7,2,0,81,
30-ago-18,MEX.,"CHIMALHUACAN, MEX.",5,2,7,2,0,81,
31-ago-18,SIN.,"CHOIX, SIN.",3,4,7,0,0,0,
03-sep-18,MEX.,"NEZAHUALCOYOTL, MEX.",4,3,7,3,0,79,
06-sep-18,MEX.,"TOLUCA, MEX.",6,1,7,6,0,1067,
07-sep-18,ZAC.,"FRESNILLO, ZAC.",6,1,7,7,0,0,
08-sep-18,MEX.,"NEZAHUALCOYOTL, MEX.",5,2,7,1,5,783,
10-sep-18,D.F.,"XOCHIMILCO, D.F.",6,1,7,0,0,114,
18-sep-18,MEX.,"NEZAHUALCOYOTL, MEX.",5,2,7,0,2,82,
23-sep-18,S.L.P.,"SAN LUIS POTOSI, S.L.P.",7,0,7,1,0,0,
08-oct-18,GTO.,"LEON, GTO.",5,2,7,0,6,0,
12-oct-18,D.F.,"MIGUEL HGO., D.F.",5,2,7,0,0,676,
13-oct-18,N.L.,"MELCHOR OCAMPO, N.L.",7,0,7,0,0,0,
15-oct-18,D.F.,"VENUSTIANO CARRANZA, D.F.",7,0,7,0,0,402,
25-oct-18,MEX.,"ALMOLOYA DE JUAREZ, MEX.",4,3,7,0,0,27,
16-nov-18,D.F.,"CUAJIMALPA DE MOR., D.F.",5,2,7,0,1,1900,
05-dic-18,SIN.,"ANGOSTURA, SIN.",1,6,7,0,0,0,
11-dic-18,SIN.,"CULIACAN, SIN.",0,7,7,0,0,0,
18-dic-18,SIN.,"GUASAVE, SIN.",5,2,7,0,0,0,
27-feb-19,ZAC.,"FRESNILLO, ZAC.",5,2,7,17,0,1333,
06-mar-19,CD. MÉX.,"BENITO JUAREZ, CD. MÉX.",6,1,7,0,0,196,
07-mar-19,ZAC.,"FRESNILLO, ZAC.",6,1,7,0,0,2640,
25-mar-19,CD. MÉX.,"COYOACAN, CD. MÉX.",6,1,7,0,0,242,
10-abr-19,CD. MÉX.,"XOCHIMILCO, CD. MÉX.",4,3,7,0,0,255,
12-abr-19,CD. MÉX.,"IZTAPALAPA, CD. MÉX.",7,0,7,0,26,85,
26-abr-19,CD. MÉX.,"ALVARO OBREGON, CD. MÉX.",5,2,7,0,3,217,
30-abr-19,CD. MÉX.,"VENUSTIANO CARRANZA, CD. MÉX.",6,1,7,0,0,811,
02-may-19,CD. MÉX.,"VENUSTIANO CARRANZA, CD. MÉX.",7,0,7,0,3,1366,
03-may-19,CHIH.,"JUÁREZ, CHIH.",5,2,7,11,0,298,
03-may-19,CD. MÉX.,"IZTAPALAPA, CD. MÉX.",7,0,7,0,0,591,
13-may-19,CD. MÉX.,"TLALPAN, CD. MÉX.",5,2,7,0,0,512,
14-may-19,CHIH.,"JUÁREZ, CHIH.",4,3,7,6,0,982,
15-may-19,CD. MÉX.,"IZTAPALAPA, CD. MÉX.",7,0,7,0,0,48,
12-jun-19,CD. MÉX.,"AZCAPOTZALCO, CD. MÉX.",6,1,7,0,0,792,
19-jun-19,CD. MÉX.,"IZTAPALAPA, CD. MÉX.",6,1,7,0,1,84,
25-jun-19,CD. MÉX.,"IZTACALCO, CD. MÉX.",5,2,7,0,12,1910,
27-jun-19,CD. MÉX.,"IZTAPALAPA, CD. MÉX.",6,1,7,0,0,4,
03-jul-19,COAH.,"MATAMOROS, COAH.",7,0,7,1,0,0,
09-jul-19,CD. MÉX.,"XOCHIMILCO, CD. MÉX.",6,1,7,0,0,29,
24-jul-19,CHIH.,"DELICIAS, CHIH.",6,1,7,5,0,109,
30-jul-19,CD. MÉX.,"CUAUHTEMOC, CD. MÉX.",6,1,7,0,0,1048,
31-jul-19,NAY.,"TECUALA, NAY.",3,4,7,0,0,0,
08-ago-19,MÉX.,"ATIZAPAN, MEX.",6,1,7,2,0,54,
16-ago-19,CD. MÉX.,"GUSTAVO A. MADERO, CD. MÉX.",7,0,7,0,0,145,
21-ago-19,CD. MÉX.,"IZTAPALAPA, CD. MÉX.",7,0,7,0,0,767,
21-ago-19,GTO.,"IRAPUATO, GTO.",5,2,7,0,0,0,
23-ago-19,CD. MÉX.,"IZTAPALAPA, CD. MÉX.",5,2,7,0,0,258,
23-ago-19,CD. MÉX.,"GUSTAVO A. MADERO, CD. MÉX.",4,3,7,0,0,8538,
24-ago-19,MÉX.,"TLALNEPANTLA DE BAZ, MEX.",7,0,7,1,0,118,
26-ago-19,TAMPS.,"TAMPICO, TAMPS.",5,2,7,0,0,117,
28-ago-19,GTO.,"IRAPUATO, GTO.",7,0,7,0,1,0,
02-sep-19,CD. MÉX.,"IZTAPALAPA, CD. MÉX.",7,0,7,0,0,214,
04-sep-19,MÉX.,"NEZAHUALCOYOTL, MEX.",7,0,7,0,0,903,
10-sep-19,CD. MÉX.,"MIGUEL HGO., CD. MÉX.",5,2,7,0,0,68,
11-sep-19,CD. MÉX.,"IZTAPALAPA, CD. MÉX.",5,2,7,0,0,91,
24-sep-19,MÉX.,"CHIMALHUACAN, MEX.",6,1,7,2,0,26,
27-sep-19,TAMPS.,"TAMPICO, TAMPS.",6,1,7,0,1,0,
28-sep-19,MÉX.,"CHIMALHUACAN, MEX.",6,1,7,0,0,104,
30-sep-19,MÉX.,"CHIMALHUACAN, MEX.",7,0,7,5,0,84,
01-oct-19,MÉX.,"CHIMALHUACAN, MEX.",6,1,7,5,0,169,
08-oct-19,MÉX.,"CHIMALHUACAN, MEX.",4,3,7,1,0,616,
12-oct-19,MÉX.,"HUIXQUILUCAN, MEX.",6,1,7,0,0,98,
21-oct-19,CD. MÉX.,"IZTAPALAPA, CD. MÉX.",3,4,7,0,0,111,
23-oct-19,CD. MÉX.,"IZTAPALAPA, CD. MÉX.",5,2,7,0,0,125,
05-nov-19,MÉX.,"LA PAZ, MEX.",7,0,7,0,0,875,
12-nov-19,CD. MÉX.,"IZTAPALAPA, CD. MÉX.",4,3,7,0,0,30,
13-nov-19,CD. MÉX.,"BENITO JUAREZ, CD. MÉX.",4,3,7,0,0,962,
13-nov-19,CD. MÉX.,"IZTAPALAPA, CD. MÉX.",4,3,7,0,0,48,
13-nov-19,CHIS.,"TUXTLA GUTIÉRREZ, CHIS.",1,6,7,0,0,0,
26-nov-19,CD. MÉX.,"IZTAPALAPA, CD. MÉX.",2,5,7,0,0,0,
03-dic-19,GTO.,"LEON, GTO.",2,5,7,0,4,0,
17-dic-19,CD. MÉX.,"IZTACALCO, CD. MÉX.",1,6,7,0,0,1113,
04-feb-20,CD. MÉX.,"IZTAPALAPA, CD. MÉX.",6,1,7,0,0,919,
11-feb-20,CD. MÉX.,"GUSTAVO A. MADERO, CD. MÉX.",7,0,7,0,0,290,
17-feb-20,SIN.,"GUASAVE, SIN.",2,5,7,0,0,0,
20-feb-20,CD. MÉX.,"TLALPAN, CD. MÉX.",7,0,7,0,0,6,
27-feb-20,NAY.,"TEPIC, NAY.",4,3,7,7,0,58,
29-feb-20,NAY.,"TEPIC, NAY.",3,4,7,2,234,315,
03-mar-20,CD. MÉX.,"BENITO JUAREZ, CD. MÉX.",5,2,7,0,0,91,
04-mar-20,CD. MÉX.,"BENITO JUAREZ, CD. MÉX.",5,2,7,0,0,172,
06-mar-20,VER.,"XALAPA, VER.",7,0,7,4,0,50,
11-mar-20,VER.,"XALAPA, VER.",5,2,7,55,0,37,
14-ago-20,CD. MÉX.,"CUAUHTEMOC, CD. MÉX.",5,2,7,0,0,100,
29-oct-20,CD. MÉX.,"GUSTAVO A. MADERO, CD. MÉX.",7,0,7,0,0,78,
02-dic-21,CHIH.,"CHIH., CHIH.",7,0,7,0,0,0,
03-dic-21,CHIH.,"CHIH., CHIH.",5,2,7,0,0,174,
06-dic-21,CHIH.,"JUÁREZ, CHIH.",5,2,7,0,0,649,
08-dic-21,CHIH.,"JUÁREZ, CHIH.",7,0,7,9,0,908,
09-dic-21,CHIH.,"JUÁREZ, CHIH.",7,0,7,1,0,1977,
15-dic-21,CHIH.,"JUÁREZ, CHIH.",6,1,7,0,1,775,
17-dic-21,CHIH.,"JUÁREZ, CHIH.",6,1,7,9,1,1131,
22-dic-21,CHIH.,"JUÁREZ, CHIH.",5,2,7,1,0,1150,
25-ene-22,CD. MÉX.,"CUAUHTEMOC, CD. MÉX.",4,3,7,0,0,557,
28-ene-22,CD. MÉX.,"IZTAPALAPA, CD. MÉX.",6,1,7,0,0,101,
11-feb-22,CD. MÉX.,"IZTACALCO, CD. MÉX.",6,1,7,0,0,522,
25-abr-22,CD. MÉX.,"CUAUHTEMOC, CD. MÉX.",4,3,7,0,0,35,
31-may-22,CD. MÉX.,"GUSTAVO A. MADERO, CD. MÉX.",7,0,7,0,0,35,
06-jun-22,SIN.,"GUASAVE, SIN.",6,1,7,0,0,15,
24-jun-22,N.L.,"MONTERREY, N.L.",5,2,7,12,0,776,
09-jul-22,JAL.,"TAMAZULA DE GORDIANO, JAL.",4,3,7,0,0,0,
12-jul-22,CHIH.,"JUÁREZ, CHIH.",6,1,7,4,0,284,
12-jul-22,VER.,"VER., VER.",5,2,7,8,0,3726,
25-jul-22,CD. MÉX.,"BENITO JUAREZ, CD. MÉX.",7,0,7,0,0,347,
18-ago-22,COAH.,"TORREÓN, COAH.",2,5,7,0,0,249,
22-ago-22,COAH.,"SALTILLO, COAH.",6,1,7,2,0,214,
27-ago-22,MÉX.,"ATIZAPAN, MEX.",2,5,7,0,0,152,
01-sep-22,ZAC.,"ZAC., ZAC.",2,5,7,13,0,0,
01-sep-22,MÉX.,"ATIZAPAN, MEX.",3,4,7,1,0,0,
03-sep-22,MÉX.,"ATIZAPAN, MEX.",5,2,7,0,0,585,
04-sep-22,ZAC.,"ZAC., ZAC.",4,3,7,13,0,230,
13-sep-22,MÉX.,"ECATEPEC DE MOR., MEX.",6,1,7,1,0,367,
19-sep-22,MÉX.,"TLALNEPANTLA DE BAZ, MEX.",6,1,7,0,1,93,
21-sep-22,MÉX.,"TECAMAC, MEX.",4,3,7,0,0,122,
14-oct-22,DGO.,"DGO., DGO.",6,1,7,9,0,39,
17-oct-22,MÉX.,"LA PAZ, MEX.",7,0,7,0,1,15,
21-oct-22,MOR.,"PUENTE DE IXTLA, MOR.",4,3,7,0,0,0,
26-oct-22,MOR.,"CUAUTLA, MOR.",1,6,7,14,0,10,
29-oct-22,GRO.,"IGUALA DE LA INDEPENDENCIA, GRO.",5,2,7,5,0,204,
29-nov-22,SIN.,"CULIACAN, SIN.",6,1,7,0,0,192,
09-dic-22,CHIH.,"NUEVO CASAS GRANDES, CHIH.",4,3,7,3,0,201,
17-dic-22,MICH.,"ZAMORA, MICH.",3,4,7,3,1,433,
10-mar-23,México,"ATIZAPAN, MEX.",7,0,7,0,0,29,
23-mar-23,México,"NAUCALPAN DE JUAREZ, MEX.",0,7,7,0,1,0,
28-mar-23,Coahuila,"PIEDRAS NEGRAS, COAH.",3,4,7,0,0,550,
11-abr-23,Cd. de México,"CUAUHTEMOC, CD. MÉX.",6,1,7,0,0,199,
21-abr-23,Querétaro,"CORREGIDORA, QRO.",6,1,7,0,0,0,
06-may-23,Cd. de México,"CUAUHTEMOC, CD. MÉX.",3,4,7,0,0,"1,643",
06-may-23,Querétaro,"CORREGIDORA, QRO.",1,6,7,0,0,4,
15-may-23,Sinaloa,"NAVOLATO, SIN.",5,2,7,0,0,223,
17-may-23,Michoacán,"TARIMBARO, MICH.",2,5,7,7,0,12,
30-may-23,Sinaloa,"SINALOA, SIN.",3,4,7,0,0,0,
26-jun-23,México,"VALLE DE CHALCO SOLIDARIDAD, MEX.",6,1,7,0,0,18,
28-jun-23,México,"VALLE DE CHALCO SOLIDARIDAD, MEX.",7,0,7,0,0,40,
29-jun-23,México,"VALLE DE CHALCO SOLIDARIDAD, MEX.",6,1,7,0,7,0,
06-jul-23,Sinaloa,"AHOME, SIN.",4,3,7,0,0,204,
06-jul-23,Guerrero,"TECPAN DE GALEANA, GRO.",3,4,7,0,0,0,
15-jul-23,México,"CHIMALHUACAN, MEX.",7,0,7,0,0,5,
18-jul-23,México,"JOCOTITLAN, MEX.",0,7,7,0,0,26,
03-ago-23,México,"CUAUTITLAN, MEX.",7,0,7,2,34,0,
09-ago-23,Chiapas,"CHENALHÓ, CHIS.",2,5,7,0,0,0,
15-ago-23,Sinaloa,"SALVADOR ALVARADO, SIN.",5,2,7,0,0,16,
30-ago-23,Querétaro,"QUERETARO, QRO.",3,4,7,14,0,48,
06-oct-23,Sinaloa,"ROSARIO, SIN.",4,3,7,0,0,0,
11-oct-23,Chihuahua,"CUAUHTÉMOC, CHIH.",7,0,7,0,0,0,
13-oct-23,Sinaloa,"ROSARIO, SIN.",5,2,7,0,0,0,
13-oct-23,Chihuahua,"CUAUHTÉMOC, CHIH.",7,0,7,5,0,326,
13-oct-23,Sinaloa,"MAZATLAN, SIN.",6,1,7,0,1,0,
24-oct-23,Coahuila,"FRONTERA, COAH.",3,4,7,3,0,245,
15-nov-23,Cd. de México,"BENITO JUAREZ, CD. MÉX.",3,4,7,0,0,117,
18-nov-23,Nvo. León,"MONTERREY, N.L.",6,1,7,198,0,320,
27-nov-23,Guanajuato,"LEON, GTO.",6,1,7,0,0,0,
28-nov-23,Sinaloa,"CULIACAN, SIN.",4,3,7,0,0,216,
01-dic-23,Tamaulipas,"TAMPICO, TAMPS.",3,4,7,0,0,353,
05-mar-24,Cd. de México,"CUAUHTEMOC, CD. MÉX.",5,2,7,0,0,"1,789",
25-jun-24,Sinaloa,"CULIACAN, SIN.",6,1,7,0,0,0,
19-jun-24,Baja California,"TIJUANA, B.C.",3,4,7,20,0,210,
28-jun-24,Sinaloa,"CULIACAN, SIN.",6,1,7,0,1,"1,385",
31-ene-13,B.C.,"ENSENADA, B.C.",2,4,6,0,0,0,
03-feb-13,CAMP.,"CAMP., CAMP.",4,2,6,0,0,0,
05-feb-13,CHIH.,"CHIH., CHIH.",4,2,6,0,1,24,
08-feb-13,TAMPS.,"VICTORIA, TAMPS.",5,1,6,0,8,0,
12-feb-13,CHIH.,"NUEVO CASAS GRANDES, CHIH.",6,0,6,0,0,0,
13-feb-13,CHIH.,"NUEVO CASAS GRANDES, CHIH.",6,0,6,0,0,0,
15-feb-13,CHIH.,"NUEVO CASAS GRANDES, CHIH.",3,3,6,0,0,11,
16-feb-13,TAMPS.,"REYNOSA, TAMPS.",4,2,6,0,0,0,
16-feb-13,TAMPS.,"CIUDAD MADERO, TAMPS.",6,0,6,10,0,0,
22-feb-13,TAMPS.,"MATAMOROS, TAMPS.",1,5,6,0,0,0,
23-feb-13,GRO.,"BENITO JUAREZ, GRO.",4,2,6,1,5,89,
26-feb-13,HGO.,"PACHUCA DE SOTO, HGO.",5,1,6,0,0,293,
27-feb-13,TAMPS.,"MATAMOROS, TAMPS.",4,2,6,0,1,0,
27-feb-13,TAMPS.,"MATAMOROS, TAMPS.",4,2,6,0,0,0,
01-mar-13,N.L.,"SANTA CATARINA, N.L.",2,4,6,0,0,2238,
01-mar-13,N.L.,"SAN PEDRO GARZA GARCIA, N.L.",3,3,6,0,1,6002,
02-mar-13,HGO.,"TULANCINGO DE BRAVO, HGO.",2,4,6,0,0,0,
02-mar-13,N.L.,"GRAL. ESCOBEDO, N.L.",6,0,6,5,1,706,
04-mar-13,N.L.,"GARCIA, N.L.",3,3,6,0,0,327,
04-mar-13,HGO.,"TULA DE ALLENDE, HGO.",5,1,6,0,0,0,
05-mar-13,N.L.,"GUADALUPE, N.L.",5,1,6,0,0,1988,
06-mar-13,N.L.,"GUADALUPE, N.L.",5,1,6,0,0,1968,
06-mar-13,N.L.,"SANTA CATARINA, N.L.",2,4,6,5,0,9903,
06-mar-13,N.L.,"SAN PEDRO GARZA GARCIA, N.L.",2,4,6,0,0,500,
07-mar-13,HGO.,"PACHUCA DE SOTO, HGO.",3,3,6,0,2,244,
08-mar-13,HGO.,"TULANCINGO DE BRAVO, HGO.",4,2,6,0,0,938,
08-mar-13,N.L.,"SAN NICOLAS DE LOS GARZA, N.L.",3,3,6,0,0,120,
10-mar-13,N.L.,"SAN NICOLAS DE LOS GARZA, N.L.",6,0,6,1,0,2857,
14-mar-13,HGO.,"TIZAYUCA, HGO.",2,4,6,0,3,0,
19-mar-13,AGS.,"AGS., AGS.",4,2,6,2,0,92,
19-mar-13,MEX.,"TULTEPEC, MEX.",4,2,6,0,2,35,
20-mar-13,AGS.,"AGS., AGS.",6,0,6,3,0,294,
20-mar-13,CHIH.,"ASCENSIÓN, CHIH.",0,6,6,1,0,206,
21-mar-13,AGS.,"AGS., AGS.",4,2,6,6,0,277,
23-mar-13,N.L.,"VILLALDAMA, N.L.",3,3,6,0,0,80,
23-mar-13,TAMPS.,"CIUDAD MADERO, TAMPS.",6,0,6,0,0,623,
26-mar-13,AGS.,"AGS., AGS.",5,1,6,0,0,158,
27-mar-13,HGO.,"TIZAYUCA, HGO.",4,2,6,0,2,554,
29-mar-13,N.L.,"SANTIAGO, N.L.",3,3,6,0,0,2771,
29-mar-13,CHIH.,"ASCENSIÓN, CHIH.",3,3,6,0,0,0,
01-abr-13,MEX.,"VALLE DE BRAVO, MEX.",3,3,6,2,0,19,
01-abr-13,SIN.,"AHOME, SIN.",4,2,6,0,0,0,
02-abr-13,N.L.,"MELCHOR OCAMPO, N.L.",0,6,6,0,0,50,
05-abr-13,MEX.,"IXTLAHUACA, MEX.",6,0,6,4,0,15,
05-abr-13,MEX.,"ZINACANTEPEC, MEX.",6,0,6,0,0,23,
05-abr-13,MEX.,"VALLE DE BRAVO, MEX.",3,3,6,0,5,1,
07-abr-13,MEX.,"VALLE DE BRAVO, MEX.",3,3,6,0,0,0,
08-abr-13,OAX.,"SANTA MARIA ATZOMPA, OAX.",4,2,6,0,0,29,
11-abr-13,MEX.,"IXTAPAN DE LA SAL, MEX.",5,1,6,0,0,2,
11-abr-13,MEX.,"MALINALCO, MEX.",5,1,6,1,0,2,
11-abr-13,MICH.,"SALVADOR ESCALANTE, MICH.",5,1,6,0,0,0,
12-abr-13,MEX.,"TEOTIHUACAN, MEX.",5,1,6,1,0,154,
12-abr-13,NAY.,"TEPIC, NAY.",5,1,6,1,0,0,
13-abr-13,CHIS.,"OCOSINGO, CHIS.",3,3,6,0,0,0,
13-abr-13,N.L.,"MINA, N.L.",3,3,6,1,0,650,
13-abr-13,MICH.,"ZAMORA, MICH.",5,1,6,0,0,0,
15-abr-13,MEX.,"ATIZAPAN, MEX.",1,5,6,0,0,159,
15-abr-13,MEX.,"TENANGO DEL VALLE, MEX.",5,1,6,0,0,0,
16-abr-13,OAX.,"SAN JUAN BAUTISTA TLACOATZINTEPEC, OAX.",4,2,6,0,0,0,
17-abr-13,MEX.,"ATIZAPAN, MEX.",2,4,6,0,1,0,
18-abr-13,B.C.,"TIJUANA, B.C.",3,3,6,0,0,0,
18-abr-13,SIN.,"GUASAVE, SIN.",3,3,6,0,5,0,
18-abr-13,QRO.,"COLON, QRO.",6,0,6,0,0,0,
19-abr-13,MEX.,"ATIZAPAN, MEX.",6,0,6,2,0,196,
19-abr-13,TAMPS.,"MATAMOROS, TAMPS.",2,4,6,0,0,0,
24-abr-13,HGO.,"HUEHUETLA, HGO.",6,0,6,0,0,0,
24-abr-13,MICH.,"LA PIEDAD, MICH.",4,2,6,0,0,0,
26-abr-13,MICH.,"APATZINGAN, MICH.",5,1,6,0,1,0,
27-abr-13,OAX.,"SAN ANTONIO DE LA CAL, OAX.",5,1,6,0,0,0,
29-abr-13,OAX.,"SAN ANTONIO DE LA CAL, OAX.",5,1,6,7,0,0,
30-abr-13,MICH.,"JIQUILPAN, MICH.",6,0,6,0,1,0,
01-may-13,N.L.,"LINARES, N.L.",6,0,6,4,0,100,
03-may-13,MICH.,"ZACAPU, MICH.",5,1,6,0,0,0,
08-may-13,MICH.,"JIQUILPAN, MICH.",5,1,6,0,0,0,
13-may-13,MICH.,"APATZINGAN, MICH.",3,3,6,0,0,0,
15-may-13,B.C.,"MEXICALI, B.C.",3,3,6,0,0,0,
17-may-13,MICH.,"HUETAMO, MICH.",4,2,6,0,0,0,
17-may-13,B.C.,"MEXICALI, B.C.",2,4,6,0,0,0,
18-may-13,MICH.,"HUETAMO, MICH.",5,1,6,0,0,0,
20-may-13,B.C.,"TIJUANA, B.C.",5,1,6,0,0,0,
25-may-13,B.C.,"TIJUANA, B.C.",3,3,6,0,0,0,
27-may-13,MICH.,"URUAPAN, MICH.",5,1,6,0,0,0,
29-may-13,B.C.,"TIJUANA, B.C.",3,3,6,0,0,0,
30-may-13,N.L.,"LAMPAZOS DE NARANJO, N.L.",1,5,6,0,0,170,
01-jun-13,MICH.,"ZITACUARO, MICH.",1,5,6,1,0,0,
04-jun-13,B.C.,"TIJUANA, B.C.",4,2,6,0,0,0,
05-jun-13,MICH.,"BUENAVISTA, MICH.",2,4,6,0,0,0,
05-jun-13,B.C.,"MEXICALI, B.C.",3,3,6,0,0,0,
12-jun-13,TAMPS.,"MATAMOROS, TAMPS.",2,4,6,1,0,0,
17-jun-13,MEX.,"NAUCALPAN DE JUAREZ, MEX.",5,1,6,3,1,741,
20-jun-13,COAH.,"ACUÑA, COAH.",5,1,6,0,0,0,
24-jun-13,B.C.,"TIJUANA, B.C.",5,1,6,0,0,0,
24-jun-13,B.C.,"MEXICALI, B.C.",3,3,6,0,0,0,
24-jun-13,B.C.,"TIJUANA, B.C.",5,1,6,0,0,0,
24-jun-13,B.C.,"MEXICALI, B.C.",3,3,6,0,0,0,
25-jun-13,COAH.,"TORREÓN, COAH.",1,5,6,0,0,0,
27-jun-13,COAH.,"MÚZQUIZ, COAH.",5,1,6,0,0,18,
01-jul-13,PUE.,"PUE., PUE.",3,3,6,2,12,2176,
01-jul-13,MOR.,"CUERNAVACA, MOR.",4,2,6,3,0,30,
03-jul-13,MOR.,"CUERNAVACA, MOR.",4,2,6,0,1,0,
03-jul-13,CHIS.,"TAPACHULA, CHIS.",2,4,6,2,1,239,
04-jul-13,MEX.,"NAUCALPAN DE JUAREZ, MEX.",4,2,6,0,0,38,
05-jul-13,MEX.,"NAUCALPAN DE JUAREZ, MEX.",3,3,6,4,1,60,
07-jul-13,MEX.,"NAUCALPAN DE JUAREZ, MEX.",4,2,6,2,0,0,
10-jul-13,B.C.,"MEXICALI, B.C.",1,5,6,0,0,0,
11-jul-13,GRO.,"CHILPANCINGO DE LOS BRAVO, GRO.",3,3,6,0,1,140,
12-jul-13,MOR.,"CUERNAVACA, MOR.",5,1,6,0,0,153,
17-jul-13,B.C.,"TECATE, B.C.",1,5,6,0,0,0,
19-jul-13,B.C.,"TIJUANA, B.C.",1,5,6,0,0,0,
20-jul-13,MOR.,"CUERNAVACA, MOR.",3,3,6,0,6,72,
23-jul-13,PUE.,"SAN MARTIN TEXMELUCAN, PUE.",5,1,6,0,6,342,
24-jul-13,N.L.,"GRAL. ESCOBEDO, N.L.",4,2,6,8,0,0,
25-jul-13,JAL.,"GUADALAJARA, JAL.",5,1,6,0,0,0,
26-jul-13,COAH.,"TORREÓN, COAH.",6,0,6,0,0,0,
26-jul-13,N.L.,"GRAL. ESCOBEDO, N.L.",3,3,6,0,0,65,
29-jul-13,CHIS.,"TUXTLA GUTIÉRREZ, CHIS.",3,3,6,2,2,506,
30-jul-13,COAH.,"TORREÓN, COAH.",5,1,6,0,0,0,
31-jul-13,SIN.,"COSALA, SIN.",0,6,6,0,0,0,
01-ago-13,COAH.,"TORREÓN, COAH.",6,0,6,0,0,0,
06-ago-13,TLAX.,"TLAX., TLAX.",5,1,6,0,0,1,
09-ago-13,QRO.,"TEQUISQUIAPAN, QRO.",3,3,6,0,0,0,
11-ago-13,QRO.,"TEQUISQUIAPAN, QRO.",2,4,6,0,0,0,
14-ago-13,AGS.,"AGS., AGS.",5,1,6,2,0,100,
16-ago-13,QRO.,"TEQUISQUIAPAN, QRO.",2,4,6,0,4,0,
17-ago-13,N.L.,"SANTA CATARINA, N.L.",3,3,6,65,0,125,
18-ago-13,MOR.,"CUAUTLA, MOR.",2,4,6,2,0,157,
20-ago-13,B.C.,"TIJUANA, B.C.",3,3,6,0,0,0,
21-ago-13,B.C.,"TIJUANA, B.C.",3,3,6,0,0,0,
26-ago-13,TLAX.,"TLAX., TLAX.",2,4,6,0,0,0,
27-ago-13,MOR.,"CUAUTLA, MOR.",3,3,6,4,1,2305,
27-ago-13,GTO.,"CELAYA, GTO.",4,2,6,0,0,0,
30-ago-13,B.C.,"TIJUANA, B.C.",3,3,6,0,0,0,
01-sep-13,PUE.,"ATLIXCO, PUE.",3,3,6,1,1,918,
03-sep-13,N.L.,"GRAL. BRAVO, N.L.",2,4,6,0,0,0,
04-sep-13,SON.,"SAN LUIS RIO COLORADO, SON.",1,5,6,1,3,0,
09-sep-13,SON.,"SAN LUIS RIO COLORADO, SON.",2,4,6,3,0,0,
10-sep-13,SON.,"SAN LUIS RIO COLORADO, SON.",3,3,6,1,1,0,
13-sep-13,B.C.,"TIJUANA, B.C.",2,4,6,0,0,0,
28-sep-13,B.C.,"TIJUANA, B.C.",3,3,6,0,0,0,
03-oct-13,ZAC.,"GUADALUPE, ZAC.",6,0,6,1,0,673,
07-oct-13,ZAC.,"ZAC., ZAC.",3,3,6,1,0,260,
09-oct-13,SIN.,"ESCUINAPA, SIN.",4,2,6,0,0,0,
09-oct-13,COAH.,"SABINAS, COAH.",2,4,6,0,0,0,
09-oct-13,AGS.,"AGS., AGS.",5,1,6,0,0,212,
10-oct-13,COAH.,"SABINAS, COAH.",3,3,6,0,0,298,
15-oct-13,SIN.,"CONCORDIA, SIN.",5,1,6,0,0,0,
15-oct-13,JAL.,"TIZAPAN EL ALTO, JAL.",0,6,6,1,0,0,
16-oct-13,COAH.,"PIEDRAS NEGRAS, COAH.",2,4,6,2,0,164,
16-oct-13,B.C.,"MEXICALI, B.C.",2,4,6,0,0,0,
19-oct-13,VER.,"XALAPA, VER.",6,0,6,0,0,82,
23-oct-13,B.C.,"TIJUANA, B.C.",3,3,6,0,0,0,
07-nov-13,B.C.,"TIJUANA, B.C.",2,4,6,0,0,0,
13-nov-13,PUE.,"PUE., PUE.",4,2,6,2,0,179,
16-nov-13,GTO.,"IRAPUATO, GTO.",5,1,6,0,0,0,
22-nov-13,TAMPS.,"VICTORIA, TAMPS.",6,0,6,4,0,60,
27-nov-13,SON.,"HERMOSILLO, SON.",5,1,6,1,0,26,
28-nov-13,TAMPS.,"CIUDAD MADERO, TAMPS.",5,1,6,14,1,1319,
02-dic-13,SON.,"NAVOJOA, SON.",5,1,6,2,0,99,
05-dic-13,TAMPS.,"NUEVO LAREDO, TAMPS.",3,3,6,2,0,222,
06-dic-13,COAH.,"FRONTERA, COAH.",2,4,6,0,0,0,
09-dic-13,SON.,"CABORCA, SON.",3,3,6,0,0,0,
13-dic-13,TAMPS.,"NUEVO LAREDO, TAMPS.",6,0,6,0,0,635,
16-dic-13,TAMPS.,"MATAMOROS, TAMPS.",2,4,6,1,0,20,
17-dic-13,D.F.,"CUAUHTEMOC, D.F.",6,0,6,0,0,0,
04-ene-14,TAMPS.,"GONZALEZ, TAMPS.",2,4,6,2,0,4,
08-ene-14,PUE.,"PUE., PUE.",6,0,6,4,1,383,
11-ene-14,TAMPS.,"TAMPICO, TAMPS.",5,1,6,0,0,87,
01-feb-14,TAMPS.,"REYNOSA, TAMPS.",1,5,6,1,0,105,
05-feb-14,COAH.,"PIEDRAS NEGRAS, COAH.",2,4,6,3,0,315,
10-feb-14,COAH.,"PIEDRAS NEGRAS, COAH.",4,2,6,7,1,394,
11-mar-14,D.F.,"IZTACALCO, D.F.",5,1,6,2,15,250,
12-mar-14,VER.,"VER., VER.",5,1,6,0,3,15,
23-mar-14,QRO.,"QUERETARO, QRO.",5,1,6,0,1,0,
24-mar-14,N.L.,"MONTERREY, N.L.",4,2,6,12,0,220,
27-mar-14,COAH.,"SALTILLO, COAH.",2,4,6,0,0,0,
31-mar-14,AGS.,"AGS., AGS.",6,0,6,10,0,137,
31-mar-14,MEX.,"ATIZAPAN DE ZARAGOZA, MEX.",5,1,6,1,0,74,
02-abr-14,N.L.,"SANTA CATARINA, N.L.",2,4,6,2,0,219,
03-abr-14,AGS.,"AGS., AGS.",5,1,6,5,0,104,
03-abr-14,MEX.,"NICOLAS ROMERO, MEX.",6,0,6,0,1,120,
04-abr-14,B.C.,"MEXICALI, B.C.",4,2,6,0,0,0,
05-abr-14,TAMPS.,"MATAMOROS, TAMPS.",2,4,6,0,0,0,
07-abr-14,D.F.,"MILPA ALTA, D.F.",3,3,6,0,0,130,
08-abr-14,GTO.,"ACAMBARO, GTO.",0,6,6,0,0,0,
11-abr-14,HGO.,"CHILCUAUTLA, HGO.",5,1,6,0,0,0,
12-abr-14,MEX.,"CUAUTITLAN, MEX.",3,3,6,1,0,97,
14-abr-14,MEX.,"NAUCALPAN DE JUAREZ, MEX.",4,2,6,2,0,641,
23-abr-14,OAX.,"OAX. DE JUAREZ, OAX.",3,3,6,1,0,0,
26-abr-14,B.C.,"ENSENADA, B.C.",4,2,6,0,0,0,
28-abr-14,MEX.,"ALMOLOYA DE JUAREZ, MEX.",6,0,6,0,0,0,
29-abr-14,OAX.,"MIAHUATLAN DE PORFIRIO DIAZ, OAX.",4,2,6,0,0,0,
29-abr-14,MEX.,"NAUCALPAN DE JUAREZ, MEX.",6,0,6,3,0,286,
02-may-14,SIN.,"SALVADOR ALVARADO, SIN.",3,3,6,0,0,0,
02-may-14,SIN.,"ANGOSTURA, SIN.",0,6,6,0,0,0,
02-may-14,OAX.,"PINOTEPA DE DON LUIS, OAX.",5,1,6,0,0,0,
09-may-14,MEX.,"SAN MATEO ATENCO, MEX.",3,3,6,0,0,0,
10-may-14,B.C.,"MEXICALI, B.C.",2,4,6,0,0,0,
13-may-14,SON.,"CAJEME, SON.",5,1,6,0,0,0,
20-may-14,MEX.,"NAUCALPAN DE JUAREZ, MEX.",6,0,6,5,0,70,
22-may-14,MEX.,"TIANGUISTENCO, MEX.",4,2,6,0,0,0,
22-may-14,MEX.,"ACOLMAN, MEX.",4,2,6,0,5,0,
23-may-14,MEX.,"ACOLMAN, MEX.",6,0,6,0,5,0,
27-may-14,SIN.,"CHOIX, SIN.",4,2,6,0,0,0,
30-may-14,HGO.,"PACHUCA DE SOTO, HGO.",6,0,6,0,0,460,
03-jun-14,CHIH.,"CHIH., CHIH.",3,3,6,0,0,480,
11-jun-14,S.L.P.,"MATEHUALA, S.L.P.",4,2,6,0,0,0,
13-jun-14,CHIH.,"CHIH., CHIH.",1,5,6,0,0,345,
18-jun-14,MEX.,"TULTITLAN, MEX.",4,2,6,0,0,0,
19-jun-14,NAY.,"ACAPONETA, NAY.",3,3,6,0,0,0,
25-jun-14,SIN.,"NAVOLATO, SIN.",4,2,6,0,0,0,
25-jun-14,SIN.,"SIN., SIN.",0,6,6,0,4,0,
25-jun-14,B.C.,"TIJUANA, B.C.",3,3,6,0,0,0,
28-jun-14,MEX.,"CHALCO, MEX.",5,1,6,0,0,0,
02-jul-14,B.C.,"TIJUANA, B.C.",1,5,6,0,0,0,
10-jul-14,NAY.,"ACAPONETA, NAY.",5,1,6,0,0,0,
19-jul-14,QRO.,"QUERETARO, QRO.",0,6,6,0,6,0,
25-jul-14,TAMPS.,"MATAMOROS, TAMPS.",6,0,6,3,0,50,
29-jul-14,NAY.,"JALA, NAY.",0,6,6,0,0,0,
30-jul-14,NAY.,"ACAPONETA, NAY.",3,3,6,0,0,0,
01-ago-14,B.C.,"TECATE, B.C.",6,0,6,0,0,0,
05-ago-14,NAY.,"JALA, NAY.",4,2,6,0,0,0,
06-ago-14,CHIH.,"JUÁREZ, CHIH.",4,2,6,0,0,0,
14-ago-14,COL.,"COL., COL.",2,4,6,0,0,299,
19-ago-14,NAY.,"IXTLAN DEL RIO, NAY.",4,2,6,0,0,0,
21-ago-14,YUC.,"Q. ROO., YUC.",0,6,6,0,0,0,
21-ago-14,NAY.,"IXTLAN DEL RIO, NAY.",5,1,6,0,0,0,
22-ago-14,SIN.,"ROSARIO, SIN.",3,3,6,0,0,0,
22-ago-14,TAMPS.,"MATAMOROS, TAMPS.",3,3,6,1,0,0,
29-ago-14,CHIH.,"JUÁREZ, CHIH.",5,1,6,0,0,0,
01-sep-14,COL.,"COL., COL.",1,5,6,0,0,0,
02-sep-14,JAL.,"TLAQUEPAQUE, JAL.",5,1,6,0,0,0,
06-sep-14,MICH.,"BUENAVISTA, MICH.",3,3,6,1,0,1104,
09-sep-14,MICH.,"ZITACUARO, MICH.",2,4,6,1,0,0,
18-sep-14,S.L.P.,"CIUDAD VALLES, S.L.P.",5,1,6,0,0,6,
19-sep-14,MICH.,"JIQUILPAN, MICH.",2,4,6,0,0,146,
23-sep-14,MICH.,"JIQUILPAN, MICH.",5,1,6,6,0,24,
26-sep-14,OAX.,"SAN PEDRO POCHUTLA, OAX.",1,5,6,34,0,140,
28-sep-14,MICH.,"ZAMORA, MICH.",3,3,6,1,0,0,
29-sep-14,B.C.,"TIJUANA, B.C.",4,2,6,0,0,0,
01-oct-14,SIN.,"ESCUINAPA, SIN.",2,4,6,0,0,0,
02-oct-14,MICH.,"URUAPAN, MICH.",3,3,6,0,0,6,
04-oct-14,N.L.,"MONTERREY, N.L.",4,2,6,9,1,420,
04-oct-14,MICH.,"URUAPAN, MICH.",4,2,6,0,0,163,
07-oct-14,MICH.,"URUAPAN, MICH.",5,1,6,1,0,2306,
07-oct-14,SON.,"CABORCA, SON.",5,1,6,4,0,110,
10-oct-14,SON.,"NAVOJOA, SON.",5,1,6,3,0,0,
10-oct-14,SON.,"NOGALES, SON.",2,4,6,30,0,60,
13-oct-14,SON.,"SAN LUIS RIO COLORADO, SON.",4,2,6,2,0,0,
14-oct-14,SON.,"NOGALES, SON.",5,1,6,2,0,65,
14-oct-14,MOR.,"CUERNAVACA, MOR.",4,2,6,1,3,35,
14-oct-14,TLAX.,"TLAX., TLAX.",4,2,6,1,0,0,
14-oct-14,GRO.,"CHILPANCINGO DE LOS BRAVO, GRO.",4,2,6,0,0,0,
17-oct-14,SON.,"HERMOSILLO, SON.",4,2,6,12,0,240,
17-oct-14,SON.,"NAVOJOA, SON.",5,1,6,5,0,0,
17-oct-14,CHIS.,"TUXTLA GUTIÉRREZ, CHIS.",3,3,6,6,3,434,
18-oct-14,SON.,"HERMOSILLO, SON.",4,2,6,26,0,44,
18-oct-14,CHIS.,"VILLAFLORES, CHIS.",5,1,6,0,0,0,
19-oct-14,CHIS.,"VILLAFLORES, CHIS.",4,2,6,3,0,0,
21-oct-14,MICH.,"PATZCUARO, MICH.",5,1,6,2,0,0,
21-oct-14,CHIS.,"OCOZOCOAUTLA DE ESPINOSA, CHIS.",2,4,6,1,0,8,
23-oct-14,CHIS.,"OCOZOCOAUTLA DE ESPINOSA, CHIS.",2,4,6,0,0,150,
24-oct-14,NAY.,"AHUACATLAN, NAY.",1,5,6,0,0,0,
25-oct-14,CHIS.,"VILLAFLORES, CHIS.",1,5,6,1,2,0,
26-oct-14,CHIS.,"COMITAN DE DOMÍNGUEZ, CHIS.",2,4,6,0,0,264,
26-oct-14,CHIS.,"TAPACHULA, CHIS.",3,3,6,2,0,745,
27-oct-14,MICH.,"MORELIA, MICH.",5,1,6,3,0,680,
28-oct-14,MICH.,"ZAMORA, MICH.",3,3,6,5,8,50,
29-oct-14,CHIS.,"TAPACHULA, CHIS.",6,0,6,9,0,1317,
01-nov-14,MOR.,"CUERNAVACA, MOR.",3,3,6,0,3,370,
01-nov-14,SON.,"NAVOJOA, SON.",3,3,6,1,1,60,
07-nov-14,CHIS.,"OCOZOCOAUTLA DE ESPINOSA, CHIS.",2,4,6,0,0,19,
09-nov-14,CHIS.,"TUXTLA GUTIÉRREZ, CHIS.",5,1,6,2,1,1163,
11-nov-14,CHIS.,"SAN CRISTOBAL DE LAS CASAS, CHIS.",5,1,6,0,0,0,
12-nov-14,CHIS.,"COMITAN DE DOMÍNGUEZ, CHIS.",6,0,6,0,0,75,
13-nov-14,CHIS.,"TAPACHULA, CHIS.",3,3,6,0,0,3437,
13-nov-14,GRO.,"FLORENCIO VILLARREAL, GRO.",3,3,6,0,0,0,
13-nov-14,CHIS.,"SAN CRISTOBAL DE LAS CASAS, CHIS.",5,1,6,0,0,314,
21-nov-14,SIN.,"SALVADOR ALVARADO, SIN.",2,4,6,0,6,0,
04-dic-14,N.L.,"MONTERREY, N.L.",5,1,6,0,0,1917,
14-dic-14,N.L.,"MONTERREY, N.L.",6,0,6,63,0,11167,
15-dic-14,N.L.,"MONTERREY, N.L.",2,4,6,73,0,8070,
17-dic-14,DGO.,"DGO., DGO.",5,1,6,19,11,0,
19-dic-14,DGO.,"LERDO, DGO.",3,3,6,1,0,0,
19-dic-14,N.L.,"MONTERREY, N.L.",3,3,6,104,0,21138,
19-dic-14,TAMPS.,"MATAMOROS, TAMPS.",1,5,6,0,0,0,
21-dic-14,GRO.,"IGUALA DE LA INDEPENDENCIA, GRO.",3,3,6,0,0,0,
24-dic-14,DGO.,"LERDO, DGO.",6,0,6,0,0,0,
05-ene-15,DGO.,"LERDO, DGO.",4,2,6,0,0,0,
10-ene-15,DGO.,"DGO., DGO.",3,3,6,2,0,0,
25-ene-15,B.C.,"TIJUANA, B.C.",5,1,6,0,0,0,
29-ene-15,B.C.,"TIJUANA, B.C.",5,1,6,0,0,0,
03-feb-15,B.C.,"TIJUANA, B.C.",4,2,6,0,0,0,
07-mar-15,B.C.,"TIJUANA, B.C.",3,3,6,0,0,0,
20-mar-15,TAMPS.,"MATAMOROS, TAMPS.",2,4,6,0,0,0,
24-mar-15,DGO.,"LERDO, DGO.",5,1,6,0,0,0,
25-mar-15,B.C.,"MEXICALI, B.C.",3,3,6,0,0,0,
28-mar-15,OAX.,"PINOTEPA DE DON LUIS, OAX.",6,0,6,4,0,0,
29-mar-15,DGO.,"GOMEZ PALACIO, DGO.",4,2,6,0,0,0,
04-ago-15,MEX.,"METEPEC, MEX.",4,2,6,9,0,82,
08-ago-15,DGO.,"DGO., DGO.",6,0,6,0,0,0,
08-ago-15,COAH.,"MONCLOVA, COAH.",3,3,6,0,0,225,
10-ago-15,MEX.,"TLALNEPANTLA DE BAZ, MEX.",4,2,6,1,5,219,
11-ago-15,MEX.,"TOLUCA, MEX.",5,1,6,4,0,0,
12-ago-15,OAX.,"CIUDAD IXTEPEC, OAX.",6,0,6,1,0,0,
12-ago-15,COAH.,"TORREÓN, COAH.",3,3,6,0,0,0,
12-ago-15,TLAX.,"APIZACO, TLAX.",4,2,6,1,0,16,
13-ago-15,CHIH.,"CHIH., CHIH.",6,0,6,0,0,466,
13-ago-15,CHIH.,"CHIH., CHIH.",4,2,6,0,0,225,
14-ago-15,SIN.,"SALVADOR ALVARADO, SIN.",5,1,6,0,0,0,
19-ago-15,DGO.,"DGO., DGO.",3,3,6,1,0,0,
19-ago-15,MEX.,"LERMA, MEX.",6,0,6,3,0,0,
20-ago-15,CHIH.,"HGO. DEL PARRAL, CHIH.",6,0,6,0,0,0,
22-ago-15,TAMPS.,"MATAMOROS, TAMPS.",4,2,6,1,0,28,
27-ago-15,DGO.,"DGO., DGO.",5,1,6,9,2,0,
28-ago-15,COAH.,"SABINAS, COAH.",5,1,6,0,0,0,
28-ago-15,OAX.,"CIUDAD IXTEPEC, OAX.",4,2,6,1,0,0,
29-ago-15,DGO.,"DGO., DGO.",3,3,6,0,0,0,
29-ago-15,DGO.,"GOMEZ PALACIO, DGO.",6,0,6,0,0,0,
30-ago-15,TAMPS.,"MATAMOROS, TAMPS.",4,2,6,0,0,100,
31-ago-15,SIN.,"MAZATLAN, SIN.",4,2,6,0,3,0,
31-ago-15,B.C.,"TIJUANA, B.C.",3,3,6,0,0,0,
01-sep-15,COAH.,"SABINAS, COAH.",3,3,6,0,0,0,
01-sep-15,SIN.,"ROSARIO, SIN.",3,3,6,0,0,0,
01-sep-15,CHIH.,"CHIH., CHIH.",3,3,6,2,0,298,
02-sep-15,COAH.,"TORREÓN, COAH.",6,0,6,2,0,39,
02-sep-15,DGO.,"GOMEZ PALACIO, DGO.",5,1,6,0,0,0,
02-sep-15,B.C.,"MEXICALI, B.C.",3,3,6,0,0,0,
03-sep-15,MEX.,"COACALCO DE BERRIOZABAL, MEX.",3,3,6,0,2,0,
07-sep-15,DGO.,"GOMEZ PALACIO, DGO.",3,3,6,0,0,0,
07-sep-15,B.C.,"TIJUANA, B.C.",5,1,6,0,0,0,
11-sep-15,SIN.,"ROSARIO, SIN.",2,4,6,0,0,0,
14-sep-15,COAH.,"SALTILLO, COAH.",6,0,6,2,0,60,
15-sep-15,B.C.,"MEXICALI, B.C.",4,2,6,0,0,0,
17-sep-15,DGO.,"DGO., DGO.",2,4,6,21,0,0,
18-sep-15,N.L.,"SAN PEDRO GARZA GARCIA, N.L.",5,1,6,27,0,8900,
21-sep-15,MEX.,"TEZOYUCA, MEX.",4,2,6,0,4,0,
22-sep-15,B.C.,"TIJUANA, B.C.",2,4,6,0,0,0,
22-sep-15,SIN.,"CULIACAN, SIN.",5,1,6,0,18,0,
23-sep-15,QRO.,"QUERETARO, QRO.",1,5,6,0,0,0,
23-sep-15,DGO.,"GOMEZ PALACIO, DGO.",3,3,6,0,0,0,
24-sep-15,DGO.,"LERDO, DGO.",3,3,6,0,0,0,
24-sep-15,N.L.,"ABASOLO, N.L.",4,2,6,0,0,0,
25-sep-15,MEX.,"TLALMANALCO, MEX.",3,3,6,0,0,0,
28-sep-15,TAB.,"BALANCAN, TAB.",2,4,6,0,0,0,
29-sep-15,COAH.,"PIEDRAS NEGRAS, COAH.",3,3,6,0,0,0,
29-sep-15,B.C.,"TIJUANA, B.C.",4,2,6,0,0,0,
29-sep-15,B.C.,"MEXICALI, B.C.",1,5,6,0,0,0,
29-sep-15,MEX.,"TEOLOYUCAN, MEX.",4,2,6,0,0,201,
30-sep-15,B.C.,"TIJUANA, B.C.",3,3,6,0,0,0,
30-sep-15,MEX.,"NICOLAS ROMERO, MEX.",5,1,6,0,12,0,
01-oct-15,B.C.,"MEXICALI, B.C.",2,4,6,0,0,0,
05-oct-15,MEX.,"TIANGUISTENCO, MEX.",6,0,6,0,0,0,
06-oct-15,MEX.,"TONANITLA, MEX.",5,1,6,0,0,100,
07-oct-15,SIN.,"BADIRAGUATO, SIN.",3,3,6,0,1,0,
07-oct-15,COAH.,"TORREÓN, COAH.",5,1,6,0,0,0,
08-oct-15,HGO.,"TULANCINGO DE BRAVO, HGO.",4,2,6,0,0,0,
08-oct-15,MEX.,"TIANGUISTENCO, MEX.",6,0,6,5,1,0,
09-oct-15,N.L.,"ANAHUAC, N.L.",0,6,6,0,0,0,
12-oct-15,COAH.,"PIEDRAS NEGRAS, COAH.",6,0,6,0,0,0,
13-oct-15,COAH.,"PIEDRAS NEGRAS, COAH.",3,3,6,7,0,180,
13-oct-15,B.C.,"MEXICALI, B.C.",1,5,6,0,0,0,
19-oct-15,COAH.,"TORREÓN, COAH.",6,0,6,0,0,0,
20-oct-15,SIN.,"CONCORDIA, SIN.",1,5,6,0,0,0,
22-oct-15,SIN.,"GUASAVE, SIN.",6,0,6,0,0,0,
22-oct-15,COAH.,"TORREÓN, COAH.",6,0,6,51,0,0,
26-oct-15,DGO.,"DGO., DGO.",5,1,6,0,2,0,
26-oct-15,COAH.,"MONCLOVA, COAH.",3,3,6,0,0,0,
28-oct-15,COAH.,"TORREÓN, COAH.",5,1,6,3,0,10,
28-oct-15,B.C.,"MEXICALI, B.C.",2,4,6,0,0,0,
03-nov-15,D.F.,"COYOACAN, D.F.",2,4,6,0,0,25,
04-nov-15,MEX.,"CAPULHUAC, MEX.",6,0,6,0,0,0,
05-nov-15,COAH.,"SALTILLO, COAH.",6,0,6,0,0,0,
06-nov-15,MEX.,"TEJUPILCO, MEX.",2,4,6,3,0,1,
10-nov-15,MEX.,"MALINALCO, MEX.",6,0,6,2,0,0,
10-nov-15,N.L.,"MONTERREY, N.L.",5,1,6,3,0,400,
11-nov-15,SIN.,"SIN., SIN.",6,0,6,0,4,0,
12-nov-15,N.L.,"GRAL. ESCOBEDO, N.L.",6,0,6,202,0,550,
21-nov-15,MEX.,"XALATLACO, MEX.",5,1,6,5,0,300,
22-nov-15,MEX.,"OTUMBA, MEX.",4,2,6,2,1,50,
23-nov-15,COAH.,"SALTILLO, COAH.",6,0,6,0,0,200,
24-nov-15,SON.,"AGUA PRIETA, SON.",2,4,6,0,0,0,
27-nov-15,COAH.,"SALTILLO, COAH.",4,2,6,3,2,209,
01-dic-15,GRO.,"IGUALA DE LA INDEPENDENCIA, GRO.",4,2,6,0,0,73,
02-dic-15,SON.,"HERMOSILLO, SON.",5,1,6,1,0,100,
03-dic-15,DGO.,"DGO., DGO.",5,1,6,8,1,0,
07-dic-15,S.L.P.,"SALINAS, S.L.P.",5,1,6,0,0,0,
08-dic-15,CHIH.,"HGO. DEL PARRAL, CHIH.",4,2,6,0,0,538,
24-dic-15,B.C.,"MEXICALI, B.C.",0,6,6,0,0,0,
08-ene-16,B.C.,"TIJUANA, B.C.",4,2,6,0,0,0,
19-ene-16,COAH.,"PIEDRAS NEGRAS, COAH.",1,5,6,0,0,0,
19-ene-16,D.F.,"COYOACAN, D.F.",3,3,6,0,2,251,
20-ene-16,COAH.,"ACUÑA, COAH.",1,5,6,0,0,59,
23-ene-16,B.C.,"ENSENADA, B.C.",1,5,6,0,0,0,
28-ene-16,CHIH.,"NUEVO CASAS GRANDES, CHIH.",3,3,6,0,0,17,
31-ene-16,GRO.,"ARCELIA, GRO.",1,5,6,0,3,0,
03-feb-16,COAH.,"SALTILLO, COAH.",4,2,6,0,2,0,
10-feb-16,CHIH.,"AHUMADA, CHIH.",1,5,6,0,0,120,
12-feb-16,COAH.,"MONCLOVA, COAH.",5,1,6,3,0,220,
19-feb-16,OAX.,"OAX. DE JUAREZ, OAX.",0,6,6,0,0,0,
14-mar-16,COAH.,"SALTILLO, COAH.",1,5,6,0,0,91,
08-abr-16,COAH.,"SALTILLO, COAH.",4,2,6,0,0,0,
09-abr-16,S.L.P.,"SAN LUIS POTOSI, S.L.P.",5,1,6,5,1,0,
09-abr-16,S.L.P.,"SAN LUIS POTOSI, S.L.P.",5,1,6,5,1,0,
24-may-16,COAH.,"ACUÑA, COAH.",5,1,6,25,0,0,
26-may-16,N.L.,"MONTERREY, N.L.",6,0,6,4,0,17,
29-may-16,N.L.,"GUADALUPE, N.L.",6,0,6,0,0,0,
17-jun-16,VER.,"POZA RICA DE HGO., VER.",4,2,6,3,0,0,
27-jun-16,N.L.,"SABINAS HGO., N.L.",1,5,6,0,0,110,
11-jul-16,SIN.,"CULIACAN, SIN.",5,1,6,0,7,0,
11-jul-16,SIN.,"COSALA, SIN.",4,2,6,0,0,0,
21-jul-16,COAH.,"PIEDRAS NEGRAS, COAH.",1,5,6,0,1,38,
22-jul-16,COAH.,"SALTILLO, COAH.",6,0,6,14,0,0,
01-ago-16,SIN.,"NAVOLATO, SIN.",5,1,6,0,0,0,
10-ago-16,MEX.,"HUEHUETOCA, MEX.",4,2,6,0,0,0,
12-ago-16,S.L.P.,"SAN LUIS POTOSI, S.L.P.",4,2,6,5,0,0,
12-ago-16,MEX.,"METEPEC, MEX.",5,1,6,0,0,6,
13-ago-16,S.L.P.,"SAN LUIS POTOSI, S.L.P.",4,2,6,0,1,250,
18-ago-16,MEX.,"TOLUCA, MEX.",5,1,6,1,0,51,
23-ago-16,MEX.,"CHIMALHUACAN, MEX.",5,1,6,0,0,0,
27-ago-16,SON.,"CAJEME, SON.",5,1,6,1,0,0,
27-ago-16,MEX.,"CHIMALHUACAN, MEX.",5,1,6,0,2,0,
29-ago-16,OAX.,"MIAHUATLAN DE PORFIRIO DIAZ, OAX.",2,4,6,5,0,0,
02-sep-16,MEX.,"TULTEPEC, MEX.",6,0,6,2,0,31,
07-sep-16,MEX.,"COACALCO DE BERRIOZABAL, MEX.",6,0,6,1,0,6,
19-sep-16,MEX.,"TULTITLAN, MEX.",2,4,6,2,0,6,
19-sep-16,MEX.,"CHALCO, MEX.",6,0,6,3,4,13,
20-sep-16,MEX.,"TULTITLAN, MEX.",2,4,6,2,0,6,
27-sep-16,MEX.,"TEZOYUCA, MEX.",5,1,6,0,0,25,
30-sep-16,SON.,"CAJEME, SON.",2,4,6,3,0,0,
30-sep-16,CHIS.,"VILLAFLORES, CHIS.",3,3,6,0,0,1166,
01-oct-16,MEX.,"MELCHOR OCAMPO, MEX.",5,1,6,1,0,49,
05-oct-16,MEX.,"TEPOTZOTLAN, MEX.",4,2,6,9,0,566,
11-oct-16,COAH.,"TORREÓN, COAH.",5,1,6,6,0,0,
12-oct-16,SIN.,"SALVADOR ALVARADO, SIN.",2,4,6,0,0,0,
14-oct-16,SIN.,"SALVADOR ALVARADO, SIN.",5,1,6,0,1,0,
18-oct-16,SIN.,"ESCUINAPA, SIN.",6,0,6,0,7,0,
20-oct-16,SIN.,"EL FUERTE, SIN.",6,0,6,0,0,0,
24-oct-16,SON.,"CAJEME, SON.",6,0,6,0,0,0,
25-oct-16,MEX.,"ZINACANTEPEC, MEX.",6,0,6,2,0,101,
06-nov-16,MEX.,"JOQUICINGO, MEX.",4,2,6,0,0,0,
14-nov-16,MEX.,"TECAMAC, MEX.",5,1,6,0,0,0,
23-nov-16,B.C.,"TIJUANA, B.C.",2,4,6,0,0,0,
26-nov-16,MEX.,"JOCOTITLAN, MEX.",1,5,6,6,0,0,
30-nov-16,TAB.,"CENTRO, TAB.",6,0,6,3,1,535,
05-dic-16,D.F.,"AZCAPOTZALCO, D.F.",3,3,6,0,1,83,
09-dic-16,GTO.,"IRAPUATO, GTO.",2,4,6,0,0,0,
13-dic-16,B.C.,"TIJUANA, B.C.",1,5,6,0,0,0,
21-dic-16,B.C.,"TIJUANA, B.C.",5,1,6,0,0,0,
23-dic-16,GTO.,"LEON, GTO.",4,2,6,0,0,0,
06-ene-17,DGO.,"GOMEZ PALACIO, DGO.",6,0,6,0,0,0,
17-ene-17,DGO.,"GOMEZ PALACIO, DGO.",6,0,6,0,0,0,
31-ene-17,D.F.,"COYOACAN, D.F.",6,0,6,0,0,334,
01-feb-17,D.F.,"COYOACAN, D.F.",5,1,6,0,0,154,
01-feb-17,SIN.,"MAZATLAN, SIN.",4,2,6,0,20,0,
02-feb-17,DGO.,"DGO., DGO.",6,0,6,2,0,0,
21-feb-17,TAMPS.,"NUEVO LAREDO, TAMPS.",2,4,6,0,0,0,
01-mar-17,PUE.,"PUE., PUE.",6,0,6,0,0,0,
04-mar-17,TAMPS.,"MATAMOROS, TAMPS.",2,4,6,5,0,234,
07-mar-17,MEX.,"TLALNEPANTLA DE BAZ, MEX.",3,3,6,1,0,47,
24-mar-17,ZAC.,"ZAC., ZAC.",5,1,6,0,0,396,
25-mar-17,QRO.,"QUERETARO, QRO.",4,2,6,0,0,0,
25-mar-17,MEX.,"TECAMAC, MEX.",6,0,6,2,0,175,
29-mar-17,QRO.,"QUERETARO, QRO.",5,1,6,0,0,0,
17-abr-17,SIN.,"MAZATLAN, SIN.",5,1,6,0,0,0,
19-abr-17,S.L.P.,"SAN LUIS POTOSI, S.L.P.",6,0,6,0,0,150,
21-abr-17,QRO.,"QUERETARO, QRO.",1,5,6,0,0,0,
21-abr-17,D.F.,"TLALPAN, D.F.",3,3,6,0,3,46,
24-abr-17,D.F.,"XOCHIMILCO, D.F.",5,1,6,0,0,9097,
24-abr-17,JAL.,"TONALA, JAL.",2,4,6,0,0,0,
27-abr-17,JAL.,"GUADALAJARA, JAL.",2,4,6,0,0,0,
27-abr-17,JAL.,"TLAQUEPAQUE, JAL.",5,1,6,0,0,0,
28-abr-17,JAL.,"GUADALAJARA, JAL.",6,0,6,0,0,0,
08-may-17,JAL.,"GUADALAJARA, JAL.",2,4,6,0,0,0,
12-may-17,TAMPS.,"MATAMOROS, TAMPS.",2,4,6,0,0,100,
29-may-17,D.F.,"BENITO JUAREZ, D.F.",5,1,6,0,0,435,
30-may-17,AGS.,"AGS., AGS.",5,1,6,7,0,7,
06-jun-17,MOR.,"CUERNAVACA, MOR.",4,2,6,1,0,304,
06-jun-17,CHIS.,"VILLAFLORES, CHIS.",4,2,6,0,0,100,
06-jun-17,CHIS.,"VILLAFLORES, CHIS.",4,2,6,0,0,100,
07-jun-17,CHIS.,"TAPACHULA, CHIS.",6,0,6,6,0,162,
07-jun-17,CHIS.,"VILLAFLORES, CHIS.",2,4,6,0,0,239,
07-jun-17,TAMPS.,"MIER, TAMPS.",1,5,6,0,0,0,
08-jun-17,MOR.,"CUERNAVACA, MOR.",4,2,6,2,5,445,
09-jun-17,YUC.,"KANASIN, YUC.",6,0,6,0,0,0,
09-jun-17,D.F.,"GUSTAVO A. MADERO, D.F.",6,0,6,0,0,2,
14-jun-17,SIN.,"CHOIX, SIN.",2,4,6,0,0,0,
23-jun-17,SIN.,"CHOIX, SIN.",3,3,6,0,0,0,
30-jun-17,SIN.,"CHOIX, SIN.",3,3,6,0,0,0,
30-jun-17,MOR.,"TEPOZTLAN, MOR.",2,4,6,0,0,0,
04-jul-17,JAL.,"ZAPOTLANEJO, JAL.",4,2,6,0,0,196,
05-jul-17,SIN.,"EL FUERTE, SIN.",5,1,6,0,0,0,
11-jul-17,SIN.,"EL FUERTE, SIN.",5,1,6,0,0,0,
13-jul-17,B.C.,"MEXICALI, B.C.",0,6,6,0,0,0,
28-jul-17,COAH.,"MÚZQUIZ, COAH.",0,6,6,0,0,0,
03-ago-17,CHIS.,"TUXTLA GUTIÉRREZ, CHIS.",6,0,6,1,0,487,
10-ago-17,D.F.,"MIGUEL HGO., D.F.",5,1,6,0,0,0,
10-ago-17,CHIS.,"TAPACHULA, CHIS.",0,6,6,1,0,239,
17-ago-17,MEX.,"CHICONCUAC, MEX.",5,1,6,0,0,784,
18-ago-17,CHIS.,"TUXTLA GUTIÉRREZ, CHIS.",5,1,6,2,0,30,
18-ago-17,SIN.,"ANGOSTURA, SIN.",0,6,6,0,0,0,
22-ago-17,COAH.,"TORREÓN, COAH.",6,0,6,0,0,0,
22-ago-17,COAH.,"TORREÓN, COAH.",6,0,6,0,0,0,
02-sep-17,COAH.,"RAMOS ARIZPE, COAH.",4,2,6,0,3,0,
04-sep-17,ZAC.,"GUADALUPE, ZAC.",2,4,6,0,0,0,
05-sep-17,COAH.,"TORREÓN, COAH.",5,1,6,0,0,0,
08-sep-17,MEX.,"ZACUALPAN, MEX.",4,2,6,0,0,3,
10-sep-17,MEX.,"ZACUALPAN, MEX.",4,2,6,0,0,0,
18-sep-17,D.F.,"CUAJIMALPA DE MOR., D.F.",5,1,6,0,0,0,
21-sep-17,SIN.,"AHOME, SIN.",4,2,6,0,1,0,
22-sep-17,ZAC.,"GUADALUPE, ZAC.",4,2,6,0,1,1217,
22-sep-17,ZAC.,"BENITO JUAREZ, ZAC.",4,2,6,0,0,0,
22-sep-17,SIN.,"AHOME, SIN.",6,0,6,0,0,0,
27-sep-17,ZAC.,"FRESNILLO, ZAC.",3,3,6,3,1,3,
02-oct-17,SON.,"HERMOSILLO, SON.",2,4,6,1,0,34,
04-oct-17,ZAC.,"FRESNILLO, ZAC.",4,2,6,0,0,0,
24-oct-17,SIN.,"CULIACAN, SIN.",6,0,6,0,1,0,
25-oct-17,ZAC.,"GUADALUPE, ZAC.",5,1,6,0,0,88,
26-oct-17,D.F.,"LA MAGDALENA CONTRERAS, D.F.",3,3,6,0,4,0,
28-oct-17,DGO.,"GOMEZ PALACIO, DGO.",3,3,6,0,0,0,
28-oct-17,DGO.,"GOMEZ PALACIO, DGO.",3,3,6,0,0,0,
07-nov-17,D.F.,"ALVARO OBREGON, D.F.",3,3,6,0,4,0,
22-nov-17,D.F.,"GUSTAVO A. MADERO, D.F.",4,2,6,0,12,185,
24-nov-17,GTO.,"CELAYA, GTO.",4,2,6,0,0,0,
29-ene-18,COAH.,"MONCLOVA, COAH.",6,0,6,0,0,310,
03-feb-18,TAMPS.,"NUEVO LAREDO, TAMPS.",5,1,6,3,0,86,
07-feb-18,COAH.,"PIEDRAS NEGRAS, COAH.",2,4,6,10,0,275,
08-feb-18,COAH.,"SALTILLO, COAH.",5,1,6,0,4,0,
09-feb-18,COAH.,"SALTILLO, COAH.",2,4,6,2,0,90,
12-feb-18,ZAC.,"GUADALUPE, ZAC.",6,0,6,10,0,461,
16-feb-18,ZAC.,"GUADALUPE, ZAC.",6,0,6,4,0,0,
16-feb-18,GRO.,"ACAPULCO DE JUAREZ, GRO.",6,0,6,0,7,119,
16-mar-18,TAMPS.,"MATAMOROS, TAMPS.",6,0,6,0,0,59,
22-mar-18,ZAC.,"GUADALUPE, ZAC.",6,0,6,0,0,0,
14-jul-18,B.C.,"TIJUANA, B.C.",5,1,6,0,0,0,
16-jul-18,B.C.,"TIJUANA, B.C.",5,1,6,0,0,0,
19-jul-18,ZAC.,"GUADALUPE, ZAC.",4,2,6,2,0,0,
21-jul-18,CHIH.,"HGO. DEL PARRAL, CHIH.",3,3,6,0,0,2174,
25-jul-18,ZAC.,"GUADALUPE, ZAC.",6,0,6,7,0,127,
27-jul-18,ZAC.,"GUADALUPE, ZAC.",6,0,6,2,0,70,
01-ago-18,D.F.,"GUSTAVO A. MADERO, D.F.",5,1,6,0,1,2147,
07-ago-18,MEX.,"ATIZAPAN, MEX.",6,0,6,6,0,201,
08-ago-18,MEX.,"ATIZAPAN, MEX.",4,2,6,0,50,206,
08-ago-18,TAMPS.,"VICTORIA, TAMPS.",4,2,6,0,0,0,
10-ago-18,MEX.,"ATIZAPAN, MEX.",5,1,6,5,35,320,
10-ago-18,CHIH.,"HGO. DEL PARRAL, CHIH.",5,1,6,7,1,1091,
11-ago-18,CHIS.,"CHICOASÉN, CHIS.",4,2,6,0,2,262,
13-ago-18,CHIH.,"HGO. DEL PARRAL, CHIH.",3,3,6,5,0,248,
15-ago-18,COAH.,"ACUÑA, COAH.",3,3,6,0,0,0,
15-ago-18,MEX.,"ATIZAPAN, MEX.",6,0,6,1,0,232,
16-ago-18,CHIH.,"HGO. DEL PARRAL, CHIH.",4,2,6,1,1,281,
17-ago-18,CHIH.,"HGO. DEL PARRAL, CHIH.",5,1,6,3,0,1224,
18-ago-18,MEX.,"CHALCO, MEX.",5,1,6,0,0,9,
20-ago-18,CHIH.,"HGO. DEL PARRAL, CHIH.",6,0,6,1,0,1,
23-ago-18,D.F.,"BENITO JUAREZ, D.F.",6,0,6,0,4,346,
23-ago-18,B.C.,"TIJUANA, B.C.",2,4,6,0,1,0,
24-ago-18,D.F.,"BENITO JUAREZ, D.F.",6,0,6,0,15,123,
24-ago-18,TAMPS.,"MIER, TAMPS.",2,4,6,0,0,130,
27-ago-18,ZAC.,"FRESNILLO, ZAC.",3,3,6,0,0,174,
31-ago-18,TLAX.,"PANOTLA, TLAX.",3,3,6,0,0,0,
04-sep-18,MEX.,"AMECAMECA, MEX.",4,2,6,1,0,0,
05-sep-18,ZAC.,"FRESNILLO, ZAC.",3,3,6,0,0,50,
07-sep-18,MEX.,"NEZAHUALCOYOTL, MEX.",6,0,6,0,0,276,
10-sep-18,VER.,"VER., VER.",5,1,6,1,0,754,
12-sep-18,D.F.,"XOCHIMILCO, D.F.",5,1,6,0,0,234,
17-sep-18,MEX.,"TULTEPEC, MEX.",6,0,6,0,0,37,
20-sep-18,ZAC.,"FRESNILLO, ZAC.",4,2,6,0,0,0,
24-sep-18,MEX.,"RAYON, MEX.",6,0,6,0,0,0,
09-oct-18,MEX.,"NAUCALPAN DE JUAREZ, MEX.",5,1,6,1,0,28,
11-oct-18,GTO.,"LEON, GTO.",6,0,6,0,5,0,
19-oct-18,AGS.,"AGS., AGS.",5,1,6,15,0,457,
20-oct-18,MEX.,"NAUCALPAN DE JUAREZ, MEX.",4,2,6,2,0,0,
20-oct-18,CHIH.,"JUÁREZ, CHIH.",6,0,6,4,0,146,
22-oct-18,MEX.,"ALMOLOYA DE JUAREZ, MEX.",5,1,6,0,0,0,
25-oct-18,GTO.,"LEON, GTO.",3,3,6,0,0,0,
31-oct-18,MEX.,"TECAMAC, MEX.",4,2,6,2,0,11,
07-nov-18,MEX.,"VALLE DE CHALCO SOLIDARIDAD, MEX.",6,0,6,0,0,533,
03-dic-18,SIN.,"SIN., SIN.",5,1,6,0,0,0,
18-dic-18,SIN.,"BADIRAGUATO, SIN.",0,6,6,0,0,0,
08-mar-19,ZAC.,"GUADALUPE, ZAC.",2,4,6,3,0,235,
29-mar-19,ZAC.,"FRESNILLO, ZAC.",5,1,6,0,0,3,
09-abr-19,CD. MÉX.,"XOCHIMILCO, CD. MÉX.",3,3,6,0,0,51,
12-abr-19,CD. MÉX.,"XOCHIMILCO, CD. MÉX.",3,3,6,0,0,25,
15-abr-19,CD. MÉX.,"IZTAPALAPA, CD. MÉX.",4,2,6,0,1,890,
22-abr-19,CD. MÉX.,"VENUSTIANO CARRANZA, CD. MÉX.",4,2,6,0,0,60,
02-may-19,CD. MÉX.,"IZTAPALAPA, CD. MÉX.",6,0,6,0,0,167,
03-may-19,CD. MÉX.,"TLALPAN, CD. MÉX.",4,2,6,0,0,100,
06-may-19,CHIH.,"JUÁREZ, CHIH.",4,2,6,19,0,495,
08-may-19,CD. MÉX.,"IZTAPALAPA, CD. MÉX.",3,3,6,0,0,35,
08-may-19,CD. MÉX.,"TLALPAN, CD. MÉX.",2,4,6,0,0,302,
08-may-19,CD. MÉX.,"AZCAPOTZALCO, CD. MÉX.",3,3,6,0,0,1484,
15-may-19,ZAC.,"FRESNILLO, ZAC.",3,3,6,11,0,0,
17-may-19,CHIH.,"JUÁREZ, CHIH.",6,0,6,48,0,713,
22-may-19,CD. MÉX.,"IZTAPALAPA, CD. MÉX.",6,0,6,0,1,5,
23-may-19,CD. MÉX.,"IZTAPALAPA, CD. MÉX.",1,5,6,0,0,31,
31-may-19,CD. MÉX.,"IZTAPALAPA, CD. MÉX.",6,0,6,0,0,330,
05-jun-19,CD. MÉX.,"AZCAPOTZALCO, CD. MÉX.",4,2,6,0,0,101,
06-jun-19,CD. MÉX.,"IZTAPALAPA, CD. MÉX.",4,2,6,0,0,123,
12-jun-19,CD. MÉX.,"IZTAPALAPA, CD. MÉX.",3,3,6,0,1,57,
20-jun-19,CD. MÉX.,"IZTACALCO, CD. MÉX.",5,1,6,0,3,353,
26-jun-19,CD. MÉX.,"IZTACALCO, CD. MÉX.",6,0,6,0,0,587,
28-jun-19,CHIH.,"NUEVO CASAS GRANDES, CHIH.",4,2,6,0,3,959,
31-jul-19,CD. MÉX.,"BENITO JUAREZ, CD. MÉX.",5,1,6,0,0,1271,
02-ago-19,CD. MÉX.,"CUAUHTEMOC, CD. MÉX.",6,0,6,0,0,7835,
02-ago-19,MOR.,"CUERNAVACA, MOR.",4,2,6,8,0,13,
05-ago-19,CD. MÉX.,"IZTAPALAPA, CD. MÉX.",6,0,6,0,0,27,
07-ago-19,MÉX.,"SAN MARTIN DE LAS PIRAMIDES, MEX.",5,1,6,0,0,7,
19-ago-19,MÉX.,"TLALNEPANTLA DE BAZ, MEX.",6,0,6,2,1,24,
22-ago-19,CD. MÉX.,"IZTAPALAPA, CD. MÉX.",2,4,6,2,1,401,
23-ago-19,MÉX.,"TECAMAC, MEX.",5,1,6,0,1,104,
26-ago-19,TAMPS.,"REYNOSA, TAMPS.",4,2,6,17,0,493,
27-ago-19,TAMPS.,"TAMPICO, TAMPS.",6,0,6,0,0,128,
29-ago-19,CD. MÉX.,"TLALPAN, CD. MÉX.",1,5,6,0,0,159,
02-sep-19,MÉX.,"NAUCALPAN DE JUAREZ, MEX.",4,2,6,4,0,5,
02-sep-19,MÉX.,"NEZAHUALCOYOTL, MEX.",4,2,6,2,1,762,
03-sep-19,CD. MÉX.,"TLALPAN, CD. MÉX.",6,0,6,0,0,30,
06-sep-19,CD. MÉX.,"IZTAPALAPA, CD. MÉX.",3,3,6,0,1,917,
09-sep-19,CD. MÉX.,"IZTAPALAPA, CD. MÉX.",6,0,6,0,1,238,
11-sep-19,MÉX.,"CUAUTITLAN IZCALLI, MEX.",3,3,6,0,0,1137,
12-sep-19,CD. MÉX.,"IZTAPALAPA, CD. MÉX.",4,2,6,0,0,2792,
14-sep-19,MÉX.,"CUAUTITLAN, MEX.",6,0,6,0,0,288,
17-sep-19,CD. MÉX.,"COYOACAN, CD. MÉX.",6,0,6,0,0,109,
24-sep-19,CHIS.,"TAPACHULA, CHIS.",6,0,6,2,0,232,
24-sep-19,CD. MÉX.,"IZTAPALAPA, CD. MÉX.",2,4,6,0,0,47,
11-oct-19,CD. MÉX.,"IZTACALCO, CD. MÉX.",2,4,6,0,0,0,
14-oct-19,CD. MÉX.,"IZTAPALAPA, CD. MÉX.",2,4,6,0,0,148,
21-oct-19,MÉX.,"IXTAPALUCA, MEX.",5,1,6,1,0,93,
22-oct-19,CD. MÉX.,"CUAJIMALPA DE MOR., CD. MÉX.",5,1,6,0,0,23,
23-oct-19,CD. MÉX.,"CUAJIMALPA DE MOR., CD. MÉX.",5,1,6,0,0,809,
24-oct-19,CD. MÉX.,"IZTAPALAPA, CD. MÉX.",3,3,6,0,0,146,
25-oct-19,CD. MÉX.,"IZTAPALAPA, CD. MÉX.",2,4,6,0,0,63,
26-oct-19,MÉX.,"IXTAPALUCA, MEX.",5,1,6,4,0,135,
01-nov-19,CD. MÉX.,"TLAHUAC, CD. MÉX.",0,6,6,0,0,65,
07-nov-19,CD. MÉX.,"IZTAPALAPA, CD. MÉX.",0,6,6,0,1,0,
12-nov-19,CD. MÉX.,"BENITO JUAREZ, CD. MÉX.",3,3,6,0,0,427,
14-nov-19,CHIS.,"TUXTLA GUTIÉRREZ, CHIS.",4,2,6,0,12,0,
21-nov-19,MÉX.,"VALLE DE CHALCO SOLIDARIDAD, MEX.",4,2,6,2,0,82,
25-nov-19,CD. MÉX.,"IZTAPALAPA, CD. MÉX.",0,6,6,0,0,3666,
27-nov-19,CD. MÉX.,"IZTAPALAPA, CD. MÉX.",0,6,6,0,0,0,
01-dic-19,CD. MÉX.,"IZTAPALAPA, CD. MÉX.",2,4,6,0,0,19,
28-ene-20,CD. MÉX.,"IZTAPALAPA, CD. MÉX.",5,1,6,0,0,342,
17-feb-20,CD. MÉX.,"CUAUHTEMOC, CD. MÉX.",2,4,6,0,0,97,
19-feb-20,ZAC.,"ZAC., ZAC.",6,0,6,0,0,0,
21-feb-20,CD. MÉX.,"IZTAPALAPA, CD. MÉX.",1,5,6,0,0,225,
26-feb-20,SIN.,"CHOIX, SIN.",3,3,6,0,0,0,
26-feb-20,NAY.,"TEPIC, NAY.",6,0,6,3,0,75,
28-feb-20,SIN.,"CHOIX, SIN.",3,3,6,0,0,0,
02-mar-20,CHIH.,"CHIH., CHIH.",6,0,6,0,0,0,
04-mar-20,CD. MÉX.,"IZTAPALAPA, CD. MÉX.",2,4,6,0,0,516,
05-mar-20,CD. MÉX.,"BENITO JUAREZ, CD. MÉX.",5,1,6,0,1,187,
05-mar-20,CD. MÉX.,"IZTAPALAPA, CD. MÉX.",3,3,6,0,0,0,
06-mar-20,CD. MÉX.,"IZTAPALAPA, CD. MÉX.",3,3,6,0,0,40,
12-mar-20,CD. MÉX.,"IZTAPALAPA, CD. MÉX.",3,3,6,0,0,86,
20-mar-20,VER.,"XALAPA, VER.",3,3,6,8,0,637,
25-sep-20,CD. MÉX.,"CUAUHTEMOC, CD. MÉX.",3,3,6,0,0,2320,
27-oct-20,CD. MÉX.,"TLALPAN, CD. MÉX.",1,5,6,0,0,1459,
25-nov-20,CD. MÉX.,"CUAUHTEMOC, CD. MÉX.",3,3,6,0,0,0,
09-dic-20,CD. MÉX.,"GUSTAVO A. MADERO, CD. MÉX.",0,6,6,0,0,0,
16-jul-21,COAH.,"PIEDRAS NEGRAS, COAH.",3,3,6,1,0,23,
11-nov-21,TLAX.,"ZACATELCO, TLAX.",6,0,6,0,0,0,
02-dic-21,CHIH.,"JUÁREZ, CHIH.",4,2,6,4,0,199,
08-dic-21,CHIH.,"CHIH., CHIH.",4,2,6,0,0,355,
10-dic-21,CHIH.,"JUÁREZ, CHIH.",6,0,6,1,1,908,
17-dic-21,CHIS.,"OCOZOCOAUTLA DE ESPINOSA, CHIS.",4,2,6,0,0,866,
17-dic-21,OAX.,"JUCHITAN DE ZARAGOZA, OAX.",6,0,6,0,0,122,
20-ene-22,CD. MÉX.,"MIGUEL HGO., CD. MÉX.",3,3,6,0,0,114,
11-feb-22,CD. MÉX.,"COYOACAN, CD. MÉX.",2,4,6,0,0,143,
20-abr-22,CD. MÉX.,"CUAUHTEMOC, CD. MÉX.",5,1,6,0,0,775,
22-abr-22,CD. MÉX.,"CUAUHTEMOC, CD. MÉX.",5,1,6,0,0,250,
03-may-22,S.L.P.,"SOLEDAD DE GRACIANO SANCHEZ, S.L.P.",6,0,6,0,0,0,
13-may-22,CD. MÉX.,"CUAUHTEMOC, CD. MÉX.",6,0,6,0,0,892,
19-may-22,SIN.,"EL FUERTE, SIN.",5,1,6,0,12,0,
22-may-22,SIN.,"CHOIX, SIN.",4,2,6,0,0,0,
08-jun-22,SIN.,"AHOME, SIN.",4,2,6,1,0,107,
09-jun-22,SIN.,"GUASAVE, SIN.",5,1,6,0,0,0,
20-jun-22,CD. MÉX.,"TLALPAN, CD. MÉX.",5,1,6,0,0,210,
24-jun-22,CD. MÉX.,"TLALPAN, CD. MÉX.",1,5,6,0,0,0,
30-jun-22,CD. MÉX.,"ALVARO OBREGON, CD. MÉX.",4,2,6,0,0,674,
07-jul-22,TAMPS.,"CIUDAD MADERO, TAMPS.",5,1,6,0,0,90,
12-jul-22,CD. MÉX.,"BENITO JUAREZ, CD. MÉX.",5,1,6,0,0,69,
12-jul-22,MICH.,"MORELIA, MICH.",3,3,6,0,0,42,
20-jul-22,JAL.,"TLAQUEPAQUE, JAL.",4,2,6,0,0,58,
10-ago-22,GRO.,"ACAPULCO DE JUAREZ, GRO.",1,5,6,0,0,1,
26-ago-22,MÉX.,"HUIXQUILUCAN, MEX.",2,4,6,0,0,0,
31-ago-22,MÉX.,"ATIZAPAN, MEX.",2,4,6,1,0,66,
01-sep-22,MÉX.,"CHIMALHUACAN, MEX.",4,2,6,0,0,0,
04-sep-22,ZAC.,"GUADALUPE, ZAC.",4,2,6,5,0,225,
09-sep-22,S.L.P.,"SAN LUIS POTOSI, S.L.P.",6,0,6,0,0,0,
10-sep-22,ZAC.,"FRESNILLO, ZAC.",4,2,6,35,0,818,
10-sep-22,MÉX.,"NAUCALPAN DE JUAREZ, MEX.",4,2,6,0,0,1056,
10-sep-22,MÉX.,"ECATEPEC DE MOR., MEX.",5,1,6,0,0,81,
12-sep-22,MÉX.,"ECATEPEC DE MOR., MEX.",1,5,6,1,0,859,
20-sep-22,MÉX.,"NEZAHUALCOYOTL, MEX.",5,1,6,0,0,234,
23-sep-22,MÉX.,"TLALNEPANTLA DE BAZ, MEX.",6,0,6,0,0,24,
04-oct-22,CD. MÉX.,"TLALPAN, CD. MÉX.",3,3,6,0,0,41,
05-oct-22,COAH.,"SAN JUAN DE SABINAS, COAH.",1,5,6,0,0,0,
06-oct-22,CD. MÉX.,"GUSTAVO A. MADERO, CD. MÉX.",5,1,6,0,0,220,
07-oct-22,MÉX.,"TULTEPEC, MEX.",3,3,6,0,0,50,
13-oct-22,MÉX.,"VALLE DE CHALCO SOLIDARIDAD, MEX.",3,3,6,0,0,21,
25-oct-22,MOR.,"CUAUTLA, MOR.",2,4,6,0,0,184,
25-oct-22,N.L.,"APODACA, N.L.",5,1,6,1,0,152,
25-oct-22,N.L.,"GRAL. ESCOBEDO, N.L.",5,1,6,1,0,152,
26-oct-22,N.L.,"MONTERREY, N.L.",3,3,6,1,0,0,
07-nov-22,OAX.,"SANTIAGO PINOTEPA NACIONAL, OAX.",6,0,6,8,0,145,
08-nov-22,MÉX.,"SAN MARTIN DE LAS PIRAMIDES, MEX.",6,0,6,0,0,13,
10-nov-22,MÉX.,"IXTAPALUCA, MEX.",6,0,6,0,0,79,
11-nov-22,MÉX.,"IXTAPALUCA, MEX.",6,0,6,0,0,7,
11-nov-22,CD. MÉX.,"COYOACAN, CD. MÉX.",6,0,6,0,0,629,
07-dic-22,CHIH.,"CHIH., CHIH.",4,2,6,6,0,153,
13-dic-22,SON.,"HERMOSILLO, SON.",4,2,6,1,0,400,
16-dic-22,SON.,"HERMOSILLO, SON.",5,1,6,8,1,150,
17-mar-23,Chihuahua,"CHIHUAHUA, CHIH.",5,1,6,25,0,442,
21-mar-23,México,"NAUCALPAN DE JUAREZ, MEX.",5,1,6,0,0,0,
23-mar-23,Cd. de México,"MIGUEL HIDALGO, CD. MÉX.",1,5,6,0,0,722,
24-mar-23,Cd. de México,"LA MAGDALENA CONTRERAS, CD. MÉX.",5,1,6,0,0,447,
11-abr-23,Cd. de México,"ALVARO OBREGON, CD. MÉX.",5,1,6,0,1,132,
19-abr-23,Cd. de México,"TLALPAN, CD. MÉX.",6,0,6,0,0,0,
30-abr-23,Querétaro,"CORREGIDORA, QRO.",3,3,6,0,0,31,
02-may-23,Cd. de México,"CUAUHTEMOC, CD. MÉX.",5,1,6,0,0,417,
16-may-23,Sinaloa,"CULIACAN, SIN.",5,1,6,0,0,"2,334",
31-may-23,Cd. de México,"CUAUHTEMOC, CD. MÉX.",5,1,6,0,0,137,
27-jun-23,Sinaloa,"AHOME, SIN.",3,3,6,0,0,5,
28-jun-23,Guanajuato,"SALVATIERRA, GTO.",3,3,6,17,0,230,
29-jun-23,Sinaloa,"AHOME, SIN.",5,1,6,0,1,31,
03-jul-23,Sinaloa,"GUASAVE, SIN.",2,4,6,0,0,0,
06-jul-23,Cd. de México,"CUAUHTEMOC, CD. MÉX.",4,2,6,0,0,9,
14-jul-23,México,"CHIMALHUACAN, MEX.",6,0,6,0,0,29,
01-ago-23,Cd. de México,"IZTAPALAPA, CD. MÉX.",6,0,6,0,0,"1,667",
03-ago-23,México,"HUIXQUILUCAN, MEX.",4,2,6,0,0,764,
04-ago-23,México,"HUIXQUILUCAN, MEX.",4,2,6,0,0,"1,188",
21-ago-23,Chihuahua,"JUÁREZ, CHIH.",6,0,6,6,0,120,
22-ago-23,Tabasco,"CARDENAS, TAB.",3,3,6,0,0,0,
28-ago-23,Cd. de México,"BENITO JUAREZ, CD. MÉX.",5,1,6,0,0,"1,549",
30-ago-23,Tamaulipas,"REYNOSA, TAMPS.",4,2,6,14,0,784,
19-sep-23,Puebla,"TEHUACAN, PUE.",5,1,6,0,6,315,
27-sep-23,Michoacán,"PENJAMILLO, MICH.",1,5,6,0,0,0,
05-oct-23,Sinaloa,"ROSARIO, SIN.",4,2,6,0,0,0,
05-oct-23,Chihuahua,"CHIHUAHUA, CHIH.",6,0,6,0,0,409,
23-nov-23,Cd. de México,"MILPA ALTA, CD. MÉX.",1,5,6,0,0,48,
26-dic-23,Zacatecas,"GUADALUPE, ZAC.",3,3,6,5,0,70,
13-jun-24,Veracruz,"VERACRUZ, VER.",5,1,6,31,0,367,
19-jun-24,Sinaloa,"SALVADOR ALVARADO, SIN.",4,2,6,0,0,0,
19-jun-24,Michoacán,"TURICATO, MICH.",2,4,6,15,0,80,
20-jun-24,Michoacán,"TURICATO, MICH.",1,5,6,7,0,100,
24-jun-24,Sinaloa,"BADIRAGUATO, SIN.",3,3,6,0,0,200,
25-ene-13,D.F.,"IZTAPALAPA, D.F.",4,1,5,0,0,50,
07-feb-13,D.F.,"IZTAPALAPA, D.F.",3,2,5,0,0,0,
07-feb-13,B.C.,"TIJUANA, B.C.",3,2,5,0,0,0,
09-feb-13,TAMPS.,"VICTORIA, TAMPS.",2,3,5,0,3,0,
09-feb-13,TAMPS.,"NUEVO LAREDO, TAMPS.",0,5,5,3,0,0,
12-feb-13,VER.,"COATZACOALCOS, VER.",4,1,5,0,0,15,
13-feb-13,CHIH.,"CHIH., CHIH.",4,1,5,0,0,603,
13-feb-13,B.C.,"TIJUANA, B.C.",5,0,5,0,0,0,
15-feb-13,CHIH.,"CHIH., CHIH.",4,1,5,14,5,460,
16-feb-13,JAL.,"GUADALAJARA, JAL.",5,0,5,0,0,0,
18-feb-13,D.F.,"VENUSTIANO CARRANZA, D.F.",3,2,5,0,1,0,
21-feb-13,HGO.,"TULA DE ALLENDE, HGO.",3,2,5,0,4,300,
22-feb-13,HGO.,"PACHUCA DE SOTO, HGO.",4,1,5,0,0,144,
22-feb-13,CHIH.,"CHIH., CHIH.",3,2,5,0,0,310,
23-feb-13,HGO.,"PACHUCA DE SOTO, HGO.",4,1,5,0,1,28,
25-feb-13,HGO.,"TULANCINGO DE BRAVO, HGO.",4,1,5,0,0,0,
25-feb-13,TAMPS.,"MATAMOROS, TAMPS.",2,3,5,0,0,0,
01-mar-13,TAMPS.,"CIUDAD MADERO, TAMPS.",5,0,5,0,0,0,
03-mar-13,N.L.,"MONTERREY, N.L.",3,2,5,4,1,437,
03-mar-13,N.L.,"APODACA, N.L.",1,4,5,0,1,6,
03-mar-13,N.L.,"GARCIA, N.L.",2,3,5,0,0,15,
04-mar-13,MEX.,"METEPEC, MEX.",5,0,5,3,1,262,
05-mar-13,N.L.,"GRAL. ESCOBEDO, N.L.",4,1,5,0,0,1026,
06-mar-13,HGO.,"TULANCINGO DE BRAVO, HGO.",5,0,5,0,0,200,
07-mar-13,N.L.,"SANTA CATARINA, N.L.",4,1,5,0,0,5348,
08-mar-13,N.L.,"MONTERREY, N.L.",3,2,5,17,0,705,
08-mar-13,N.L.,"APODACA, N.L.",2,3,5,0,0,755,
09-mar-13,TAMPS.,"CIUDAD MADERO, TAMPS.",5,0,5,0,0,0,
10-mar-13,N.L.,"SANTA CATARINA, N.L.",5,0,5,11,0,4131,
11-mar-13,AGS.,"AGS., AGS.",5,0,5,0,0,5,
11-mar-13,HGO.,"ACTOPAN, HGO.",4,1,5,0,1,0,
11-mar-13,HGO.,"TEPEAPULCO, HGO.",3,2,5,0,2,20,
13-mar-13,VER.,"VER., VER.",4,1,5,2,0,79,
15-mar-13,MEX.,"HUIXQUILUCAN, MEX.",4,1,5,4,0,52,
16-mar-13,HGO.,"TIZAYUCA, HGO.",3,2,5,0,2,50,
16-mar-13,TAMPS.,"CIUDAD MADERO, TAMPS.",2,3,5,12,2,130,
17-mar-13,MEX.,"NICOLAS ROMERO, MEX.",5,0,5,2,0,413,
18-mar-13,HGO.,"TIZAYUCA, HGO.",5,0,5,0,0,1200,
18-mar-13,TAMPS.,"VICTORIA, TAMPS.",2,3,5,0,0,0,
19-mar-13,N.L.,"CADEREYTA JIMENEZ, N.L.",2,3,5,1,0,119,
21-mar-13,CHIH.,"ASCENSIÓN, CHIH.",3,2,5,16,0,80,
22-mar-13,CHIH.,"CHIH., CHIH.",5,0,5,7,0,155,
22-mar-13,HGO.,"TIZAYUCA, HGO.",3,2,5,0,2,211,
22-mar-13,TAMPS.,"CIUDAD MADERO, TAMPS.",5,0,5,1,0,106,
23-mar-13,S.L.P.,"CIUDAD VALLES, S.L.P.",3,2,5,3,0,0,
25-mar-13,S.L.P.,"CIUDAD VALLES, S.L.P.",3,2,5,1,2,0,
25-mar-13,CHIH.,"ASCENSIÓN, CHIH.",2,3,5,0,0,0,
27-mar-13,N.L.,"BUSTAMANTE, N.L.",4,1,5,0,0,350,
04-abr-13,MICH.,"SALVADOR ESCALANTE, MICH.",4,1,5,0,0,0,
04-abr-13,MEX.,"VALLE DE BRAVO, MEX.",5,0,5,1,0,0,
06-abr-13,N.L.,"MONTEMOR., N.L.",4,1,5,2,0,350,
08-abr-13,N.L.,"MONTEMOR., N.L.",4,1,5,5,0,200,
08-abr-13,B.C.,"TIJUANA, B.C.",4,1,5,0,0,0,
08-abr-13,B.C.,"TIJUANA, B.C.",4,1,5,0,0,0,
08-abr-13,OAX.,"SAN JUAN BAUTISTA TUXTEPEC, OAX.",3,2,5,0,0,0,
09-abr-13,OAX.,"JUCHITAN DE ZARAGOZA, OAX.",5,0,5,2,0,0,
10-abr-13,NAY.,"TEPIC, NAY.",4,1,5,0,0,0,
10-abr-13,MEX.,"IXTAPAN DE LA SAL, MEX.",2,3,5,0,0,0,
11-abr-13,N.L.,"GALEANA, N.L.",2,3,5,4,0,0,
11-abr-13,OAX.,"SAN MIGUEL SOYALTEPEC, OAX.",5,0,5,1,0,0,
14-abr-13,OAX.,"SAN PEDRO IXCATLAN, OAX.",1,4,5,1,0,0,
14-abr-13,MEX.,"ALMOLOYA DE JUAREZ, MEX.",3,2,5,3,0,219,
15-abr-13,N.L.,"HGO., N.L.",2,3,5,0,0,100,
16-abr-13,N.L.,"ARAMBERRI, N.L.",2,3,5,2,0,0,
16-abr-13,TAMPS.,"VICTORIA, TAMPS.",5,0,5,0,0,0,
19-abr-13,B.C.,"TIJUANA, B.C.",3,2,5,0,0,0,
20-abr-13,NAY.,"ACAPONETA, NAY.",5,0,5,0,0,0,
22-abr-13,VER.,"BOCA DEL RIO, VER.",3,2,5,3,0,4,
23-abr-13,MICH.,"MARAVATIO, MICH.",3,2,5,0,0,0,
23-abr-13,MICH.,"TACAMBARO, MICH.",3,2,5,0,0,0,
24-abr-13,MICH.,"TACAMBARO, MICH.",3,2,5,0,0,0,
24-abr-13,N.L.,"SALINAS VICTORIA, N.L.",4,1,5,7,0,250,
24-abr-13,NAY.,"TEPIC, NAY.",1,4,5,0,0,0,
25-abr-13,HGO.,"HUEHUETLA, HGO.",2,3,5,0,0,0,
27-abr-13,CHIS.,"LAS MARGARITAS, CHIS.",4,1,5,0,0,0,
27-abr-13,N.L.,"GRAL. ZUAZUA, N.L.",3,2,5,1,0,150,
02-may-13,CHIS.,"FRONTERA COMALAPA, CHIS.",3,2,5,0,0,0,
02-may-13,B.C.,"MEXICALI, B.C.",2,3,5,0,0,0,
04-may-13,N.L.,"ABASOLO, N.L.",3,2,5,23,0,1450,
04-may-13,TAB.,"CARDENAS, TAB.",5,0,5,2,0,0,
07-may-13,N.L.,"HIGUERAS, N.L.",2,3,5,2,0,50,
08-may-13,N.L.,"CHINA, N.L.",2,3,5,2,0,0,
10-may-13,TAB.,"CARDENAS, TAB.",4,1,5,15,1,0,
10-may-13,B.C.,"TIJUANA, B.C.",2,3,5,0,0,0,
12-may-13,N.L.,"GRAL. BRAVO, N.L.",2,3,5,0,0,0,
12-may-13,B.C.,"MEXICALI, B.C.",2,3,5,0,0,0,
13-may-13,B.C.,"ENSENADA, B.C.",1,4,5,0,0,0,
13-may-13,B.C.,"MEXICALI, B.C.",3,2,5,0,0,0,
14-may-13,MICH.,"LAZARO CARDENAS, MICH.",3,2,5,4,0,42,
14-may-13,B.C.,"MEXICALI, B.C.",1,4,5,0,0,0,
15-may-13,MICH.,"LAZARO CARDENAS, MICH.",5,0,5,4,0,66,
16-may-13,MICH.,"HUETAMO, MICH.",3,2,5,0,0,0,
16-may-13,CHIS.,"COMITAN DE DOMÍNGUEZ, CHIS.",4,1,5,0,0,0,
18-may-13,YUC.,"KANASIN, YUC.",5,0,5,0,0,0,
19-may-13,GRO.,"BENITO JUAREZ, GRO.",3,2,5,0,0,0,
20-may-13,N.L.,"AGUALEGUAS, N.L.",3,2,5,8,0,335,
20-may-13,CHIH.,"GALEANA, CHIH.",4,1,5,0,0,0,
21-may-13,SIN.,"SALVADOR ALVARADO, SIN.",4,1,5,0,4,0,
22-may-13,COAH.,"TORREÓN, COAH.",4,1,5,0,0,0,
23-may-13,MICH.,"ZITACUARO, MICH.",3,2,5,1,0,0,
26-may-13,MICH.,"ZITACUARO, MICH.",4,1,5,1,0,0,
28-may-13,S.L.P.,"SAN LUIS POTOSI, S.L.P.",4,1,5,0,0,0,
28-may-13,MICH.,"ZITACUARO, MICH.",4,1,5,3,0,0,
29-may-13,N.L.,"DR. ARROYO, N.L.",4,1,5,1,0,0,
30-may-13,SIN.,"SALVADOR ALVARADO, SIN.",4,1,5,0,7,0,
30-may-13,OAX.,"MIAHUATLAN DE PORFIRIO DIAZ, OAX.",1,4,5,20,0,532,
31-may-13,MICH.,"LAZARO CARDENAS, MICH.",5,0,5,0,0,0,
01-jun-13,B.C.,"TIJUANA, B.C.",0,5,5,0,0,0,
04-jun-13,COAH.,"TORREÓN, COAH.",5,0,5,0,0,106,
06-jun-13,COAH.,"TORREÓN, COAH.",5,0,5,0,0,0,
06-jun-13,MICH.,"BUENAVISTA, MICH.",2,3,5,0,0,0,
10-jun-13,COAH.,"TORREÓN, COAH.",5,0,5,0,0,0,
13-jun-13,MICH.,"BUENAVISTA, MICH.",3,2,5,0,0,0,
15-jun-13,NAY.,"RUIZ, NAY.",5,0,5,0,0,0,
17-jun-13,NAY.,"RUIZ, NAY.",3,2,5,1,0,0,
18-jun-13,NAY.,"RUIZ, NAY.",4,1,5,0,0,0,
18-jun-13,B.C.,"TIJUANA, B.C.",2,3,5,0,0,0,
19-jun-13,NAY.,"RUIZ, NAY.",5,0,5,0,0,0,
19-jun-13,TAMPS.,"VICTORIA, TAMPS.",5,0,5,0,0,0,
20-jun-13,SIN.,"BADIRAGUATO, SIN.",4,1,5,0,0,0,
20-jun-13,COAH.,"LAMADRID, COAH.",3,2,5,0,0,79,
21-jun-13,SIN.,"BADIRAGUATO, SIN.",5,0,5,2,0,0,
23-jun-13,JAL.,"PUERTO VALLARTA, JAL.",5,0,5,1,0,4,
24-jun-13,COAH.,"TORREÓN, COAH.",2,3,5,0,3,0,
25-jun-13,B.C.,"TIJUANA, B.C.",0,5,5,0,0,0,
26-jun-13,COAH.,"TORREÓN, COAH.",4,1,5,0,0,0,
26-jun-13,COAH.,"NADADORES, COAH.",4,1,5,0,0,72,
27-jun-13,B.C.,"TIJUANA, B.C.",3,2,5,0,0,0,
28-jun-13,PUE.,"TEHUACAN, PUE.",4,1,5,0,0,0,
30-jun-13,MEX.,"NAUCALPAN DE JUAREZ, MEX.",2,3,5,3,1,174,
01-jul-13,CHIS.,"CHICOMUSELO, CHIS.",3,2,5,0,0,0,
01-jul-13,MEX.,"NAUCALPAN DE JUAREZ, MEX.",4,1,5,5,2,3,
03-jul-13,B.C.,"TIJUANA, B.C.",3,2,5,0,0,0,
05-jul-13,SIN.,"NAVOLATO, SIN.",3,2,5,0,0,0,
08-jul-13,MEX.,"NAUCALPAN DE JUAREZ, MEX.",2,3,5,0,0,0,
11-jul-13,CHIS.,"MAZATÁN, CHIS.",1,4,5,0,0,0,
13-jul-13,MEX.,"NAUCALPAN DE JUAREZ, MEX.",1,4,5,0,1,0,
13-jul-13,MOR.,"CUERNAVACA, MOR.",3,2,5,0,1,360,
14-jul-13,MEX.,"NAUCALPAN DE JUAREZ, MEX.",2,3,5,0,0,0,
15-jul-13,MOR.,"CUERNAVACA, MOR.",2,3,5,0,1,20,
16-jul-13,B.C.,"TECATE, B.C.",5,0,5,0,0,0,
16-jul-13,N.L.,"APODACA, N.L.",2,3,5,0,0,483,
18-jul-13,B.C.,"TECATE, B.C.",0,5,5,0,0,0,
18-jul-13,COAH.,"TORREÓN, COAH.",3,2,5,0,0,0,
19-jul-13,CHIH.,"MADERA, CHIH.",1,4,5,7,0,0,
19-jul-13,CHIS.,"ESCUINTLA, CHIS.",4,1,5,3,0,0,
21-jul-13,MOR.,"CUERNAVACA, MOR.",1,4,5,0,1,60,
21-jul-13,B.C.,"MEXICALI, B.C.",4,1,5,0,0,0,
22-jul-13,B.C.,"MEXICALI, B.C.",4,1,5,0,0,0,
22-jul-13,QRO.,"QUERETARO, QRO.",1,4,5,0,1,0,
25-jul-13,B.C.,"MEXICALI, B.C.",1,4,5,0,0,0,
27-jul-13,PUE.,"SAN MARTIN TEXMELUCAN, PUE.",3,2,5,0,0,0,
29-jul-13,MOR.,"PUENTE DE IXTLA, MOR.",2,3,5,0,0,25,
30-jul-13,CHIS.,"TUXTLA GUTIÉRREZ, CHIS.",2,3,5,2,1,379,
30-jul-13,B.C.,"TIJUANA, B.C.",3,2,5,0,0,0,
02-ago-13,SIN.,"COSALA, SIN.",3,2,5,0,2,0,
02-ago-13,COAH.,"TORREÓN, COAH.",5,0,5,0,0,0,
05-ago-13,N.L.,"GUADALUPE, N.L.",2,3,5,0,0,238,
07-ago-13,B.C.,"MEXICALI, B.C.",2,3,5,0,2,0,
08-ago-13,HGO.,"PACHUCA DE SOTO, HGO.",4,1,5,0,0,0,
09-ago-13,CHIH.,"ASCENSIÓN, CHIH.",2,3,5,0,0,0,
09-ago-13,N.L.,"SANTA CATARINA, N.L.",4,1,5,5,0,600,
09-ago-13,B.C.,"TIJUANA, B.C.",1,4,5,0,0,0,
09-ago-13,TAMPS.,"REYNOSA, TAMPS.",2,3,5,4,0,0,
12-ago-13,HGO.,"PACHUCA DE SOTO, HGO.",4,1,5,0,0,0,
12-ago-13,TLAX.,"TLAX., TLAX.",4,1,5,2,0,32,
13-ago-13,JAL.,"GUADALAJARA, JAL.",4,1,5,0,0,0,
15-ago-13,TLAX.,"TLAX., TLAX.",3,2,5,0,0,5,
16-ago-13,JAL.,"TONALA, JAL.",5,0,5,2,0,54,
17-ago-13,N.L.,"SAN NICOLAS DE LOS GARZA, N.L.",3,2,5,28,0,50,
19-ago-13,B.C.,"TIJUANA, B.C.",5,0,5,0,0,0,
19-ago-13,AGS.,"AGS., AGS.",5,0,5,1,0,390,
20-ago-13,TLAX.,"PANOTLA, TLAX.",1,4,5,1,0,0,
21-ago-13,AGS.,"AGS., AGS.",5,0,5,1,0,46,
22-ago-13,B.C.,"TIJUANA, B.C.",4,1,5,0,0,0,
23-ago-13,SIN.,"MAZATLAN, SIN.",5,0,5,0,2,0,
23-ago-13,YUC.,"TEKAL DE VENEGAS, YUC.",2,3,5,0,0,0,
26-ago-13,B.C.,"MEXICALI, B.C.",2,3,5,0,0,0,
26-ago-13,SIN.,"MAZATLAN, SIN.",3,2,5,0,0,0,
27-ago-13,B.C.,"MEXICALI, B.C.",5,0,5,0,0,0,
28-ago-13,PUE.,"ATLIXCO, PUE.",2,3,5,0,0,0,
29-ago-13,TLAX.,"TLAX., TLAX.",2,3,5,0,0,34,
30-ago-13,GTO.,"SAN FRANCISCO DEL RINCON, GTO.",3,2,5,0,0,0,
03-sep-13,MOR.,"XOCHITEPEC, MOR.",4,1,5,0,8,236,
06-sep-13,B.C.,"TIJUANA, B.C.",2,3,5,0,0,0,
10-sep-13,B.C.,"TIJUANA, B.C.",2,3,5,0,0,0,
11-sep-13,SON.,"SAN LUIS RIO COLORADO, SON.",4,1,5,0,0,0,
12-sep-13,SON.,"SAN LUIS RIO COLORADO, SON.",3,2,5,3,0,46,
18-sep-13,SON.,"SAN LUIS RIO COLORADO, SON.",0,5,5,5,0,4,
19-sep-13,SON.,"SAN LUIS RIO COLORADO, SON.",2,3,5,0,0,0,
24-sep-13,SON.,"SAN LUIS RIO COLORADO, SON.",1,4,5,2,2,0,
26-sep-13,B.C.,"TIJUANA, B.C.",3,2,5,0,0,0,
26-sep-13,B.C.,"ENSENADA, B.C.",2,3,5,0,0,0,
27-sep-13,ZAC.,"TLALTENANGO DE SANCHEZ ROMAN, ZAC.",5,0,5,3,0,26,
27-sep-13,ZAC.,"FRESNILLO, ZAC.",4,1,5,0,0,72,
28-sep-13,ZAC.,"TLALTENANGO DE SANCHEZ ROMAN, ZAC.",5,0,5,0,0,0,
04-oct-13,ZAC.,"GUADALUPE, ZAC.",5,0,5,0,0,125,
04-oct-13,ZAC.,"JEREZ, ZAC.",4,1,5,2,0,30,
07-oct-13,COAH.,"MONCLOVA, COAH.",4,1,5,0,1,88,
08-oct-13,YUC.,"UMAN, YUC.",4,1,5,0,0,0,
08-oct-13,ZAC.,"JEREZ, ZAC.",5,0,5,0,0,100,
08-oct-13,COAH.,"SALTILLO, COAH.",4,1,5,0,0,35,
08-oct-13,COAH.,"SABINAS, COAH.",4,1,5,0,0,190,
09-oct-13,ZAC.,"FRESNILLO, ZAC.",5,0,5,1,0,124,
09-oct-13,COAH.,"MONCLOVA, COAH.",4,1,5,3,1,434,
10-oct-13,ZAC.,"FRESNILLO, ZAC.",4,1,5,2,1,138,
10-oct-13,SIN.,"ESCUINAPA, SIN.",2,3,5,0,0,0,
12-oct-13,OAX.,"SANTA MARIA MIXTEQUILLA, OAX.",0,5,5,0,0,36,
15-oct-13,COAH.,"SABINAS, COAH.",2,3,5,0,0,85,
15-oct-13,ZAC.,"VALPARAISO, ZAC.",4,1,5,3,0,0,
16-oct-13,HGO.,"TULANCINGO DE BRAVO, HGO.",5,0,5,0,0,0,
16-oct-13,AGS.,"AGS., AGS.",4,1,5,1,0,0,
16-oct-13,SIN.,"CONCORDIA, SIN.",2,3,5,0,0,0,
18-oct-13,AGS.,"AGS., AGS.",5,0,5,79,0,0,
18-oct-13,ZAC.,"FRESNILLO, ZAC.",4,1,5,0,0,106,
25-oct-13,COAH.,"MÚZQUIZ, COAH.",3,2,5,0,0,0,
29-oct-13,COAH.,"RAMOS ARIZPE, COAH.",4,1,5,0,0,0,
29-oct-13,B.C.,"TIJUANA, B.C.",1,4,5,0,0,0,
29-oct-13,B.C.,"MEXICALI, B.C.",2,3,5,0,0,0,
26-nov-13,CHIH.,"CHIH., CHIH.",2,3,5,8,0,33,
26-nov-13,COAH.,"SALTILLO, COAH.",2,3,5,0,0,5,
02-dic-13,SON.,"PUERTO PEÑASCO, SON.",1,4,5,1,0,74,
04-dic-13,COAH.,"PIEDRAS NEGRAS, COAH.",2,3,5,2,0,126,
04-dic-13,COAH.,"FRONTERA, COAH.",2,3,5,1,0,0,
06-dic-13,TAMPS.,"CIUDAD MADERO, TAMPS.",4,1,5,3,0,183,
06-dic-13,SON.,"GENERAL PLUTARCO ELIAS CALLES, SON.",5,0,5,1,2,100,
10-dic-13,SON.,"CAJEME, SON.",4,1,5,1,0,0,
15-dic-13,TAMPS.,"REYNOSA, TAMPS.",3,2,5,0,0,0,
16-dic-13,D.F.,"CUAUHTEMOC, D.F.",5,0,5,0,0,0,
16-dic-13,COAH.,"MONCLOVA, COAH.",5,0,5,0,0,143,
17-dic-13,PUE.,"ATLIXCO, PUE.",3,2,5,0,0,0,
09-ene-14,TAMPS.,"NUEVO LAREDO, TAMPS.",0,5,5,27,0,1471,
23-ene-14,S.L.P.,"CIUDAD VALLES, S.L.P.",5,0,5,0,0,0,
25-ene-14,S.L.P.,"SAN LUIS POTOSI, S.L.P.",5,0,5,0,0,0,
29-ene-14,S.L.P.,"SAN LUIS POTOSI, S.L.P.",3,2,5,0,0,0,
03-feb-14,COAH.,"PIEDRAS NEGRAS, COAH.",1,4,5,0,0,0,
12-feb-14,MICH.,"LAZARO CARDENAS, MICH.",4,1,5,2,0,1,
14-feb-14,COAH.,"PIEDRAS NEGRAS, COAH.",0,5,5,0,0,0,
17-feb-14,COAH.,"PIEDRAS NEGRAS, COAH.",4,1,5,0,0,180,
20-feb-14,CHIH.,"JUÁREZ, CHIH.",4,1,5,0,0,0,
25-feb-14,PUE.,"PUE., PUE.",3,2,5,3,0,28,
26-feb-14,S.L.P.,"CIUDAD VALLES, S.L.P.",5,0,5,4,0,84,
07-mar-14,TAMPS.,"MATAMOROS, TAMPS.",3,2,5,1,0,61,
10-mar-14,VER.,"ZONGOLICA, VER.",2,3,5,0,0,0,
12-mar-14,N.L.,"MONTERREY, N.L.",4,1,5,15,0,1940,
15-mar-14,N.L.,"MONTERREY, N.L.",4,1,5,74,0,650,
18-mar-14,VER.,"IGNACIO DE LA LLAVE, VER.",0,5,5,0,0,0,
18-mar-14,B.C.,"TIJUANA, B.C.",4,1,5,0,0,0,
19-mar-14,VER.,"IGNACIO DE LA LLAVE, VER.",2,3,5,0,0,0,
20-mar-14,B.C.,"MEXICALI, B.C.",3,2,5,0,0,0,
20-mar-14,ZAC.,"SOMBRERETE, ZAC.",4,1,5,3,0,0,
20-mar-14,N.L.,"SAN NICOLAS DE LOS GARZA, N.L.",0,5,5,2,0,66,
26-mar-14,B.C.,"TIJUANA, B.C.",3,2,5,0,0,0,
28-mar-14,CHIH.,"OJINAGA, CHIH.",3,2,5,0,0,0,
28-mar-14,CHIS.,"TUXTLA GUTIÉRREZ, CHIS.",3,2,5,5,0,1876,
30-mar-14,OAX.,"OAX. DE JUAREZ, OAX.",4,1,5,1,0,1,
31-mar-14,B.C.,"TIJUANA, B.C.",2,3,5,0,0,0,
01-abr-14,JAL.,"TLAQUEPAQUE, JAL.",5,0,5,0,0,0,
01-abr-14,B.C.,"MEXICALI, B.C.",4,1,5,0,0,0,
01-abr-14,MEX.,"COACALCO DE BERRIOZABAL, MEX.",4,1,5,0,0,0,
02-abr-14,JAL.,"TLAQUEPAQUE, JAL.",4,1,5,0,0,0,
02-abr-14,MEX.,"NICOLAS ROMERO, MEX.",4,1,5,0,1,0,
02-abr-14,N.L.,"GUADALUPE, N.L.",2,3,5,0,0,400,
02-abr-14,PUE.,"IZUCAR DE MATAMOROS, PUE.",1,4,5,0,0,0,
03-abr-14,OAX.,"LOMA BONITA, OAX.",4,1,5,2,0,3,
04-abr-14,MEX.,"NICOLAS ROMERO, MEX.",5,0,5,6,0,7,
04-abr-14,HGO.,"MIXQUIAHUALA DE JUAREZ, HGO.",5,0,5,0,0,0,
04-abr-14,N.L.,"GUADALUPE, N.L.",4,1,5,7,3,350,
04-abr-14,MEX.,"COACALCO DE BERRIOZABAL, MEX.",4,1,5,0,2,21,
05-abr-14,B.C.,"MEXICALI, B.C.",2,3,5,0,0,0,
09-abr-14,MEX.,"CUAUTITLAN, MEX.",5,0,5,0,2,0,
10-abr-14,B.C.,"ENSENADA, B.C.",1,4,5,0,0,0,
11-abr-14,N.L.,"GUADALUPE, N.L.",3,2,5,1,0,50,
12-abr-14,OAX.,"SANTA MARIA COLOTEPEC, OAX.",3,2,5,0,0,0,
14-abr-14,B.C.,"TIJUANA, B.C.",3,2,5,0,0,0,
16-abr-14,JAL.,"ZAPOPAN, JAL.",4,1,5,0,0,0,
17-abr-14,MEX.,"NAUCALPAN DE JUAREZ, MEX.",5,0,5,3,0,0,
18-abr-14,CHIS.,"ACACOYAGUA, CHIS.",3,2,5,0,0,154,
21-abr-14,MEX.,"OCOYOACAC, MEX.",5,0,5,0,0,68,
21-abr-14,N.L.,"APODACA, N.L.",2,3,5,5,0,200,
23-abr-14,MEX.,"HUIXQUILUCAN, MEX.",4,1,5,0,0,6,
24-abr-14,MEX.,"NAUCALPAN DE JUAREZ, MEX.",4,1,5,0,2,16,
25-abr-14,JAL.,"ZAPOPAN, JAL.",4,1,5,0,0,0,
25-abr-14,MEX.,"ECATEPEC DE MOR., MEX.",3,2,5,0,3,0,
29-abr-14,SIN.,"GUASAVE, SIN.",3,2,5,0,0,0,
30-abr-14,MEX.,"NAUCALPAN DE JUAREZ, MEX.",4,1,5,0,0,0,
01-may-14,SIN.,"GUASAVE, SIN.",3,2,5,0,0,0,
02-may-14,OAX.,"MIAHUATLAN DE PORFIRIO DIAZ, OAX.",4,1,5,5,0,0,
03-may-14,CHIS.,"SAN CRISTOBAL DE LAS CASAS, CHIS.",3,2,5,0,0,0,
04-may-14,CHIS.,"SAN CRISTOBAL DE LAS CASAS, CHIS.",2,3,5,0,0,0,
07-may-14,B.C.,"TIJUANA, B.C.",2,3,5,0,0,0,
07-may-14,MEX.,"TENANCINGO, MEX.",3,2,5,0,0,0,
07-may-14,SIN.,"GUASAVE, SIN.",3,2,5,0,0,0,
08-may-14,MEX.,"TENANCINGO, MEX.",5,0,5,0,0,0,
09-may-14,B.C.,"TIJUANA, B.C.",3,2,5,0,0,0,
10-may-14,TAMPS.,"MATAMOROS, TAMPS.",0,5,5,0,0,0,
13-may-14,SIN.,"MOCORITO, SIN.",4,1,5,0,0,0,
14-may-14,MEX.,"NAUCALPAN DE JUAREZ, MEX.",4,1,5,2,0,0,
14-may-14,OAX.,"OAX. DE JUAREZ, OAX.",0,5,5,0,0,0,
14-may-14,N.L.,"ANAHUAC, N.L.",0,5,5,1,0,100,
15-may-14,SIN.,"MOCORITO, SIN.",4,1,5,0,3,0,
15-may-14,MEX.,"NAUCALPAN DE JUAREZ, MEX.",5,0,5,2,0,40,
17-may-14,MEX.,"TENANGO DEL VALLE, MEX.",2,3,5,0,0,0,
21-may-14,N.L.,"LINARES, N.L.",3,2,5,0,0,15,
21-may-14,MEX.,"ACOLMAN, MEX.",2,3,5,0,1,0,
23-may-14,SIN.,"MOCORITO, SIN.",1,4,5,0,0,0,
23-may-14,MEX.,"TIANGUISTENCO, MEX.",4,1,5,0,0,0,
23-may-14,N.L.,"LINARES, N.L.",4,1,5,0,0,148,
24-may-14,MEX.,"TULTEPEC, MEX.",4,1,5,0,2,41,
25-may-14,N.L.,"JUAREZ, N.L.",3,2,5,6,0,30,
26-may-14,MEX.,"TOLUCA, MEX.",4,1,5,0,0,0,
26-may-14,SIN.,"BADIRAGUATO, SIN.",1,4,5,0,0,0,
27-may-14,CHIH.,"CHIH., CHIH.",3,2,5,3,1,486,
28-may-14,OAX.,"OAX. DE JUAREZ, OAX.",1,4,5,1,0,0,
29-may-14,OAX.,"OAX. DE JUAREZ, OAX.",2,3,5,2,0,0,
30-may-14,OAX.,"OAX. DE JUAREZ, OAX.",1,4,5,0,0,0,
30-may-14,MEX.,"HUIXQUILUCAN, MEX.",3,2,5,0,0,0,
02-jun-14,MEX.,"HUEYPOXTLA, MEX.",2,3,5,0,0,0,
05-jun-14,OAX.,"OAX. DE JUAREZ, OAX.",0,5,5,0,0,0,
10-jun-14,MEX.,"JILOTEPEC, MEX.",1,4,5,0,0,11,
12-jun-14,MEX.,"JILOTEPEC, MEX.",3,2,5,0,0,0,
13-jun-14,NAY.,"ACAPONETA, NAY.",2,3,5,0,0,0,
16-jun-14,N.L.,"LOS ALDAMAS, N.L.",0,5,5,10,0,0,
16-jun-14,NAY.,"ACAPONETA, NAY.",3,2,5,0,0,0,
17-jun-14,N.L.,"LOS ALDAMAS, N.L.",1,4,5,5,0,920,
17-jun-14,MEX.,"TULTITLAN, MEX.",2,3,5,0,0,0,
20-jun-14,B.C.,"TIJUANA, B.C.",3,2,5,0,0,0,
24-jun-14,NAY.,"ACAPONETA, NAY.",3,2,5,0,0,0,
26-jun-14,SIN.,"SIN., SIN.",2,3,5,0,0,0,
30-jun-14,SIN.,"NAVOLATO, SIN.",2,3,5,0,3,0,
30-jun-14,B.C.,"TIJUANA, B.C.",2,3,5,0,0,0,
09-jul-14,Q. ROO,"OTHON P. BLANCO, Q. ROO",4,1,5,0,0,118,
15-jul-14,QRO.,"QUERETARO, QRO.",0,5,5,0,3,0,
17-jul-14,QRO.,"QUERETARO, QRO.",0,5,5,0,3,0,
17-jul-14,QRO.,"QUERETARO, QRO.",5,0,5,0,7,0,
23-jul-14,COAH.,"MONCLOVA, COAH.",3,2,5,0,0,0,
26-jul-14,AGS.,"EL LLANO, AGS.",3,2,5,2,0,12,
01-ago-14,COAH.,"PIEDRAS NEGRAS, COAH.",5,0,5,0,0,0,
03-ago-14,CHIH.,"JUÁREZ, CHIH.",4,1,5,0,0,0,
05-ago-14,B.C.,"TIJUANA, B.C.",4,1,5,0,0,0,
14-ago-14,B.C.,"TECATE, B.C.",1,4,5,0,0,0,
15-ago-14,N.L.,"MONTERREY, N.L.",4,1,5,54,0,2220,
19-ago-14,PUE.,"PUE., PUE.",5,0,5,0,0,93,
28-ago-14,SIN.,"ROSARIO, SIN.",5,0,5,0,0,0,
28-ago-14,TAMPS.,"REYNOSA, TAMPS.",3,2,5,0,8,104,
29-ago-14,MICH.,"TACAMBARO, MICH.",3,2,5,1,0,0,
01-sep-14,MICH.,"MORELIA, MICH.",3,2,5,0,0,0,
04-sep-14,MICH.,"APATZINGAN, MICH.",4,1,5,3,0,525,
04-sep-14,COAH.,"SALTILLO, COAH.",2,3,5,0,0,132,
05-sep-14,MICH.,"BUENAVISTA, MICH.",4,1,5,0,0,2942,
14-sep-14,N.L.,"CADEREYTA JIMENEZ, N.L.",5,0,5,0,0,0,
18-sep-14,MICH.,"JIQUILPAN, MICH.",4,1,5,4,0,3,
20-sep-14,MICH.,"VISTA HERMOSA, MICH.",1,4,5,0,0,19,
23-sep-14,AGS.,"AGS., AGS.",5,0,5,0,0,0,
01-oct-14,SIN.,"ELOTA, SIN.",1,4,5,0,0,0,
02-oct-14,SIN.,"ESCUINAPA, SIN.",5,0,5,0,0,0,
04-oct-14,MICH.,"URUAPAN, MICH.",4,1,5,0,0,147,
04-oct-14,MICH.,"HUETAMO, MICH.",3,2,5,3,0,0,
07-oct-14,SIN.,"ESCUINAPA, SIN.",3,2,5,0,1,0,
07-oct-14,MICH.,"TIQUICHEO DE NICOLAS ROMERO, MICH.",4,1,5,1,0,0,
07-oct-14,AGS.,"AGS., AGS.",4,1,5,5,0,166,
07-oct-14,SON.,"AGUA PRIETA, SON.",4,1,5,0,0,0,
08-oct-14,SON.,"GUAYMAS, SON.",4,1,5,1,0,167,
08-oct-14,SON.,"NAVOJOA, SON.",4,1,5,0,0,79,
08-oct-14,AGS.,"AGS., AGS.",5,0,5,1,0,192,
08-oct-14,MICH.,"URUAPAN, MICH.",1,4,5,4,0,3034,
08-oct-14,SON.,"NOGALES, SON.",3,2,5,1,0,41,
08-oct-14,SON.,"CANANEA, SON.",3,2,5,0,0,275,
09-oct-14,SIN.,"ESCUINAPA, SIN.",3,2,5,0,0,0,
09-oct-14,SON.,"NOGALES, SON.",5,0,5,2,1,76,
10-oct-14,SON.,"HERMOSILLO, SON.",5,0,5,0,0,1977,
11-oct-14,SON.,"NOGALES, SON.",3,2,5,2,0,127,
11-oct-14,MOR.,"CUERNAVACA, MOR.",4,1,5,3,2,292,
13-oct-14,TLAX.,"TLAX., TLAX.",3,2,5,2,0,2,
13-oct-14,SON.,"ALTAR, SON.",2,3,5,1,0,0,
14-oct-14,SIN.,"CONCORDIA, SIN.",5,0,5,0,0,0,
15-oct-14,SON.,"HERMOSILLO, SON.",5,0,5,63,0,20,
15-oct-14,SON.,"CAJEME, SON.",4,1,5,1,0,0,
16-oct-14,SON.,"CABORCA, SON.",4,1,5,0,0,0,
16-oct-14,SON.,"SAN LUIS RIO COLORADO, SON.",1,4,5,2,0,75,
17-oct-14,SON.,"NOGALES, SON.",4,1,5,1,0,98,
18-oct-14,CHIS.,"SAN CRISTOBAL DE LAS CASAS, CHIS.",1,4,5,0,0,9,
18-oct-14,SON.,"NOGALES, SON.",4,1,5,1,0,98,
18-oct-14,SON.,"SAN LUIS RIO COLORADO, SON.",5,0,5,0,0,0,
19-oct-14,MOR.,"CUERNAVACA, MOR.",5,0,5,0,2,174,
19-oct-14,CHIS.,"TAPACHULA, CHIS.",4,1,5,0,0,572,
20-oct-14,SON.,"NOGALES, SON.",4,1,5,3,0,153,
20-oct-14,CHIS.,"SAN CRISTOBAL DE LAS CASAS, CHIS.",4,1,5,0,0,0,
21-oct-14,SON.,"CABORCA, SON.",3,2,5,10,0,0,
21-oct-14,SON.,"SAN LUIS RIO COLORADO, SON.",2,3,5,1,0,53,
22-oct-14,MICH.,"PATZCUARO, MICH.",4,1,5,1,0,0,
22-oct-14,CHIS.,"OCOZOCOAUTLA DE ESPINOSA, CHIS.",3,2,5,1,0,6,
24-oct-14,SON.,"NAVOJOA, SON.",5,0,5,1,0,0,
24-oct-14,MOR.,"CUERNAVACA, MOR.",4,1,5,0,1,311,
26-oct-14,CHIS.,"OCOZOCOAUTLA DE ESPINOSA, CHIS.",4,1,5,0,0,461,
28-oct-14,CHIS.,"SAN CRISTOBAL DE LAS CASAS, CHIS.",2,3,5,0,0,0,
28-oct-14,MICH.,"TACAMBARO, MICH.",3,2,5,0,0,280,
28-oct-14,SIN.,"EL FUERTE, SIN.",1,4,5,0,0,0,
28-oct-14,CHIS.,"TONALÁ, CHIS.",2,3,5,20,1,1463,
29-oct-14,MICH.,"APATZINGAN, MICH.",1,4,5,3,0,750,
30-oct-14,CHIS.,"TONALÁ, CHIS.",3,2,5,2,0,311,
31-oct-14,CHIS.,"TONALÁ, CHIS.",3,2,5,0,0,333,
31-oct-14,SON.,"NAVOJOA, SON.",2,3,5,4,0,710,
01-nov-14,SON.,"NOGALES, SON.",3,2,5,1,0,43,
04-nov-14,CHIS.,"VILLAFLORES, CHIS.",4,1,5,0,0,83,
06-nov-14,CHIS.,"TAPACHULA, CHIS.",2,3,5,1,1,541,
06-nov-14,CHIS.,"TAPACHULA, CHIS.",2,3,5,1,1,541,
06-nov-14,AGS.,"AGS., AGS.",4,1,5,2,0,4,
07-nov-14,CHIS.,"VILLAFLORES, CHIS.",3,2,5,0,0,0,
08-nov-14,CHIS.,"VILLAFLORES, CHIS.",4,1,5,0,0,0,
08-nov-14,N.L.,"CADEREYTA JIMENEZ, N.L.",3,2,5,11,0,992,
14-nov-14,SIN.,"SALVADOR ALVARADO, SIN.",4,1,5,0,0,0,
19-nov-14,SIN.,"CHOIX, SIN.",3,2,5,0,0,0,
20-nov-14,SIN.,"SALVADOR ALVARADO, SIN.",3,2,5,0,4,0,
20-nov-14,SIN.,"MAZATLAN, SIN.",5,0,5,0,2,0,
05-dic-14,N.L.,"MONTERREY, N.L.",2,3,5,4,0,936,
06-dic-14,N.L.,"ANAHUAC, N.L.",1,4,5,1,0,300,
12-dic-14,N.L.,"MONTERREY, N.L.",4,1,5,10,0,1350,
25-dic-14,DGO.,"LERDO, DGO.",1,4,5,0,0,0,
27-dic-14,DGO.,"GOMEZ PALACIO, DGO.",3,2,5,0,0,0,
29-dic-14,DGO.,"LERDO, DGO.",3,2,5,0,0,0,
14-ene-15,DGO.,"DGO., DGO.",4,1,5,0,0,0,
24-ene-15,DGO.,"DGO., DGO.",5,0,5,3,0,0,
30-ene-15,CHIS.,"BENEMÉRITO DE LAS AMÉRICAS, CHIS.",3,2,5,0,0,0,
04-feb-15,B.C.,"MEXICALI, B.C.",1,4,5,0,0,0,
17-feb-15,B.C.,"ENSENADA, B.C.",3,2,5,0,0,0,
21-feb-15,B.C.,"TIJUANA, B.C.",2,3,5,0,0,0,
24-feb-15,COAH.,"ACUÑA, COAH.",3,2,5,0,0,0,
02-mar-15,HGO.,"CHAPULHUACAN, HGO.",4,1,5,0,0,0,
11-mar-15,OAX.,"OAX. DE JUAREZ, OAX.",2,3,5,4,0,0,
11-mar-15,DGO.,"GOMEZ PALACIO, DGO.",5,0,5,0,0,0,
13-mar-15,OAX.,"MIAHUATLAN DE PORFIRIO DIAZ, OAX.",4,1,5,0,0,0,
17-mar-15,CAMP.,"CAMP., CAMP.",3,2,5,0,0,0,
17-mar-15,YUC.,"XOCCHEL, YUC.",1,4,5,6,0,70,
18-mar-15,CAMP.,"CAMP., CAMP.",3,2,5,0,0,0,
26-mar-15,DGO.,"GOMEZ PALACIO, DGO.",3,2,5,0,0,0,
27-mar-15,DGO.,"GOMEZ PALACIO, DGO.",0,5,5,0,0,0,
28-mar-15,DGO.,"LERDO, DGO.",5,0,5,0,5,0,
03-ago-15,MEX.,"METEPEC, MEX.",3,2,5,2,0,0,
05-ago-15,OAX.,"OAX. DE JUAREZ, OAX.",0,5,5,0,0,0,
05-ago-15,PUE.,"PUE., PUE.",4,1,5,0,0,94,
08-ago-15,PUE.,"PUE., PUE.",5,0,5,1,0,216,
10-ago-15,SIN.,"SALVADOR ALVARADO, SIN.",2,3,5,0,0,0,
10-ago-15,TLAX.,"APIZACO, TLAX.",4,1,5,0,0,0,
13-ago-15,COAH.,"PIEDRAS NEGRAS, COAH.",4,1,5,21,0,263,
13-ago-15,COAH.,"SABINAS, COAH.",2,3,5,0,0,0,
13-ago-15,MEX.,"ZUMPANGO, MEX.",5,0,5,1,0,0,
13-ago-15,SIN.,"SALVADOR ALVARADO, SIN.",4,1,5,0,1,0,
14-ago-15,DGO.,"DGO., DGO.",5,0,5,4,0,0,
14-ago-15,MEX.,"AMECAMECA, MEX.",5,0,5,0,0,0,
14-ago-15,COAH.,"TORREÓN, COAH.",2,3,5,0,0,0,
18-ago-15,TAB.,"CENTRO, TAB.",2,3,5,0,0,29,
18-ago-15,SIN.,"SALVADOR ALVARADO, SIN.",5,0,5,0,0,0,
18-ago-15,MEX.,"CUAUTITLAN IZCALLI, MEX.",5,0,5,0,1,0,
19-ago-15,SIN.,"SALVADOR ALVARADO, SIN.",4,1,5,0,0,0,
19-ago-15,CHIH.,"HGO. DEL PARRAL, CHIH.",5,0,5,30,0,0,
20-ago-15,SIN.,"SALVADOR ALVARADO, SIN.",4,1,5,0,0,0,
20-ago-15,COAH.,"PIEDRAS NEGRAS, COAH.",1,4,5,0,0,0,
20-ago-15,COAH.,"MONCLOVA, COAH.",4,1,5,3,1,57,
22-ago-15,TLAX.,"CALPULALPAN, TLAX.",1,4,5,0,0,0,
22-ago-15,MEX.,"CUAUTITLAN, MEX.",5,0,5,0,0,0,
25-ago-15,QRO.,"CORREGIDORA, QRO.",2,3,5,0,0,0,
25-ago-15,SIN.,"SALVADOR ALVARADO, SIN.",4,1,5,0,0,0,
25-ago-15,COAH.,"SABINAS, COAH.",5,0,5,0,0,0,
26-ago-15,SON.,"HERMOSILLO, SON.",3,2,5,0,0,0,
26-ago-15,SIN.,"CULIACAN, SIN.",3,2,5,0,5,0,
26-ago-15,MEX.,"CHICONCUAC, MEX.",3,2,5,0,4,0,
27-ago-15,SIN.,"CULIACAN, SIN.",4,1,5,0,1,0,
28-ago-15,MEX.,"TULTEPEC, MEX.",5,0,5,0,0,0,
28-ago-15,B.C.,"TIJUANA, B.C.",2,3,5,0,0,0,
30-ago-15,DGO.,"DGO., DGO.",4,1,5,0,3,0,
31-ago-15,COAH.,"MONCLOVA, COAH.",4,1,5,0,0,43,
01-sep-15,SIN.,"MAZATLAN, SIN.",3,2,5,0,0,0,
02-sep-15,DGO.,"DGO., DGO.",3,2,5,0,0,0,
05-sep-15,N.L.,"MONTERREY, N.L.",5,0,5,2,0,1350,
05-sep-15,COAH.,"PIEDRAS NEGRAS, COAH.",3,2,5,2,0,0,
07-sep-15,SIN.,"CULIACAN, SIN.",3,2,5,0,4,0,
07-sep-15,SIN.,"COSALA, SIN.",2,3,5,0,0,0,
07-sep-15,COAH.,"TORREÓN, COAH.",3,2,5,2,0,0,
07-sep-15,N.L.,"MONTERREY, N.L.",1,4,5,0,0,200,
08-sep-15,CHIH.,"HGO. DEL PARRAL, CHIH.",3,2,5,0,0,0,
09-sep-15,COL.,"COL., COL.",1,4,5,0,0,0,
10-sep-15,TLAX.,"HUAMANTLA, TLAX.",1,4,5,0,0,0,
11-sep-15,SIN.,"COSALA, SIN.",1,4,5,0,0,0,
11-sep-15,DGO.,"GOMEZ PALACIO, DGO.",2,3,5,2,0,0,
12-sep-15,TLAX.,"HUAMANTLA, TLAX.",3,2,5,0,0,0,
12-sep-15,B.C.,"MEXICALI, B.C.",1,4,5,0,0,0,
12-sep-15,DGO.,"GOMEZ PALACIO, DGO.",2,3,5,0,0,0,
13-sep-15,B.C.,"MEXICALI, B.C.",4,1,5,0,0,0,
15-sep-15,COAH.,"TORREÓN, COAH.",1,4,5,0,0,0,
16-sep-15,DGO.,"DGO., DGO.",1,4,5,1,0,0,
18-sep-15,DGO.,"GOMEZ PALACIO, DGO.",3,2,5,0,0,0,
18-sep-15,B.C.,"TIJUANA, B.C.",5,0,5,0,0,0,
20-sep-15,DGO.,"DGO., DGO.",0,5,5,0,0,0,
21-sep-15,B.C.,"TIJUANA, B.C.",5,0,5,0,0,0,
22-sep-15,MEX.,"TEZOYUCA, MEX.",4,1,5,0,0,0,
23-sep-15,SIN.,"MAZATLAN, SIN.",5,0,5,0,5,0,
23-sep-15,DGO.,"DGO., DGO.",2,3,5,3,0,0,
23-sep-15,MEX.,"TENANCINGO, MEX.",4,1,5,4,0,0,
23-sep-15,CHIH.,"HGO. DEL PARRAL, CHIH.",3,2,5,0,0,44,
24-sep-15,COAH.,"PIEDRAS NEGRAS, COAH.",3,2,5,0,6,30,
24-sep-15,QRO.,"QUERETARO, QRO.",3,2,5,0,0,0,
25-sep-15,QRO.,"QUERETARO, QRO.",3,2,5,0,0,0,
25-sep-15,COAH.,"PIEDRAS NEGRAS, COAH.",1,4,5,0,0,200,
25-sep-15,SIN.,"CULIACAN, SIN.",2,3,5,0,13,0,
26-sep-15,MEX.,"TEZOYUCA, MEX.",3,2,5,0,0,0,
27-sep-15,DGO.,"DGO., DGO.",4,1,5,2,0,0,
28-sep-15,MEX.,"TEPOTZOTLAN, MEX.",5,0,5,0,0,0,
29-sep-15,COAH.,"SALTILLO, COAH.",4,1,5,5,3,149,
30-sep-15,TAMPS.,"TAMPICO, TAMPS.",3,2,5,1,0,311,
30-sep-15,COAH.,"TORREÓN, COAH.",4,1,5,4,0,0,
01-oct-15,SIN.,"BADIRAGUATO, SIN.",3,2,5,0,0,0,
02-oct-15,COAH.,"MONCLOVA, COAH.",3,2,5,0,0,177,
05-oct-15,DGO.,"GOMEZ PALACIO, DGO.",3,2,5,0,0,0,
05-oct-15,SIN.,"ESCUINAPA, SIN.",3,2,5,0,0,0,
07-oct-15,COAH.,"SALTILLO, COAH.",3,2,5,1,1,50,
12-oct-15,DGO.,"DGO., DGO.",3,2,5,11,0,0,
12-oct-15,SIN.,"BADIRAGUATO, SIN.",3,2,5,0,0,0,
12-oct-15,SIN.,"EL FUERTE, SIN.",2,3,5,0,1,0,
13-oct-15,COAH.,"SALTILLO, COAH.",5,0,5,0,0,0,
15-oct-15,SIN.,"BADIRAGUATO, SIN.",3,2,5,0,0,0,
16-oct-15,COAH.,"TORREÓN, COAH.",4,1,5,0,0,0,
17-oct-15,MEX.,"LA PAZ, MEX.",4,1,5,0,0,0,
18-oct-15,TAMPS.,"MATAMOROS, TAMPS.",2,3,5,3,0,90,
19-oct-15,NAY.,"ACAPONETA, NAY.",2,3,5,0,0,0,
19-oct-15,MEX.,"NEZAHUALCOYOTL, MEX.",4,1,5,0,2,0,
19-oct-15,COAH.,"PIEDRAS NEGRAS, COAH.",3,2,5,3,2,34,
20-oct-15,COAH.,"MONCLOVA, COAH.",4,1,5,2,0,172,
21-oct-15,MEX.,"ZINACANTEPEC, MEX.",4,1,5,0,0,0,
21-oct-15,MEX.,"NEZAHUALCOYOTL, MEX.",5,0,5,0,1,328,
23-oct-15,MEX.,"ZINACANTEPEC, MEX.",4,1,5,1,0,6,
26-oct-15,B.C.,"TIJUANA, B.C.",5,0,5,0,0,0,
29-oct-15,HGO.,"ACTOPAN, HGO.",1,4,5,0,0,0,
04-nov-15,MEX.,"TEJUPILCO, MEX.",2,3,5,0,0,0,
06-nov-15,MEX.,"VALLE DE CHALCO SOLIDARIDAD, MEX.",4,1,5,0,2,0,
07-nov-15,N.L.,"GRAL. ESCOBEDO, N.L.",0,5,5,130,0,12000,
09-nov-15,N.L.,"MONTERREY, N.L.",4,1,5,1,0,100,
09-nov-15,MEX.,"TECAMAC, MEX.",2,3,5,0,0,466,
10-nov-15,N.L.,"GRAL. ESCOBEDO, N.L.",0,5,5,21,0,0,
10-nov-15,COAH.,"PIEDRAS NEGRAS, COAH.",2,3,5,2,0,650,
11-nov-15,COAH.,"TORREÓN, COAH.",4,1,5,0,0,27,
17-nov-15,COAH.,"TORREÓN, COAH.",4,1,5,6,0,0,
17-nov-15,MEX.,"RAYON, MEX.",1,4,5,0,0,0,
18-nov-15,COAH.,"ACUÑA, COAH.",2,3,5,1,0,0,
18-nov-15,B.C.,"TIJUANA, B.C.",5,0,5,0,0,0,
18-nov-15,MEX.,"OTUMBA, MEX.",3,2,5,1,0,41,
19-nov-15,COAH.,"SALTILLO, COAH.",3,2,5,0,0,0,
19-nov-15,MEX.,"OTUMBA, MEX.",2,3,5,1,0,13,
24-nov-15,AGS.,"AGS., AGS.",4,1,5,6,0,6,
24-nov-15,GRO.,"TELOLOAPAN, GRO.",1,4,5,0,0,0,
27-nov-15,B.C.,"ENSENADA, B.C.",3,2,5,0,0,0,
28-nov-15,DGO.,"DGO., DGO.",3,2,5,2,0,0,
01-dic-15,COAH.,"SALTILLO, COAH.",4,1,5,0,0,300,
01-dic-15,COAH.,"ACUÑA, COAH.",3,2,5,0,0,309,
04-dic-15,COAH.,"MONCLOVA, COAH.",3,2,5,2,0,211,
04-dic-15,S.L.P.,"CIUDAD VALLES, S.L.P.",5,0,5,0,2,0,
06-dic-15,COAH.,"MATAMOROS, COAH.",5,0,5,0,0,0,
06-dic-15,COAH.,"MATAMOROS, COAH.",5,0,5,0,0,0,
07-dic-15,DGO.,"DGO., DGO.",3,2,5,3,0,0,
10-dic-15,SON.,"ALAMOS, SON.",5,0,5,0,0,44,
11-dic-15,SON.,"SAN LUIS RIO COLORADO, SON.",2,3,5,5,0,30,
11-dic-15,S.L.P.,"SAN LUIS POTOSI, S.L.P.",5,0,5,0,0,120,
12-dic-15,B.C.,"TIJUANA, B.C.",1,4,5,0,0,0,
12-dic-15,SON.,"NOGALES, SON.",2,3,5,0,0,128,
15-dic-15,CHIH.,"HGO. DEL PARRAL, CHIH.",5,0,5,0,0,289,
17-dic-15,CHIS.,"COMITAN DE DOMÍNGUEZ, CHIS.",3,2,5,4,0,21,
17-dic-15,CHIH.,"HGO. DEL PARRAL, CHIH.",4,1,5,16,0,1412,
18-dic-15,CHIH.,"HGO. DEL PARRAL, CHIH.",4,1,5,16,0,1412,
23-dic-15,TAMPS.,"REYNOSA, TAMPS.",5,0,5,177,0,0,
29-dic-15,GRO.,"FLORENCIO VILLARREAL, GRO.",4,1,5,0,0,0,
02-ene-16,B.C.,"TIJUANA, B.C.",3,2,5,0,0,0,
04-ene-16,B.C.,"TIJUANA, B.C.",2,3,5,0,0,0,
14-ene-16,COAH.,"SALTILLO, COAH.",5,0,5,2,0,8,
15-ene-16,COAH.,"PIEDRAS NEGRAS, COAH.",2,3,5,3,0,34,
15-ene-16,COAH.,"SAN PEDRO, COAH.",5,0,5,0,0,0,
15-ene-16,COAH.,"SALTILLO, COAH.",2,3,5,0,0,100,
20-ene-16,OAX.,"OAX. DE JUAREZ, OAX.",0,5,5,0,0,0,
21-ene-16,COAH.,"PIEDRAS NEGRAS, COAH.",3,2,5,4,0,220,
26-ene-16,OAX.,"OAX. DE JUAREZ, OAX.",1,4,5,0,0,20,
27-ene-16,COAH.,"SALTILLO, COAH.",4,1,5,0,0,43,
06-feb-16,TAMPS.,"NUEVO LAREDO, TAMPS.",1,4,5,0,0,66,
09-feb-16,OAX.,"OAX. DE JUAREZ, OAX.",0,5,5,0,0,160,
10-feb-16,COAH.,"MONCLOVA, COAH.",4,1,5,4,0,245,
12-feb-16,COAH.,"SALTILLO, COAH.",3,2,5,0,0,96,
19-feb-16,CHIH.,"HGO. DEL PARRAL, CHIH.",1,4,5,0,0,0,
24-feb-16,COAH.,"TORREÓN, COAH.",2,3,5,0,0,0,
04-mar-16,COAH.,"TORREÓN, COAH.",2,3,5,0,2,0,
08-mar-16,COAH.,"TORREÓN, COAH.",1,4,5,0,0,75,
08-mar-16,COAH.,"TORREÓN, COAH.",3,2,5,0,0,0,
09-mar-16,D.F.,"TLAHUAC, D.F.",1,4,5,48,0,626,
16-mar-16,COAH.,"SALTILLO, COAH.",3,2,5,12,1,3040,
19-mar-16,COAH.,"SAN PEDRO, COAH.",4,1,5,0,0,643,
21-mar-16,COAH.,"SALTILLO, COAH.",4,1,5,0,0,0,
29-mar-16,COAH.,"TORREÓN, COAH.",2,3,5,0,0,0,
31-mar-16,OAX.,"MIAHUATLAN DE PORFIRIO DIAZ, OAX.",4,1,5,0,0,0,
14-abr-16,COAH.,"MONCLOVA, COAH.",2,3,5,0,0,0,
16-abr-16,TAMPS.,"MATAMOROS, TAMPS.",0,5,5,0,0,0,
29-abr-16,COAH.,"TORREÓN, COAH.",3,2,5,0,0,0,
07-may-16,COAH.,"MOR., COAH.",3,2,5,0,0,40,
22-may-16,N.L.,"GUADALUPE, N.L.",4,1,5,0,0,100,
26-may-16,N.L.,"GUADALUPE, N.L.",2,3,5,0,0,100,
06-jul-16,SIN.,"CULIACAN, SIN.",4,1,5,0,6,0,
07-jul-16,SIN.,"CULIACAN, SIN.",5,0,5,0,0,0,
12-jul-16,SIN.,"CULIACAN, SIN.",5,0,5,0,10,0,
13-jul-16,SIN.,"CULIACAN, SIN.",2,3,5,0,4,0,
18-jul-16,B.C.,"TIJUANA, B.C.",3,2,5,0,0,0,
22-jul-16,COAH.,"MONCLOVA, COAH.",2,3,5,0,0,0,
01-ago-16,S.L.P.,"SAN LUIS POTOSI, S.L.P.",5,0,5,3,0,0,
08-ago-16,MEX.,"ACOLMAN, MEX.",4,1,5,0,0,13,
10-ago-16,MEX.,"ACOLMAN, MEX.",3,2,5,0,0,35,
11-ago-16,COAH.,"TORREÓN, COAH.",3,2,5,0,0,0,
11-ago-16,SIN.,"NAVOLATO, SIN.",5,0,5,0,0,0,
15-ago-16,MEX.,"TOLUCA, MEX.",5,0,5,3,0,5,
15-ago-16,MEX.,"AMECAMECA, MEX.",4,1,5,0,0,0,
18-ago-16,MEX.,"ZUMPAHUACAN, MEX.",5,0,5,0,1,0,
24-ago-16,SON.,"CAJEME, SON.",2,3,5,0,0,73,
31-ago-16,MEX.,"TULTEPEC, MEX.",5,0,5,3,0,3,
01-sep-16,MEX.,"TULTEPEC, MEX.",1,4,5,0,0,67,
09-sep-16,MEX.,"SAN MARTIN DE LAS PIRAMIDES, MEX.",3,2,5,0,4,0,
19-sep-16,COAH.,"TORREÓN, COAH.",4,1,5,0,0,40,
19-sep-16,COAH.,"MÚZQUIZ, COAH.",4,1,5,0,0,0,
20-sep-16,MEX.,"ATLACOMULCO, MEX.",3,2,5,0,3,170,
22-sep-16,MEX.,"ATLACOMULCO, MEX.",2,3,5,0,0,0,
23-sep-16,MEX.,"ATLACOMULCO, MEX.",3,2,5,0,0,0,
30-sep-16,MOR.,"XOCHITEPEC, MOR.",4,1,5,0,5,1197,
30-sep-16,SIN.,"CONCORDIA, SIN.",4,1,5,0,4,0,
03-oct-16,MEX.,"TEPOTZOTLAN, MEX.",5,0,5,1,0,40,
05-oct-16,SON.,"CAJEME, SON.",3,2,5,4,0,0,
10-oct-16,SIN.,"CHOIX, SIN.",2,3,5,0,2,0,
11-oct-16,SIN.,"CHOIX, SIN.",5,0,5,0,0,0,
12-oct-16,MEX.,"IXTAPALUCA, MEX.",5,0,5,1,0,127,
12-oct-16,SON.,"HERMOSILLO, SON.",5,0,5,14,0,46,
17-oct-16,CHIS.,"TAPACHULA, CHIS.",4,1,5,1,1,191,
21-oct-16,MEX.,"NEXTLALPAN, MEX., MEX.",4,1,5,2,0,5,
24-oct-16,MEX.,"ZINACANTEPEC, MEX.",5,0,5,0,0,0,
08-nov-16,SON.,"HERMOSILLO, SON.",5,0,5,0,0,0,
08-nov-16,MEX.,"TEMAMATLA, MEX.",5,0,5,0,0,0,
12-nov-16,SON.,"NOGALES, SON.",5,0,5,5,0,124,
12-nov-16,SON.,"HERMOSILLO, SON.",3,2,5,0,0,0,
12-nov-16,MEX.,"LUVIANOS, MEX.",5,0,5,2,0,0,
18-nov-16,SON.,"HERMOSILLO, SON.",5,0,5,0,0,0,
18-nov-16,MEX.,"TECAMAC, MEX.",5,0,5,0,0,0,
22-nov-16,MEX.,"NOPALTEPEC, MEX.",0,5,5,5,8,173,
29-nov-16,D.F.,"ALVARO OBREGON, D.F.",3,2,5,0,2,68,
02-dic-16,MEX.,"ACAMBAY, MEX.",5,0,5,4,0,0,
05-dic-16,B.C.,"TIJUANA, B.C.",1,4,5,0,0,0,
07-dic-16,B.C.,"TIJUANA, B.C.",0,5,5,0,0,0,
08-dic-16,D.F.,"VENUSTIANO CARRANZA, D.F.",3,2,5,0,0,76,
12-dic-16,S.L.P.,"CIUDAD VALLES, S.L.P.",4,1,5,0,0,6,
17-dic-16,B.C.,"TIJUANA, B.C.",0,5,5,0,1,0,
21-dic-16,B.C.,"TIJUANA, B.C.",0,5,5,0,0,0,
21-dic-16,TAMPS.,"TAMPICO, TAMPS.",5,0,5,11,0,475,
21-ene-17,DGO.,"DGO., DGO.",3,2,5,2,0,0,
24-ene-17,DGO.,"DGO., DGO.",2,3,5,0,0,11,
25-ene-17,B.C.,"TIJUANA, B.C.",5,0,5,0,0,0,
25-ene-17,B.C.,"TIJUANA, B.C.",5,0,5,0,0,0,
26-ene-17,DGO.,"DGO., DGO.",4,1,5,1,0,50,
03-feb-17,OAX.,"PINOTEPA DE DON LUIS, OAX.",3,2,5,1,0,0,
03-feb-17,OAX.,"PINOTEPA DE DON LUIS, OAX.",3,2,5,1,0,0,
07-feb-17,MICH.,"LAZARO CARDENAS, MICH.",3,2,5,1,0,0,
09-feb-17,COAH.,"PIEDRAS NEGRAS, COAH.",1,4,5,0,0,0,
17-feb-17,TAMPS.,"MATAMOROS, TAMPS.",1,4,5,1,0,406,
21-feb-17,COAH.,"PIEDRAS NEGRAS, COAH.",4,1,5,0,0,84,
23-feb-17,D.F.,"IZTAPALAPA, D.F.",5,0,5,0,0,0,
25-feb-17,COAH.,"PIEDRAS NEGRAS, COAH.",0,5,5,20,0,0,
01-mar-17,TAMPS.,"NUEVO LAREDO, TAMPS.",5,0,5,1,0,204,
03-mar-17,TAMPS.,"NUEVO LAREDO, TAMPS.",3,2,5,2,0,26,
08-mar-17,MEX.,"TOLUCA, MEX.",4,1,5,0,0,0,
09-mar-17,TAMPS.,"NUEVO LAREDO, TAMPS.",3,2,5,0,0,127,
11-mar-17,MEX.,"TOLUCA, MEX.",3,2,5,2,0,343,
11-mar-17,CHIH.,"HGO. DEL PARRAL, CHIH.",3,2,5,9,0,1662,
13-mar-17,DGO.,"DGO., DGO.",3,2,5,3,1,0,
14-mar-17,DGO.,"CANATLAN, DGO.",2,3,5,0,0,0,
14-mar-17,QRO.,"SAN JUAN DEL RIO, QRO.",4,1,5,0,0,0,
15-mar-17,QRO.,"QUERETARO, QRO.",0,5,5,0,0,0,
23-mar-17,MEX.,"NAUCALPAN DE JUAREZ, MEX.",5,0,5,0,0,446,
23-mar-17,MEX.,"TECAMAC, MEX.",5,0,5,0,0,0,
24-mar-17,TAMPS.,"MATAMOROS, TAMPS.",3,2,5,9,0,242,
01-abr-17,TAMPS.,"MATAMOROS, TAMPS.",1,4,5,2,0,632,
03-abr-17,QRO.,"QUERETARO, QRO.",0,5,5,0,0,0,
04-abr-17,D.F.,"TLALPAN, D.F.",3,2,5,0,1,117,
06-abr-17,D.F.,"TLALPAN, D.F.",4,1,5,0,3,9,
08-abr-17,TAMPS.,"MATAMOROS, TAMPS.",4,1,5,15,0,855,
10-abr-17,DGO.,"DGO., DGO.",3,2,5,2,0,0,
10-abr-17,DGO.,"DGO., DGO.",3,2,5,2,0,0,
18-abr-17,SIN.,"MAZATLAN, SIN.",4,1,5,0,6,0,
24-abr-17,SIN.,"MAZATLAN, SIN.",3,2,5,0,0,0,
25-abr-17,S.L.P.,"SAN LUIS POTOSI, S.L.P.",4,1,5,1,0,105,
25-abr-17,JAL.,"GUADALAJARA, JAL.",2,3,5,0,0,0,
26-abr-17,JAL.,"ZAPOPAN, JAL.",5,0,5,0,0,55,
29-abr-17,JAL.,"GUADALAJARA, JAL.",2,3,5,0,0,0,
04-may-17,GTO.,"SALAMANCA, GTO.",4,1,5,0,0,0,
13-may-17,TAMPS.,"MATAMOROS, TAMPS.",0,5,5,1,0,10,
15-may-17,DGO.,"DGO., DGO.",2,3,5,0,0,0,
23-may-17,AGS.,"AGS., AGS.",3,2,5,13,1,324,
30-may-17,SIN.,"SIN., SIN.",0,5,5,0,0,0,
05-jun-17,CHIS.,"COMITAN DE DOMÍNGUEZ, CHIS.",5,0,5,0,0,90,
07-jun-17,B.C.,"TIJUANA, B.C.",4,1,5,0,0,0,
07-jun-17,MOR.,"CUERNAVACA, MOR.",0,5,5,5,1,85,
07-jun-17,TLAX.,"CHIAUTEMPAN, TLAX.",1,4,5,0,0,0,
08-jun-17,CHIS.,"TONALÁ, CHIS.",3,2,5,30,0,629,
09-jun-17,N.L.,"SANTA CATARINA, N.L.",5,0,5,0,0,140,
09-jun-17,CHIS.,"TAPACHULA, CHIS.",1,4,5,6,0,1551,
09-jun-17,MOR.,"CUERNAVACA, MOR.",2,3,5,28,1,273,
09-jun-17,QRO.,"QUERETARO, QRO.",1,4,5,0,0,0,
11-jun-17,JAL.,"ZAPOPAN, JAL.",5,0,5,0,0,121,
14-jun-17,JAL.,"ZAPOPAN, JAL.",3,2,5,0,0,0,
15-jun-17,N.L.,"MONTERREY, N.L.",5,0,5,0,0,0,
17-jun-17,CHIH.,"OJINAGA, CHIH.",4,1,5,0,0,0,
20-jun-17,SIN.,"CHOIX, SIN.",4,1,5,0,0,0,
21-jun-17,TLAX.,"IXTACUIXTLA DE MARIANO MATAMOROS, TLAX.",2,3,5,0,0,0,
24-jun-17,MOR.,"TEPOZTLAN, MOR.",3,2,5,2,0,70,
10-jul-17,D.F.,"MILPA ALTA, D.F.",5,0,5,0,0,67,
13-jul-17,CHIS.,"CHIAPA DE CORZO, CHIS.",1,4,5,16,0,746,
28-jul-17,MOR.,"EMILIANO ZAPATA, MOR.",5,0,5,0,1,117,
30-jul-17,MEX.,"CHAPA DE MOTA, MEX.",2,3,5,2,0,0,
30-jul-17,MEX.,"TEPETLAOXTOC, MEX.",4,1,5,1,0,118,
02-ago-17,MOR.,"EMILIANO ZAPATA, MOR.",3,2,5,7,4,0,
09-ago-17,S.L.P.,"SAN LUIS POTOSI, S.L.P.",5,0,5,16,0,283,
11-ago-17,TAMPS.,"MATAMOROS, TAMPS.",5,0,5,0,0,0,
12-ago-17,S.L.P.,"SAN LUIS POTOSI, S.L.P.",5,0,5,8,0,0,
14-ago-17,D.F.,"VENUSTIANO CARRANZA, D.F.",5,0,5,0,0,7,
16-ago-17,MOR.,"EMILIANO ZAPATA, MOR.",4,1,5,1,0,0,
18-ago-17,TAMPS.,"MATAMOROS, TAMPS.",2,3,5,0,0,0,
19-ago-17,MEX.,"TEXCOCO, MEX.",4,1,5,2,0,66,
23-ago-17,N.L.,"APODACA, N.L.",2,3,5,0,0,0,
26-ago-17,COAH.,"RAMOS ARIZPE, COAH.",5,0,5,1,0,500,
07-sep-17,COAH.,"TORREÓN, COAH.",5,0,5,25,0,54,
07-sep-17,ZAC.,"GUADALUPE, ZAC.",3,2,5,0,0,640,
13-sep-17,ZAC.,"GUADALUPE, ZAC.",4,1,5,2,0,769,
15-sep-17,ZAC.,"GUADALUPE, ZAC.",4,1,5,0,0,1060,
18-sep-17,COAH.,"TORREÓN, COAH.",4,1,5,0,0,0,
21-sep-17,AGS.,"AGS., AGS.",1,4,5,3,0,0,
24-sep-17,ZAC.,"ZAC., ZAC.",5,0,5,0,0,641,
25-sep-17,SIN.,"AHOME, SIN.",4,1,5,0,1,183,
25-sep-17,COAH.,"RAMOS ARIZPE, COAH.",5,0,5,2,0,487,
26-sep-17,ZAC.,"ZAC., ZAC.",3,2,5,0,0,6,
26-sep-17,SIN.,"AHOME, SIN.",4,1,5,0,1,0,
27-sep-17,ZAC.,"GUADALUPE, ZAC.",5,0,5,7,0,664,
27-sep-17,SIN.,"AHOME, SIN.",4,1,5,0,0,0,
28-sep-17,DGO.,"DGO., DGO.",2,3,5,0,0,0,
03-oct-17,ZAC.,"JEREZ, ZAC.",1,4,5,5,0,1468,
12-oct-17,D.F.,"IZTACALCO, D.F.",4,1,5,0,0,319,
13-oct-17,D.F.,"IZTACALCO, D.F.",3,2,5,0,0,0,
16-oct-17,SIN.,"CULIACAN, SIN.",4,1,5,0,8,0,
25-oct-17,DGO.,"GOMEZ PALACIO, DGO.",3,2,5,0,0,0,
27-oct-17,SIN.,"CULIACAN, SIN.",5,0,5,0,18,0,
07-nov-17,ZAC.,"GUADALUPE, ZAC.",3,2,5,0,0,12,
08-dic-17,GTO.,"LEON, GTO.",3,2,5,0,4,0,
11-dic-17,GTO.,"LEON, GTO.",3,2,5,0,1,0,
12-dic-17,GTO.,"LEON, GTO.",3,2,5,0,0,0,
22-dic-17,B.C.,"TIJUANA, B.C.",4,1,5,0,0,0,
30-dic-17,B.C.,"TIJUANA, B.C.",3,2,5,0,0,0,
02-ene-18,B.C.,"TIJUANA, B.C.",4,1,5,0,0,0,
15-ene-18,COAH.,"SALTILLO, COAH.",4,1,5,1,0,100,
15-ene-18,COAH.,"MONCLOVA, COAH.",1,4,5,7,5,0,
19-ene-18,COAH.,"SALTILLO, COAH.",5,0,5,7,0,489,
23-ene-18,D.F.,"CUAUHTEMOC, D.F.",3,2,5,0,0,243,
26-ene-18,COAH.,"PIEDRAS NEGRAS, COAH.",1,4,5,0,0,0,
29-ene-18,GTO.,"IRAPUATO, GTO.",4,1,5,2,0,38,
31-ene-18,ZAC.,"GUADALUPE, ZAC.",3,2,5,11,0,0,
01-feb-18,COAH.,"TORREÓN, COAH.",5,0,5,0,0,1,
03-feb-18,COAH.,"SALTILLO, COAH.",5,0,5,1,0,96,
06-feb-18,COAH.,"SALTILLO, COAH.",5,0,5,1,0,96,
09-feb-18,D.F.,"TLAHUAC, D.F.",2,3,5,0,0,62,
09-feb-18,COAH.,"MONCLOVA, COAH.",3,2,5,4,1,155,
12-feb-18,ZAC.,"FRESNILLO, ZAC.",4,1,5,39,0,300,
14-feb-18,COAH.,"MONCLOVA, COAH.",5,0,5,16,0,254,
05-mar-18,D.F.,"TLALPAN, D.F.",3,2,5,0,0,0,
09-mar-18,GRO.,"TECPAN DE GALEANA, GRO.",5,0,5,2,0,0,
12-mar-18,S.L.P.,"SAN LUIS POTOSI, S.L.P.",3,2,5,0,0,0,
12-mar-18,COAH.,"MONCLOVA, COAH.",5,0,5,1,3,37,
13-mar-18,COAH.,"ACUÑA, COAH.",0,5,5,0,0,0,
13-mar-18,ZAC.,"FRESNILLO, ZAC.",4,1,5,6,0,39,
03-jul-18,SIN.,"CULIACAN, SIN.",4,1,5,0,0,0,
17-jul-18,GTO.,"IRAPUATO, GTO.",4,1,5,0,0,19,
20-jul-18,ZAC.,"GUADALUPE, ZAC.",3,2,5,9,0,187,
20-jul-18,GTO.,"CELAYA, GTO.",4,1,5,0,0,0,
23-jul-18,ZAC.,"GUADALUPE, ZAC.",2,3,5,1,1,85,
30-jul-18,GTO.,"IRAPUATO, GTO.",1,4,5,0,0,0,
03-ago-18,DGO.,"GOMEZ PALACIO, DGO.",5,0,5,3,0,0,
06-ago-18,CHIS.,"CHICOASÉN, CHIS.",5,0,5,1,0,16,
06-ago-18,MEX.,"ATIZAPAN, MEX.",3,2,5,0,0,138,
07-ago-18,GTO.,"CELAYA, GTO.",5,0,5,0,0,69,
07-ago-18,TAMPS.,"TAMPICO, TAMPS.",4,1,5,0,0,16,
08-ago-18,MEX.,"CHALCO, MEX.",2,3,5,0,0,461,
09-ago-18,MEX.,"ATLACOMULCO, MEX.",5,0,5,2,0,710,
09-ago-18,CHIS.,"TAPACHULA, CHIS.",3,2,5,1,1,77,
09-ago-18,TAMPS.,"VICTORIA, TAMPS.",2,3,5,0,0,20,
11-ago-18,MEX.,"CHALCO, MEX.",4,1,5,0,0,63,
12-ago-18,CHIS.,"TUXTLA GUTIÉRREZ, CHIS.",2,3,5,1,0,0,
13-ago-18,QRO.,"PINAL DE AMOLES, QRO.",5,0,5,1,0,0,
13-ago-18,MEX.,"ATIZAPAN, MEX.",4,1,5,3,0,66,
13-ago-18,MEX.,"SAN MATEO ATENCO, MEX.",3,2,5,1,0,71,
16-ago-18,N.L.,"LINARES, N.L.",5,0,5,0,0,0,
16-ago-18,GTO.,"CELAYA, GTO.",3,2,5,0,0,0,
21-ago-18,TAMPS.,"REYNOSA, TAMPS.",2,3,5,0,0,70,
21-ago-18,COAH.,"SALTILLO, COAH.",1,4,5,0,0,0,
21-ago-18,B.C.,"TIJUANA, B.C.",5,0,5,0,0,0,
25-ago-18,TAMPS.,"REYNOSA, TAMPS.",5,0,5,0,0,0,
27-ago-18,COAH.,"TORREÓN, COAH.",4,1,5,2,0,24,
27-ago-18,D.F.,"AZCAPOTZALCO, D.F.",4,1,5,0,1,156,
29-ago-18,AGS.,"AGS., AGS.",3,2,5,0,0,0,
31-ago-18,MEX.,"CHIMALHUACAN, MEX.",3,2,5,0,0,18228,
01-sep-18,TLAX.,"SAN PABLO DEL MONTE, TLAX.",5,0,5,0,0,0,
03-sep-18,B.C.,"TIJUANA, B.C.",3,2,5,0,0,0,
03-sep-18,MEX.,"TENANCINGO, MEX.",3,2,5,1,0,0,
19-sep-18,MEX.,"TOLUCA, MEX.",4,1,5,2,0,7196,
20-sep-18,AGS.,"AGS., AGS.",5,0,5,0,0,35,
22-sep-18,MEX.,"TOLUCA, MEX.",5,0,5,4,0,3608,
22-sep-18,MOR.,"CUERNAVACA, MOR.",5,0,5,0,0,653,
01-oct-18,S.L.P.,"SAN LUIS POTOSI, S.L.P.",5,0,5,0,0,0,
04-oct-18,D.F.,"MIGUEL HGO., D.F.",5,0,5,0,3,134,
16-oct-18,MEX.,"HUEHUETOCA, MEX.",4,1,5,0,0,36,
16-oct-18,D.F.,"VENUSTIANO CARRANZA, D.F.",4,1,5,0,0,76,
18-oct-18,D.F.,"VENUSTIANO CARRANZA, D.F.",5,0,5,0,0,1201,
18-oct-18,GTO.,"LEON, GTO.",4,1,5,0,3,0,
20-oct-18,MEX.,"ATIZAPAN, MEX.",1,4,5,0,0,0,
22-oct-18,CHIH.,"JUÁREZ, CHIH.",4,1,5,1,0,185,
28-oct-18,CHIH.,"JUÁREZ, CHIH.",0,5,5,6,0,3022,
30-oct-18,CHIH.,"JUÁREZ, CHIH.",1,4,5,2,0,495,
06-nov-18,D.F.,"COYOACAN, D.F.",3,2,5,0,0,2865,
06-nov-18,MEX.,"CUAUTITLAN IZCALLI, MEX.",3,2,5,3,0,60,
08-nov-18,MEX.,"VALLE DE CHALCO SOLIDARIDAD, MEX.",4,1,5,3,0,292,
09-nov-18,MEX.,"VALLE DE CHALCO SOLIDARIDAD, MEX.",5,0,5,0,0,0,
12-nov-18,N.L.,"LOS ALDAMAS, N.L.",3,2,5,17,0,0,
27-nov-18,ZAC.,"GUADALUPE, ZAC.",5,0,5,9,0,0,
28-nov-18,SIN.,"AHOME, SIN.",3,2,5,0,1,0,
07-dic-18,SIN.,"ANGOSTURA, SIN.",2,3,5,0,0,0,
13-dic-18,SIN.,"CULIACAN, SIN.",4,1,5,0,0,0,
27-dic-18,B.C.,"TIJUANA, B.C.",2,3,5,0,0,0,
26-feb-19,ZAC.,"FRESNILLO, ZAC.",5,0,5,3,0,2147,
01-mar-19,GTO.,"ACAMBARO, GTO.",2,3,5,0,0,0,
08-mar-19,CHIS.,"TUXTLA GUTIÉRREZ, CHIS.",4,1,5,6,2,5565,
13-mar-19,CD. MÉX.,"BENITO JUAREZ, CD. MÉX.",5,0,5,0,0,262,
01-abr-19,CD. MÉX.,"GUSTAVO A. MADERO, CD. MÉX.",5,0,5,0,0,6,
04-abr-19,CD. MÉX.,"XOCHIMILCO, CD. MÉX.",1,4,5,0,0,0,
04-abr-19,S.L.P.,"SAN LUIS POTOSI, S.L.P.",4,1,5,2,0,0,
06-may-19,CD. MÉX.,"IZTAPALAPA, CD. MÉX.",3,2,5,0,0,402,
07-may-19,CD. MÉX.,"IZTAPALAPA, CD. MÉX.",5,0,5,0,1,808,
09-may-19,CHIH.,"JUÁREZ, CHIH.",3,2,5,16,0,1020,
10-may-19,CD. MÉX.,"AZCAPOTZALCO, CD. MÉX.",2,3,5,0,0,75,
21-may-19,CHIH.,"JUÁREZ, CHIH.",1,4,5,33,0,350,
22-may-19,CD. MÉX.,"MILPA ALTA, CD. MÉX.",2,3,5,0,0,44,
23-may-19,CD. MÉX.,"VENUSTIANO CARRANZA, CD. MÉX.",5,0,5,0,0,142,
28-may-19,CHIH.,"JUÁREZ, CHIH.",3,2,5,10,0,371,
29-may-19,CD. MÉX.,"MILPA ALTA, CD. MÉX.",3,2,5,0,0,106,
29-may-19,CHIH.,"JUÁREZ, CHIH.",5,0,5,53,0,57,
31-may-19,CD. MÉX.,"MILPA ALTA, CD. MÉX.",5,0,5,0,0,32,
04-jun-19,MÉX.,"ECATEPEC DE MOR., MEX.",5,0,5,0,2,190,
07-jun-19,CD. MÉX.,"LA MAGDALENA CONTRERAS, CD. MÉX.",4,1,5,0,13,0,
07-jun-19,QRO.,"SAN JUAN DEL RIO, QRO.",2,3,5,0,3,0,
14-jun-19,CD. MÉX.,"IZTACALCO, CD. MÉX.",5,0,5,0,1,56,
24-jun-19,CD. MÉX.,"IZTAPALAPA, CD. MÉX.",4,1,5,0,0,57,
08-jul-19,CD. MÉX.,"XOCHIMILCO, CD. MÉX.",4,1,5,0,0,903,
08-jul-19,CD. MÉX.,"IZTAPALAPA, CD. MÉX.",4,1,5,0,0,15,
19-jul-19,NAY.,"TEPIC, NAY.",5,0,5,0,0,0,
25-jul-19,COAH.,"FRANCISCO I. MADERO, COAH.",5,0,5,0,0,0,
27-jul-19,CHIH.,"DELICIAS, CHIH.",3,2,5,0,0,0,
30-jul-19,NAY.,"TECUALA, NAY.",5,0,5,0,0,0,
01-ago-19,QRO.,"PEDRO ESCOBEDO, QRO.",1,4,5,0,0,0,
02-ago-19,AGS.,"EL LLANO, AGS.",5,0,5,10,1,40,
02-ago-19,QRO.,"PEDRO ESCOBEDO, QRO.",3,2,5,0,0,0,
04-ago-19,NAY.,"ACAPONETA, NAY.",4,1,5,0,0,0,
06-ago-19,CD. MÉX.,"CUAUHTEMOC, CD. MÉX.",5,0,5,0,0,36,
08-ago-19,CD. MÉX.,"IZTAPALAPA, CD. MÉX.",5,0,5,0,0,2,
19-ago-19,CD. MÉX.,"IZTAPALAPA, CD. MÉX.",5,0,5,0,0,0,
20-ago-19,CD. MÉX.,"IZTAPALAPA, CD. MÉX.",4,1,5,0,0,218,
20-ago-19,QRO.,"QUERETARO, QRO.",3,2,5,0,2,0,
21-ago-19,QRO.,"EZEQUIEL MONTES, QRO.",2,3,5,0,0,0,
23-ago-19,VER.,"LAS CHOAPAS, VER.",3,2,5,1,0,0,
27-ago-19,TAMPS.,"REYNOSA, TAMPS.",4,1,5,4,0,307,
29-ago-19,CD. MÉX.,"MIGUEL HGO., CD. MÉX.",4,1,5,0,0,87,
30-ago-19,CHIH.,"NUEVO CASAS GRANDES, CHIH.",3,2,5,0,0,0,
31-ago-19,MÉX.,"ATLACOMULCO, MEX.",2,3,5,0,0,0,
02-sep-19,MÉX.,"TOLUCA, MEX.",3,2,5,1,20,95,
02-sep-19,CD. MÉX.,"MIGUEL HGO., CD. MÉX.",3,2,5,0,0,84,
03-sep-19,CD. MÉX.,"MIGUEL HGO., CD. MÉX.",5,0,5,0,0,7,
06-sep-19,MÉX.,"NEZAHUALCOYOTL, MEX.",3,2,5,0,0,676,
09-sep-19,MÉX.,"NEZAHUALCOYOTL, MEX.",5,0,5,4,0,47,
12-sep-19,CD. MÉX.,"COYOACAN, CD. MÉX.",5,0,5,0,0,341,
13-sep-19,MÉX.,"NEZAHUALCOYOTL, MEX.",4,1,5,0,0,164,
18-sep-19,TLAX.,"TETLA DE LA SOLIDARIDAD, TLAX.",0,5,5,0,0,0,
04-oct-19,MÉX.,"CHIMALHUACAN, MEX.",5,0,5,4,0,130,
07-oct-19,TAMPS.,"TAMPICO, TAMPS.",4,1,5,0,0,383,
08-oct-19,MÉX.,"METEPEC, MEX.",4,1,5,3,2,702,
08-oct-19,CD. MÉX.,"IZTACALCO, CD. MÉX.",5,0,5,0,0,346,
14-oct-19,MÉX.,"ZINACANTEPEC, MEX.",2,3,5,0,0,0,
14-oct-19,MÉX.,"IXTAPALUCA, MEX.",5,0,5,0,1,144,
15-oct-19,MÉX.,"TEMOAYA, MEX.",3,2,5,3,0,154,
15-oct-19,MÉX.,"IXTAPALUCA, MEX.",5,0,5,0,1,142,
15-oct-19,CD. MÉX.,"IZTACALCO, CD. MÉX.",5,0,5,0,0,3,
16-oct-19,CD. MÉX.,"IZTAPALAPA, CD. MÉX.",2,3,5,0,0,34,
18-oct-19,CD. MÉX.,"CUAJIMALPA DE MOR., CD. MÉX.",4,1,5,0,0,61,
29-oct-19,CD. MÉX.,"IZTAPALAPA, CD. MÉX.",5,0,5,0,2,615,
29-oct-19,MÉX.,"CHALCO, MEX.",3,2,5,0,0,201,
06-nov-19,MÉX.,"LA PAZ, MEX.",5,0,5,0,0,314,
09-nov-19,MÉX.,"LA PAZ, MEX.",3,2,5,0,0,100,
11-nov-19,CD. MÉX.,"BENITO JUAREZ, CD. MÉX.",4,1,5,0,0,457,
11-nov-19,MÉX.,"CUAUTITLAN IZCALLI, MEX.",4,1,5,0,0,249,
21-nov-19,CD. MÉX.,"CUAUHTEMOC, CD. MÉX.",4,1,5,0,0,164,
22-nov-19,MÉX.,"ALMOLOYA DE JUAREZ, MEX.",5,0,5,0,0,0,
22-nov-19,CD. MÉX.,"COYOACAN, CD. MÉX.",2,3,5,0,0,0,
22-nov-19,MÉX.,"COYOTEPEC, MEX.",4,1,5,0,3,228,
28-nov-19,GTO.,"LEON, GTO.",0,5,5,0,0,0,
02-dic-19,GTO.,"LEON, GTO.",4,1,5,0,0,0,
06-dic-19,CD. MÉX.,"XOCHIMILCO, CD. MÉX.",0,5,5,0,0,0,
29-ene-20,CD. MÉX.,"IZTAPALAPA, CD. MÉX.",4,1,5,0,0,55,
29-ene-20,CHIS.,"COMITAN DE DOMÍNGUEZ, CHIS.",2,3,5,2,2,420,
30-ene-20,CD. MÉX.,"IZTAPALAPA, CD. MÉX.",5,0,5,0,0,340,
05-feb-20,CD. MÉX.,"IZTAPALAPA, CD. MÉX.",4,1,5,0,1,733,
14-feb-20,CD. MÉX.,"CUAUHTEMOC, CD. MÉX.",5,0,5,0,0,223,
18-feb-20,CD. MÉX.,"CUAUHTEMOC, CD. MÉX.",4,1,5,0,0,628,
21-feb-20,SIN.,"GUASAVE, SIN.",4,1,5,0,0,0,
25-feb-20,CD. MÉX.,"IZTAPALAPA, CD. MÉX.",2,3,5,0,0,50,
27-feb-20,COAH.,"SALTILLO, COAH.",2,3,5,1,0,30,
09-mar-20,VER.,"COATZACOALCOS, VER.",5,0,5,3,0,165,
17-sep-20,CD. MÉX.,"GUSTAVO A. MADERO, CD. MÉX.",4,1,5,0,0,0,
21-sep-20,VER.,"CORDOBA, VER.",4,1,5,3,0,129,
27-sep-20,VER.,"MARTINEZ DE LA TORRE, VER.",2,3,5,2,0,0,
30-sep-20,VER.,"MARTINEZ DE LA TORRE, VER.",1,4,5,1,0,317,
02-oct-20,VER.,"CORDOBA, VER.",1,4,5,1,0,9539,
08-oct-20,CD. MÉX.,"GUSTAVO A. MADERO, CD. MÉX.",0,5,5,0,0,0,
27-oct-20,CD. MÉX.,"GUSTAVO A. MADERO, CD. MÉX.",4,1,5,0,0,460,
06-nov-20,CD. MÉX.,"GUSTAVO A. MADERO, CD. MÉX.",3,2,5,0,0,0,
13-nov-20,CD. MÉX.,"MIGUEL HGO., CD. MÉX.",3,2,5,0,0,65,
07-dic-20,CD. MÉX.,"GUSTAVO A. MADERO, CD. MÉX.",2,3,5,0,0,0,
15-dic-20,CD. MÉX.,"GUSTAVO A. MADERO, CD. MÉX.",0,5,5,0,0,0,
18-dic-20,CD. MÉX.,"CUAUHTEMOC, CD. MÉX.",0,5,5,0,0,0,
23-sep-21,GTO.,"SALAMANCA, GTO.",5,0,5,0,0,138,
08-nov-21,CD. MÉX.,"COYOACAN, CD. MÉX.",5,0,5,0,0,310,
09-nov-21,TLAX.,"TLAX., TLAX.",4,1,5,0,0,46,
11-nov-21,TLAX.,"TLAX., TLAX.",3,2,5,0,0,0,
12-nov-21,TLAX.,"ZACATELCO, TLAX.",4,1,5,0,0,0,
17-nov-21,TLAX.,"SAN PABLO DEL MONTE, TLAX.",4,1,5,0,0,0,
30-nov-21,TLAX.,"YAUHQUEMECAN, TLAX.",2,3,5,0,0,0,
08-dic-21,SON.,"HERMOSILLO, SON.",5,0,5,1,0,17,
09-dic-21,SON.,"HERMOSILLO, SON.",3,2,5,2,0,0,
09-dic-21,CHIH.,"CHIH., CHIH.",5,0,5,0,1,499,
13-dic-21,CHIH.,"JUÁREZ, CHIH.",3,2,5,2,0,948,
16-dic-21,CHIH.,"JUÁREZ, CHIH.",4,1,5,0,0,975,
04-feb-22,GTO.,"PURISIMA DEL RINCON, GTO.",2,3,5,0,0,0,
10-feb-22,CD. MÉX.,"BENITO JUAREZ, CD. MÉX.",0,5,5,0,0,78,
14-may-22,S.L.P.,"SAN LUIS POTOSI, S.L.P.",5,0,5,0,0,0,
20-may-22,SIN.,"CHOIX, SIN.",0,5,5,0,0,0,
20-may-22,SIN.,"EL FUERTE, SIN.",4,1,5,0,0,0,
20-may-22,VER.,"XALAPA, VER.",5,0,5,18,0,363,
23-may-22,VER.,"XALAPA, VER.",4,1,5,28,0,959,
27-may-22,CD. MÉX.,"MIGUEL HGO., CD. MÉX.",4,1,5,0,0,321,
30-may-22,VER.,"COATZACOALCOS, VER.",5,0,5,9,0,210,
10-jun-22,CD. MÉX.,"ALVARO OBREGON, CD. MÉX.",3,2,5,0,0,180,
15-jun-22,SIN.,"AHOME, SIN.",4,1,5,0,1,0,
20-jun-22,CHIH.,"JUÁREZ, CHIH.",3,2,5,6,0,378,
24-jun-22,CD. MÉX.,"BENITO JUAREZ, CD. MÉX.",5,0,5,0,0,218,
27-jun-22,CD. MÉX.,"TLALPAN, CD. MÉX.",3,2,5,0,0,14,
27-jun-22,JAL.,"ZAPOPAN, JAL.",3,2,5,1,0,78,
28-jun-22,S.L.P.,"SAN LUIS POTOSI, S.L.P.",5,0,5,0,0,0,
02-jul-22,CHIH.,"JUÁREZ, CHIH.",5,0,5,14,0,298,
05-jul-22,CD. MÉX.,"ALVARO OBREGON, CD. MÉX.",3,2,5,0,0,465,
06-jul-22,CD. MÉX.,"MIGUEL HGO., CD. MÉX.",5,0,5,0,6,242,
06-jul-22,DGO.,"DGO., DGO.",4,1,5,1,1,0,
07-jul-22,DGO.,"DGO., DGO.",4,1,5,1,1,0,
11-jul-22,VER.,"TUXPAM, VER.",3,2,5,0,0,76,
13-jul-22,CD. MÉX.,"MIGUEL HGO., CD. MÉX.",5,0,5,0,0,109,
21-jul-22,CD. MÉX.,"BENITO JUAREZ, CD. MÉX.",2,3,5,0,0,7,
22-jul-22,CD. MÉX.,"BENITO JUAREZ, CD. MÉX.",2,3,5,0,0,8,
08-ago-22,COAH.,"ARTEAGA, COAH.",2,3,5,0,0,39,
09-ago-22,COAH.,"ARTEAGA, COAH.",4,1,5,0,0,4,
12-ago-22,GRO.,"ACAPULCO DE JUAREZ, GRO.",4,1,5,22,1,2462,
15-ago-22,SIN.,"SIN., SIN.",5,0,5,0,1,0,
24-ago-22,COAH.,"SALTILLO, COAH.",3,2,5,10,0,76,
25-ago-22,DGO.,"GOMEZ PALACIO, DGO.",2,3,5,0,0,0,
29-ago-22,MOR.,"TEMIXCO, MOR.",2,3,5,1,1,485,
29-ago-22,TAMPS.,"REYNOSA, TAMPS.",3,2,5,3,0,63,
30-ago-22,MÉX.,"ATIZAPAN, MEX.",4,1,5,5,0,357,
05-sep-22,MÉX.,"NAUCALPAN DE JUAREZ, MEX.",5,0,5,0,0,286,
06-sep-22,CD. MÉX.,"TLAHUAC, CD. MÉX.",3,2,5,0,0,48,
07-sep-22,CD. MÉX.,"VENUSTIANO CARRANZA, CD. MÉX.",5,0,5,0,0,32,
09-sep-22,COAH.,"ACUÑA, COAH.",5,0,5,0,0,0,
17-sep-22,MÉX.,"CUAUTITLAN IZCALLI, MEX.",5,0,5,0,0,30,
19-sep-22,MÉX.,"TECAMAC, MEX.",3,2,5,0,3,492,
20-sep-22,MÉX.,"TECAMAC, MEX.",4,1,5,0,0,234,
21-sep-22,CD. MÉX.,"TLAHUAC, CD. MÉX.",5,0,5,0,0,263,
21-sep-22,CD. MÉX.,"CUAUHTEMOC, CD. MÉX.",4,1,5,0,0,0,
21-sep-22,S.L.P.,"SAN LUIS POTOSI, S.L.P.",5,0,5,0,0,0,
23-sep-22,CD. MÉX.,"GUSTAVO A. MADERO, CD. MÉX.",3,2,5,0,0,10,
27-sep-22,COAH.,"SABINAS, COAH.",0,5,5,0,0,0,
30-sep-22,CD. MÉX.,"TLALPAN, CD. MÉX.",4,1,5,0,0,162,
06-oct-22,CHIH.,"JUÁREZ, CHIH.",4,1,5,4,0,401,
20-oct-22,CD. MÉX.,"CUAUHTEMOC, CD. MÉX.",5,0,5,0,0,56,
20-oct-22,SIN.,"MAZATLAN, SIN.",4,1,5,2,2,639,
21-oct-22,MÉX.,"HUEHUETOCA, MEX.",4,1,5,0,0,303,
21-oct-22,SIN.,"MAZATLAN, SIN.",5,0,5,4,0,936,
26-oct-22,CHIH.,"JUÁREZ, CHIH.",3,2,5,3,0,0,
27-oct-22,MOR.,"CUAUTLA, MOR.",5,0,5,16,0,25,
28-oct-22,N.L.,"MONTERREY, N.L.",5,0,5,0,0,139,
31-oct-22,MÉX.,"SAN MATEO ATENCO, MEX.",4,1,5,0,0,0,
03-nov-22,MÉX.,"ZINACANTEPEC, MEX.",4,1,5,0,1,0,
04-nov-22,CD. MÉX.,"GUSTAVO A. MADERO, CD. MÉX.",4,1,5,0,0,222,
04-nov-22,VER.,"POZA RICA DE HGO., VER.",5,0,5,20,0,214,
08-nov-22,VER.,"PAPANTLA, VER.",3,2,5,9,0,135,
08-nov-22,MOR.,"AYALA, MOR.",4,1,5,13,1,0,
10-nov-22,CHIS.,"SAN CRISTOBAL DE LAS CASAS, CHIS.",2,3,5,6,0,1306,
11-nov-22,VER.,"PAPANTLA, VER.",4,1,5,5,0,145,
22-nov-22,CD. MÉX.,"COYOACAN, CD. MÉX.",2,3,5,0,0,0,
23-nov-22,CD. MÉX.,"CUAUHTEMOC, CD. MÉX.",4,1,5,0,0,304,
30-nov-22,SIN.,"CULIACAN, SIN.",4,1,5,0,2,36,
05-dic-22,SIN.,"CULIACAN, SIN.",3,2,5,0,0,67,
06-dic-22,CHIH.,"JUÁREZ, CHIH.",2,3,5,0,1,0,
06-dic-22,SIN.,"CULIACAN, SIN.",2,3,5,0,1,0,
07-dic-22,SIN.,"CULIACAN, SIN.",4,1,5,0,1,0,
10-dic-22,CHIH.,"CHIH., CHIH.",5,0,5,18,1,1013,
10-dic-22,CHIH.,"OJINAGA, CHIH.",0,5,5,0,0,0,
15-dic-22,SIN.,"CULIACAN, SIN.",4,1,5,0,0,250,
17-dic-22,MICH.,"MORELIA, MICH.",3,2,5,0,2,122,
08-feb-23,Cd. de México,"ALVARO OBREGON, CD. MÉX.",5,0,5,0,0,132,
15-mar-23,México,"IXTAPALUCA, MEX.",4,1,5,0,0,45,
16-mar-23,Chihuahua,"CHIHUAHUA, CHIH.",5,0,5,31,0,198,
23-mar-23,Cd. de México,"LA MAGDALENA CONTRERAS, CD. MÉX.",5,0,5,0,0,65,
29-mar-23,Cd. de México,"ALVARO OBREGON, CD. MÉX.",4,1,5,0,0,11,
13-abr-23,Cd. de México,"CUAUHTEMOC, CD. MÉX.",3,2,5,0,0,0,
19-abr-23,Cd. de México,"IZTAPALAPA, CD. MÉX.",2,3,5,0,1,0,
29-abr-23,Querétaro,"CORREGIDORA, QRO.",4,1,5,0,16,50,
03-may-23,Cd. de México,"XOCHIMILCO, CD. MÉX.",4,1,5,0,0,164,
07-may-23,Michoacán,"URUAPAN, MICH.",5,0,5,135,0,0,
15-may-23,Cd. de México,"CUAUHTEMOC, CD. MÉX.",5,0,5,0,0,140,
17-may-23,Cd. de México,"TLALPAN, CD. MÉX.",4,1,5,0,0,46,
18-may-23,Michoacán,"TARIMBARO, MICH.",3,2,5,142,0,275,
23-may-23,Cd. de México,"CUAUHTEMOC, CD. MÉX.",4,1,5,0,0,156,
24-may-23,Cd. de México,"AZCAPOTZALCO, CD. MÉX.",5,0,5,0,0,0,
26-may-23,Cd. de México,"CUAUHTEMOC, CD. MÉX.",3,2,5,0,0,11,
27-may-23,Michoacán,"HIDALGO, MICH.",5,0,5,55,0,15,
31-may-23,Sinaloa,"SINALOA, SIN.",1,4,5,0,1,3,
06-jun-23,Sinaloa,"EL FUERTE, SIN.",4,1,5,0,0,0,
08-jun-23,Sinaloa,"CHOIX, SIN.",1,4,5,0,0,0,
09-jun-23,Sinaloa,"EL FUERTE, SIN.",3,2,5,0,0,0,
16-jun-23,México,"LERMA, MEX.",3,2,5,0,0,554,
19-jun-23,México,"TECAMAC, MEX.",4,1,5,0,0,37,
21-jun-23,Cd. de México,"CUAUHTEMOC, CD. MÉX.",3,2,5,0,0,19,
23-jun-23,México,"ZUMPANGO, MEX.",4,1,5,1,0,0,
23-jun-23,Cd. de México,"CUAUHTEMOC, CD. MÉX.",5,0,5,0,0,69,
23-jun-23,Tlaxcala,"APIZACO, TLAX.",4,1,5,0,0,0,
26-jun-23,Sinaloa,"GUASAVE, SIN.",3,2,5,0,0,40,
28-jun-23,Sinaloa,"AHOME, SIN.",5,0,5,0,0,64,
28-jun-23,Querétaro,"QUERETARO, QRO.",5,0,5,0,0,0,
29-jun-23,Michoacán,"ZAMORA, MICH.",1,4,5,16,0,"1,540",
29-jun-23,Guanajuato,"CELAYA, GTO.",4,1,5,1,6,392,
30-jun-23,Sinaloa,"AHOME, SIN.",4,1,5,0,0,185,
30-jun-23,Sinaloa,"GUASAVE, SIN.",0,5,5,0,0,0,
05-jul-23,Sinaloa,"GUASAVE, SIN.",3,2,5,0,0,0,
06-jul-23,México,"CHIMALHUACAN, MEX.",4,1,5,0,0,0,
11-jul-23,Cd. de México,"IZTAPALAPA, CD. MÉX.",4,1,5,0,0,104,
11-jul-23,México,"COYOTEPEC, MEX.",2,3,5,0,0,0,
17-jul-23,México,"JOCOTITLAN, MEX.",1,4,5,0,0,0,
02-ago-23,Cd. de México,"MIGUEL HIDALGO, CD. MÉX.",3,2,5,0,2,310,
03-ago-23,Cd. de México,"CUAUHTEMOC, CD. MÉX.",4,1,5,0,0,0,
10-ago-23,Cd. de México,"CUAUHTEMOC, CD. MÉX.",5,0,5,0,0,290,
15-ago-23,Sinaloa,"MOCORITO, SIN.",4,1,5,0,1,0,
23-ago-23,Tabasco,"CARDENAS, TAB.",4,1,5,2,0,264,
28-ago-23,Morelos,"JIUTEPEC, MOR.",4,1,5,0,0,0,
19-sep-23,Michoacán,"LA PIEDAD, MICH.",0,5,5,0,0,0,
20-sep-23,Chihuahua,"JUÁREZ, CHIH.",3,2,5,2,0,323,
02-oct-23,Chihuahua,"JUÁREZ, CHIH.",2,3,5,0,0,0,
03-oct-23,Sinaloa,"ROSARIO, SIN.",3,2,5,0,0,0,
05-oct-23,Cd. de México,"CUAUHTEMOC, CD. MÉX.",2,3,5,0,0,0,
09-oct-23,Cd. de México,"VENUSTIANO CARRANZA, CD. MÉX.",4,1,5,0,1,701,
09-oct-23,Sinaloa,"ESCUINAPA, SIN.",3,2,5,0,0,47,
16-oct-23,Cd. de México,"CUAUHTEMOC, CD. MÉX.",1,4,5,0,0,387,
25-oct-23,Tlaxcala,"APIZACO, TLAX.",5,0,5,0,0,0,
31-oct-23,Sinaloa,"SAN IGNACIO, SIN.",2,3,5,0,5,50,
27-nov-23,México,"NEZAHUALCOYOTL, MEX.",5,0,5,3,0,669,
30-nov-23,Cd. de México,"COYOACAN, CD. MÉX.",5,0,5,0,0,175,
06-dic-23,Sinaloa,"CULIACAN, SIN.",3,2,5,0,0,44,
15-dic-23,Cd. de México,"COYOACAN, CD. MÉX.",0,5,5,0,0,24,
20-dic-23,Chihuahua,"JUÁREZ, CHIH.",4,1,5,17,0,546,
24-may-24,Cd. de México,"XOCHIMILCO, CD. MÉX.",3,2,5,0,0,269,
12-jun-24,Michoacán,"APATZINGAN, MICH.",1,4,5,7,0,0,
17-jun-24,Sinaloa,"SALVADOR ALVARADO, SIN.",5,0,5,0,0,25,
17-jun-24,Sinaloa,"CULIACAN, SIN.",4,1,5,0,0,114,
17-jun-24,Michoacán,"BUENAVISTA, MICH.",5,0,5,30,0,500,
18-jun-24,Sinaloa,"SALVADOR ALVARADO, SIN.",5,0,5,0,0,141,
18-jun-24,Sinaloa,"COSALA, SIN.",3,2,5,0,0,349,
19-jun-24,Sinaloa,"MOCORITO, SIN.",4,1,5,0,0,334,
19-jun-24,Sinaloa,"BADIRAGUATO, SIN.",0,5,5,0,0,0,
20-jun-24,Sinaloa,"CULIACAN, SIN.",5,0,5,0,0,"1,890",
21-jun-24,Sinaloa,"MOCORITO, SIN.",5,0,5,0,0,0,
21-jun-24,Michoacán,"TURICATO, MICH.",3,2,5,10,0,147,
24-jun-24,Sinaloa,"MAZATLAN, SIN.",0,5,5,3,0,4,
25-jun-24,Sinaloa,"MOCORITO, SIN.",4,1,5,0,0,200,
25-jun-24,Sinaloa,"BADIRAGUATO, SIN.",2,3,5,0,0,25,
22-jun-24,Baja California,"TIJUANA, B.C.",2,3,5,20,0,161,
27-jun-24,Sinaloa,"MOCORITO, SIN.",4,1,5,0,0,"2,075",
06-feb-13,B.C.,"TIJUANA, B.C.",2,2,4,0,0,0,
10-feb-13,TAMPS.,"CIUDAD MADERO, TAMPS.",4,0,4,31,0,1270,
13-feb-13,VER.,"COATZACOALCOS, VER.",4,0,4,0,0,0,
13-feb-13,TAMPS.,"VICTORIA, TAMPS.",3,1,4,2,0,145,
14-feb-13,TAMPS.,"NUEVO LAREDO, TAMPS.",0,4,4,0,0,0,
14-feb-13,B.C.,"MEXICALI, B.C.",4,0,4,0,0,0,
15-feb-13,TAMPS.,"REYNOSA, TAMPS.",1,3,4,0,0,0,
15-feb-13,TAMPS.,"MATAMOROS, TAMPS.",0,4,4,0,0,0,
16-feb-13,B.C.,"TIJUANA, B.C.",0,4,4,0,0,0,
17-feb-13,TAMPS.,"CIUDAD MADERO, TAMPS.",4,0,4,12,0,1452,
20-feb-13,CAMP.,"CAMP., CAMP.",3,1,4,0,0,0,
21-feb-13,HGO.,"HUEJUTLA DE REYES, HGO.",4,0,4,0,0,0,
22-feb-13,HGO.,"HUEJUTLA DE REYES, HGO.",3,1,4,0,0,0,
22-feb-13,TAMPS.,"TAMPICO, TAMPS.",3,1,4,25,0,1098,
25-feb-13,CHIS.,"SAN CRISTOBAL DE LAS CASAS, CHIS.",2,2,4,1,0,1450,
26-feb-13,HGO.,"TULA DE ALLENDE, HGO.",4,0,4,0,0,0,
27-feb-13,TAMPS.,"VICTORIA, TAMPS.",3,1,4,0,0,0,
01-mar-13,CHIH.,"CHIH., CHIH.",3,1,4,3,0,534,
01-mar-13,N.L.,"GRAL. ESCOBEDO, N.L.",2,2,4,3,0,100,
02-mar-13,N.L.,"GARCIA, N.L.",2,2,4,0,0,432,
03-mar-13,N.L.,"SANTA CATARINA, N.L.",3,1,4,10,0,496,
04-mar-13,N.L.,"MONTERREY, N.L.",3,1,4,13,0,1208,
04-mar-13,N.L.,"JUAREZ, N.L.",2,2,4,0,0,300,
05-mar-13,HGO.,"TULANCINGO DE BRAVO, HGO.",3,1,4,0,0,0,
05-mar-13,N.L.,"APODACA, N.L.",2,2,4,10,0,806,
05-mar-13,N.L.,"GARCIA, N.L.",1,3,4,0,0,50,
06-mar-13,N.L.,"APODACA, N.L.",3,1,4,0,0,1455,
06-mar-13,N.L.,"SAN NICOLAS DE LOS GARZA, N.L.",2,2,4,0,0,1768,
06-mar-13,N.L.,"JUAREZ, N.L.",2,2,4,4,0,100,
06-mar-13,TAMPS.,"VICTORIA, TAMPS.",2,2,4,0,0,25,
07-mar-13,N.L.,"SAN NICOLAS DE LOS GARZA, N.L.",2,2,4,0,0,2945,
08-mar-13,CHIH.,"IGNACIO ZARAGOZA, CHIH.",2,2,4,0,0,0,
08-mar-13,TAMPS.,"TAMPICO, TAMPS.",2,2,4,1,0,575,
09-mar-13,TAMPS.,"VICTORIA, TAMPS.",4,0,4,7,0,112,
09-mar-13,MICH.,"LAZARO CARDENAS, MICH.",4,0,4,3,0,44,
12-mar-13,HGO.,"TIZAYUCA, HGO.",2,2,4,0,0,34,
13-mar-13,S.L.P.,"CIUDAD VALLES, S.L.P.",4,0,4,0,2,0,
14-mar-13,HGO.,"IXMIQUILPAN, HGO.",1,3,4,0,0,0,
15-mar-13,HGO.,"TIZAYUCA, HGO.",3,1,4,0,1,0,
19-mar-13,HGO.,"ACTOPAN, HGO.",4,0,4,0,0,0,
20-mar-13,CAMP.,"CARMEN, CAMP.",4,0,4,0,0,0,
21-mar-13,HGO.,"TIZAYUCA, HGO.",4,0,4,0,0,60,
21-mar-13,S.L.P.,"CIUDAD VALLES, S.L.P.",4,0,4,0,0,0,
22-mar-13,S.L.P.,"SOLEDAD DE GRACIANO SANCHEZ, S.L.P.",3,1,4,0,1,0,
22-mar-13,S.L.P.,"CIUDAD VALLES, S.L.P.",3,1,4,0,0,0,
22-mar-13,VER.,"VER., VER.",4,0,4,0,0,0,
23-mar-13,S.L.P.,"SOLEDAD DE GRACIANO SANCHEZ, S.L.P.",2,2,4,0,0,45,
26-mar-13,HGO.,"TEPEAPULCO, HGO.",2,2,4,0,0,0,
26-mar-13,S.L.P.,"CIUDAD VALLES, S.L.P.",3,1,4,0,1,0,
26-mar-13,TAMPS.,"VICTORIA, TAMPS.",4,0,4,0,0,50,
01-abr-13,N.L.,"CERRALVO, N.L.",2,2,4,0,0,0,
02-abr-13,MICH.,"ZAMORA, MICH.",2,2,4,0,0,0,
02-abr-13,MICH.,"SALVADOR ESCALANTE, MICH.",2,2,4,0,0,0,
02-abr-13,MICH.,"LA HUACANA, MICH.",3,1,4,0,0,0,
03-abr-13,Q. ROO,"BENITO JUAREZ, Q. ROO",2,2,4,0,0,133,
04-abr-13,MEX.,"IXTLAHUACA, MEX.",1,3,4,1,0,92,
05-abr-13,COL.,"COL., COL.",4,0,4,0,0,150,
05-abr-13,Q. ROO,"OTHON P. BLANCO, Q. ROO",3,1,4,0,0,39,
06-abr-13,MEX.,"VALLE DE BRAVO, MEX.",3,1,4,0,0,0,
08-abr-13,OAX.,"SANTIAGO PINOTEPA NACIONAL, OAX.",0,4,4,0,0,0,
08-abr-13,AGS.,"COSÍO, AGS.",4,0,4,0,0,0,
08-abr-13,MEX.,"ALMOLOYA DE JUAREZ, MEX.",3,1,4,1,0,95,
08-abr-13,MEX.,"MALINALCO, MEX.",4,0,4,1,0,0,
09-abr-13,MEX.,"MALINALCO, MEX.",1,3,4,2,0,0,
11-abr-13,NAY.,"TEPIC, NAY.",3,1,4,1,0,0,
11-abr-13,B.C.,"TIJUANA, B.C.",3,1,4,0,0,0,
12-abr-13,QRO.,"AMEALCO DE BONFIL, QRO.",0,4,4,0,0,0,
13-abr-13,MEX.,"ALMOLOYA DE JUAREZ, MEX.",3,1,4,0,0,0,
13-abr-13,MEX.,"IXTAPAN DE LA SAL, MEX.",3,1,4,1,0,0,
13-abr-13,HGO.,"TIZAYUCA, HGO.",3,1,4,0,0,829,
13-abr-13,B.C.,"TIJUANA, B.C.",1,3,4,0,0,0,
14-abr-13,MEX.,"MALINALCO, MEX.",4,0,4,2,0,1,
17-abr-13,TAMPS.,"BURGOS, TAMPS.",1,3,4,0,0,0,
17-abr-13,MICH.,"APATZINGAN, MICH.",3,1,4,0,0,0,
18-abr-13,MICH.,"TACAMBARO, MICH.",2,2,4,0,0,0,
18-abr-13,S.L.P.,"MATEHUALA, S.L.P.",3,1,4,0,0,0,
18-abr-13,TAMPS.,"MATAMOROS, TAMPS.",3,1,4,0,0,0,
18-abr-13,B.C.,"TIJUANA, B.C.",3,1,4,0,0,0,
19-abr-13,S.L.P.,"MATEHUALA, S.L.P.",3,1,4,0,0,0,
19-abr-13,NAY.,"ACAPONETA, NAY.",2,2,4,0,0,0,
19-abr-13,MICH.,"MARAVATIO, MICH.",4,0,4,0,0,0,
19-abr-13,MICH.,"LA PIEDAD, MICH.",4,0,4,0,0,0,
20-abr-13,JAL.,"CABO CORRIENTES, JAL.",0,4,4,0,0,0,
20-abr-13,MICH.,"LA PIEDAD, MICH.",4,0,4,0,0,0,
22-abr-13,MICH.,"TACAMBARO, MICH.",1,3,4,0,0,0,
24-abr-13,QRO.,"HUIMILPAN, QRO.",3,1,4,0,0,0,
25-abr-13,N.L.,"HUALAHUISES, N.L.",2,2,4,4,0,50,
26-abr-13,HGO.,"HUEHUETLA, HGO.",3,1,4,0,0,200,
27-abr-13,OAX.,"SALINA CRUZ, OAX.",4,0,4,0,0,0,
27-abr-13,JAL.,"CABO CORRIENTES, JAL.",0,4,4,0,0,0,
28-abr-13,MICH.,"MARAVATIO, MICH.",3,1,4,0,2,0,
30-abr-13,B.C.,"TIJUANA, B.C.",4,0,4,0,0,0,
30-abr-13,TAMPS.,"VICTORIA, TAMPS.",4,0,4,3,0,60,
30-abr-13,B.C.,"TIJUANA, B.C.",4,0,4,0,0,0,
04-may-13,TAMPS.,"EL MANTE, TAMPS.",3,1,4,1,0,0,
06-may-13,SIN.,"CHOIX, SIN.",2,2,4,0,4,0,
07-may-13,MICH.,"JIQUILPAN, MICH.",3,1,4,0,0,0,
07-may-13,B.C.,"TIJUANA, B.C.",0,4,4,0,0,0,
08-may-13,TAB.,"CENTRO, TAB.",1,3,4,0,0,0,
08-may-13,TAB.,"CARDENAS, TAB.",1,3,4,0,0,0,
09-may-13,N.L.,"MARIN, N.L.",2,2,4,0,0,600,
09-may-13,N.L.,"CHINA, N.L.",1,3,4,7,0,200,
09-may-13,MICH.,"ZACAPU, MICH.",2,2,4,0,0,0,
10-may-13,B.C.S.,"MULEGÉ, B.C.S.",4,0,4,0,0,0,
10-may-13,B.C.,"MEXICALI, B.C.",2,2,4,0,4,0,
11-may-13,MICH.,"ZACAPU, MICH.",3,1,4,0,0,0,
11-may-13,B.C.,"TIJUANA, B.C.",1,3,4,0,0,0,
15-may-13,MICH.,"HUETAMO, MICH.",2,2,4,0,0,0,
16-may-13,MICH.,"ZITACUARO, MICH.",2,2,4,0,0,0,
17-may-13,YUC.,"KANASIN, YUC.",2,2,4,0,0,32,
17-may-13,MICH.,"ZITACUARO, MICH.",2,2,4,0,0,0,
17-may-13,MICH.,"LAZARO CARDENAS, MICH.",4,0,4,1,0,0,
18-may-13,JAL.,"TOMATLAN, JAL.",1,3,4,0,0,0,
18-may-13,JAL.,"CABO CORRIENTES, JAL.",4,0,4,0,0,0,
19-may-13,JAL.,"TOMATLAN, JAL.",1,3,4,0,0,0,
21-may-13,N.L.,"LOS RAMONES, N.L.",1,3,4,0,0,50,
23-may-13,JAL.,"TOMATLAN, JAL.",2,2,4,0,0,0,
24-may-13,CHIH.,"HGO. DEL PARRAL, CHIH.",3,1,4,0,0,0,
24-may-13,MICH.,"COAHUAYANA, MICH.",2,2,4,0,0,0,
25-may-13,MICH.,"URUAPAN, MICH.",4,0,4,0,0,0,
27-may-13,N.L.,"DR. ARROYO, N.L.",2,2,4,11,0,100,
28-may-13,SIN.,"SALVADOR ALVARADO, SIN.",3,1,4,0,11,0,
28-may-13,CHIH.,"JUÁREZ, CHIH.",4,0,4,0,0,0,
28-may-13,MICH.,"COAHUAYANA, MICH.",2,2,4,0,0,0,
29-may-13,MICH.,"ZITACUARO, MICH.",2,2,4,1,0,0,
30-may-13,N.L.,"DR. ARROYO, N.L.",3,1,4,7,0,50,
30-may-13,CHIH.,"JUÁREZ, CHIH.",3,1,4,0,0,0,
31-may-13,MICH.,"HUETAMO, MICH.",2,2,4,2,0,0,
01-jun-13,N.L.,"MIER Y NORIEGA, N.L.",3,1,4,107,0,4823,
02-jun-13,N.L.,"LAMPAZOS DE NARANJO, N.L.",2,2,4,0,0,0,
02-jun-13,MICH.,"LAZARO CARDENAS, MICH.",2,2,4,0,0,0,
04-jun-13,MICH.,"BUENAVISTA, MICH.",3,1,4,0,0,0,
05-jun-13,COAH.,"TORREÓN, COAH.",3,1,4,0,0,0,
06-jun-13,CAMP.,"HECELCHAKÁN, CAMP.",2,2,4,0,0,0,
07-jun-13,SIN.,"ANGOSTURA, SIN.",1,3,4,0,8,0,
07-jun-13,B.C.,"TIJUANA, B.C.",0,4,4,0,0,0,
08-jun-13,COAH.,"TORREÓN, COAH.",3,1,4,0,0,0,
10-jun-13,B.C.,"ENSENADA, B.C.",0,4,4,0,0,0,
12-jun-13,COAH.,"TORREÓN, COAH.",4,0,4,0,0,0,
12-jun-13,TAMPS.,"VICTORIA, TAMPS.",2,2,4,1,0,0,
13-jun-13,B.C.,"TIJUANA, B.C.",2,2,4,0,0,0,
14-jun-13,SIN.,"MOCORITO, SIN.",4,0,4,0,1,0,
14-jun-13,COAH.,"TORREÓN, COAH.",4,0,4,0,0,0,
15-jun-13,JAL.,"AUTLAN DE NAVARRO, JAL.",3,1,4,0,0,127,
20-jun-13,NAY.,"RUIZ, NAY.",4,0,4,0,0,0,
21-jun-13,B.C.,"TIJUANA, B.C.",3,1,4,0,0,0,
21-jun-13,NAY.,"RUIZ, NAY.",3,1,4,0,0,0,
22-jun-13,NAY.,"RUIZ, NAY.",3,1,4,0,0,0,
24-jun-13,CHIS.,"CHICOMUSELO, CHIS.",2,2,4,0,0,0,
24-jun-13,CHIS.,"CHICOMUSELO, CHIS.",2,2,4,0,0,0,
25-jun-13,NAY.,"RUIZ, NAY.",3,1,4,0,0,0,
26-jun-13,B.C.,"ENSENADA, B.C.",0,4,4,0,0,0,
27-jun-13,SIN.,"BADIRAGUATO, SIN.",1,3,4,0,0,0,
27-jun-13,GTO.,"GTO., GTO.",3,1,4,0,0,40,
02-jul-13,MOR.,"CUERNAVACA, MOR.",3,1,4,0,0,241,
03-jul-13,CHIS.,"TUXTLA GUTIÉRREZ, CHIS.",3,1,4,1,0,151,
05-jul-13,COAH.,"TORREÓN, COAH.",3,1,4,0,0,0,
06-jul-13,CHIS.,"TAPACHULA, CHIS.",4,0,4,0,0,0,
08-jul-13,PUE.,"PUE., PUE.",2,2,4,14,9,750,
09-jul-13,B.C.,"MEXICALI, B.C.",1,3,4,0,0,0,
11-jul-13,PUE.,"PUE., PUE.",3,1,4,3,0,881,
12-jul-13,N.L.,"APODACA, N.L.",2,2,4,6,0,8212,
12-jul-13,PUE.,"CHALCHICOMULA DE SESMA, PUE.",3,1,4,0,0,0,
13-jul-13,B.C.S.,"LA PAZ, B.C.S.",1,3,4,0,0,0,
14-jul-13,CHIS.,"MAZATÁN, CHIS.",2,2,4,1,0,0,
16-jul-13,B.C.,"MEXICALI, B.C.",3,1,4,0,0,0,
19-jul-13,B.C.,"TECATE, B.C.",0,4,4,0,0,0,
19-jul-13,PUE.,"PUE., PUE.",2,2,4,1,0,121,
19-jul-13,NAY.,"AHUACATLAN, NAY.",3,1,4,1,0,11,
19-jul-13,QRO.,"QUERETARO, QRO.",4,0,4,0,0,0,
25-jul-13,CHIS.,"TUXTLA GUTIÉRREZ, CHIS.",3,1,4,6,0,1476,
26-jul-13,GRO.,"CHILPANCINGO DE LOS BRAVO, GRO.",3,1,4,0,2,0,
28-jul-13,N.L.,"GRAL. ESCOBEDO, N.L.",3,1,4,1,0,46,
29-jul-13,N.L.,"GUADALUPE, N.L.",1,3,4,0,1,176,
01-ago-13,TLAX.,"TLAX., TLAX.",2,2,4,1,0,70,
01-ago-13,SIN.,"COSALA, SIN.",2,2,4,0,0,0,
01-ago-13,CHIS.,"TUXTLA GUTIÉRREZ, CHIS.",3,1,4,0,2,1032,
02-ago-13,TLAX.,"TLAX., TLAX.",3,1,4,1,0,0,
02-ago-13,B.C.,"TIJUANA, B.C.",2,2,4,0,0,0,
02-ago-13,CHIS.,"TUXTLA GUTIÉRREZ, CHIS.",3,1,4,0,1,1032,
02-ago-13,TLAX.,"TLAX., TLAX.",2,2,4,3,0,0,
06-ago-13,COAH.,"TORREÓN, COAH.",4,0,4,0,1,0,
06-ago-13,COAH.,"TORREÓN, COAH.",4,0,4,0,1,0,
08-ago-13,SIN.,"ELOTA, SIN.",3,1,4,0,2,0,
08-ago-13,CHIH.,"ASCENSIÓN, CHIH.",1,3,4,0,0,0,
08-ago-13,TLAX.,"TLAX., TLAX.",1,3,4,1,0,79,
09-ago-13,COAH.,"TORREÓN, COAH.",1,3,4,0,0,0,
11-ago-13,B.C.,"TECATE, B.C.",2,2,4,0,0,0,
12-ago-13,N.L.,"SAN NICOLAS DE LOS GARZA, N.L.",3,1,4,1,0,72,
12-ago-13,N.L.,"SANTA CATARINA, N.L.",2,2,4,5,0,273,
13-ago-13,B.C.,"TIJUANA, B.C.",0,4,4,0,0,0,
14-ago-13,B.C.,"MEXICALI, B.C.",2,2,4,0,0,0,
14-ago-13,GRO.,"CHILPANCINGO DE LOS BRAVO, GRO.",1,3,4,0,6,102,
14-ago-13,N.L.,"SANTA CATARINA, N.L.",4,0,4,0,0,184,
15-ago-13,B.C.,"TIJUANA, B.C.",2,2,4,0,0,0,
16-ago-13,PUE.,"ATLIXCO, PUE.",1,3,4,0,0,172,
18-ago-13,PUE.,"ATLIXCO, PUE.",3,1,4,1,1,711,
19-ago-13,TLAX.,"TLAX., TLAX.",3,1,4,0,0,0,
20-ago-13,AGS.,"AGS., AGS.",3,1,4,0,0,0,
21-ago-13,TLAX.,"TLAX., TLAX.",1,3,4,0,0,0,
22-ago-13,AGS.,"AGS., AGS.",4,0,4,0,0,149,
22-ago-13,SIN.,"MAZATLAN, SIN.",3,1,4,0,0,0,
22-ago-13,HGO.,"JACALA DE LEDEZMA, HGO.",4,0,4,0,0,0,
23-ago-13,B.C.,"TIJUANA, B.C.",2,2,4,0,0,0,
24-ago-13,B.C.,"TIJUANA, B.C.",3,1,4,0,0,0,
25-ago-13,N.L.,"VALLECILLO, N.L.",1,3,4,13,0,0,
28-ago-13,TLAX.,"TLAX., TLAX.",2,2,4,1,0,0,
29-ago-13,JAL.,"JAMAY, JAL.",1,3,4,1,0,0,
30-ago-13,SIN.,"MAZATLAN, SIN.",2,2,4,0,4,0,
30-ago-13,PUE.,"ATLIXCO, PUE.",2,2,4,9,0,0,
30-ago-13,JAL.,"GUADALAJARA, JAL.",3,1,4,0,1,0,
30-ago-13,JAL.,"TEPATITLAN DE MOR., JAL.",0,4,4,0,0,0,
31-ago-13,SON.,"HERMOSILLO, SON.",2,2,4,2,0,114,
31-ago-13,HGO.,"SAN BARTOLO TUTOTEPEC, HGO.",1,3,4,0,0,0,
31-ago-13,HGO.,"TEPEAPULCO, HGO.",1,3,4,0,0,0,
06-sep-13,TAMPS.,"VICTORIA, TAMPS.",4,0,4,0,1,0,
09-sep-13,MOR.,"XOCHITEPEC, MOR.",2,2,4,1,0,327,
09-sep-13,B.C.,"TIJUANA, B.C.",1,3,4,0,0,0,
09-sep-13,TAMPS.,"VICTORIA, TAMPS.",3,1,4,0,1,0,
10-sep-13,SON.,"HERMOSILLO, SON.",0,4,4,0,0,0,
11-sep-13,B.C.,"TIJUANA, B.C.",2,2,4,0,0,0,
17-sep-13,SON.,"SAN LUIS RIO COLORADO, SON.",1,3,4,0,3,0,
22-sep-13,PUE.,"ATLIXCO, PUE.",4,0,4,0,0,1070,
23-sep-13,SIN.,"CULIACAN, SIN.",3,1,4,3,3,9,
24-sep-13,B.C.,"TIJUANA, B.C.",2,2,4,0,0,0,
25-sep-13,ZAC.,"GUADALUPE, ZAC.",4,0,4,2,0,0,
26-sep-13,ZAC.,"JALPA, ZAC.",4,0,4,0,0,100,
01-oct-13,SIN.,"ROSARIO, SIN.",0,4,4,0,1,0,
01-oct-13,B.C.,"TIJUANA, B.C.",2,2,4,0,0,0,
01-oct-13,B.C.,"ENSENADA, B.C.",2,2,4,0,0,0,
03-oct-13,N.L.,"LAMPAZOS DE NARANJO, N.L.",0,4,4,3,0,125,
04-oct-13,N.L.,"LAMPAZOS DE NARANJO, N.L.",1,3,4,0,0,0,
07-oct-13,AGS.,"AGS., AGS.",3,1,4,0,0,495,
08-oct-13,ZAC.,"GUADALUPE, ZAC.",4,0,4,1,0,215,
08-oct-13,ZAC.,"FRESNILLO, ZAC.",3,1,4,0,2,0,
09-oct-13,OAX.,"CIUDAD IXTEPEC, OAX.",2,2,4,6,0,0,
09-oct-13,COAH.,"PIEDRAS NEGRAS, COAH.",3,1,4,1,0,50,
10-oct-13,COAH.,"SALTILLO, COAH.",4,0,4,0,0,311,
11-oct-13,COAH.,"SABINAS, COAH.",2,2,4,3,0,72,
11-oct-13,N.L.,"VILLALDAMA, N.L.",0,4,4,2,0,250,
14-oct-13,ZAC.,"CAÑITAS DE FELIPE PESCADOR, ZAC.",1,3,4,4,0,110,
15-oct-13,B.C.,"MEXICALI, B.C.",3,1,4,0,0,0,
17-oct-13,AGS.,"AGS., AGS.",3,1,4,2,0,53,
18-oct-13,ZAC.,"VALPARAISO, ZAC.",3,1,4,2,0,0,
22-oct-13,SON.,"HERMOSILLO, SON.",2,2,4,1,0,82,
24-oct-13,COAH.,"PIEDRAS NEGRAS, COAH.",0,4,4,0,0,313,
25-oct-13,COAH.,"PIEDRAS NEGRAS, COAH.",1,3,4,0,0,47,
25-oct-13,N.L.,"ITURBIDE, N.L.",1,3,4,0,0,0,
26-oct-13,N.L.,"ITURBIDE, N.L.",1,3,4,0,0,0,
26-oct-13,COAH.,"RAMOS ARIZPE, COAH.",3,1,4,0,0,0,
27-oct-13,N.L.,"ITURBIDE, N.L.",2,2,4,0,0,0,
30-oct-13,N.L.,"LINARES, N.L.",3,1,4,2,0,80,
31-oct-13,N.L.,"HUALAHUISES, N.L.",4,0,4,0,0,0,
31-oct-13,B.C.,"TIJUANA, B.C.",3,1,4,0,0,0,
31-oct-13,CHIS.,"TAPACHULA, CHIS.",4,0,4,0,0,140,
04-nov-13,TAMPS.,"VICTORIA, TAMPS.",4,0,4,0,0,0,
05-nov-13,N.L.,"MARIN, N.L.",1,3,4,3,1,700,
06-nov-13,N.L.,"HIGUERAS, N.L.",2,2,4,25,0,0,
11-nov-13,TAMPS.,"VICTORIA, TAMPS.",2,2,4,4,0,164,
16-nov-13,HGO.,"TEPEJI DEL RIO DE OCAMPO, HGO.",4,0,4,0,0,0,
20-nov-13,PUE.,"PUE., PUE.",4,0,4,2,2,205,
23-nov-13,SON.,"GUAYMAS, SON.",3,1,4,0,0,620,
23-nov-13,SON.,"NAVOJOA, SON.",4,0,4,2,0,30,
25-nov-13,N.L.,"GRAL. ESCOBEDO, N.L.",2,2,4,2,0,50,
26-nov-13,SON.,"CABORCA, SON.",3,1,4,2,0,90,
26-nov-13,TAB.,"CARDENAS, TAB.",4,0,4,0,3,0,
27-nov-13,SON.,"NOGALES, SON.",3,1,4,4,0,123,
27-nov-13,NAY.,"COMPOSTELA, NAY.",2,2,4,0,0,0,
29-nov-13,N.L.,"GRAL. ESCOBEDO, N.L.",3,1,4,222,0,100,
02-dic-13,SON.,"GENERAL PLUTARCO ELIAS CALLES, SON.",2,2,4,3,0,66,
06-dic-13,CHIS.,"PALENQUE, CHIS.",3,1,4,1,0,20,
07-dic-13,TAMPS.,"VICTORIA, TAMPS.",4,0,4,6,0,100,
07-dic-13,SON.,"NAVOJOA, SON.",3,1,4,0,0,18,
12-dic-13,COAH.,"MONCLOVA, COAH.",1,3,4,0,0,0,
12-dic-13,CAMP.,"CAMP., CAMP.",3,1,4,0,0,0,
13-dic-13,TAMPS.,"REYNOSA, TAMPS.",1,3,4,0,0,0,
13-dic-13,TAMPS.,"TAMPICO, TAMPS.",4,0,4,1,0,213,
14-dic-13,PUE.,"ATLIXCO, PUE.",3,1,4,0,0,146,
19-dic-13,TAMPS.,"TAMPICO, TAMPS.",3,1,4,2,0,189,
14-ene-14,Q. ROO,"BENITO JUAREZ, Q. ROO",4,0,4,0,1,245,
23-ene-14,TAMPS.,"NUEVO LAREDO, TAMPS.",1,3,4,4,0,1133,
04-feb-14,COAH.,"TORREÓN, COAH.",3,1,4,0,0,0,
04-feb-14,COAH.,"MÚZQUIZ, COAH.",2,2,4,2,0,49,
05-feb-14,VER.,"BOCA DEL RIO, VER.",3,1,4,0,0,0,
06-feb-14,CAMP.,"CAMP., CAMP.",2,2,4,0,0,0,
07-feb-14,COAH.,"TORREÓN, COAH.",2,2,4,0,0,35,
07-feb-14,COAH.,"SALTILLO, COAH.",3,1,4,0,0,106,
08-feb-14,VER.,"BOCA DEL RIO, VER.",4,0,4,0,0,0,
10-feb-14,VER.,"BOCA DEL RIO, VER.",3,1,4,0,0,0,
10-feb-14,MICH.,"LAZARO CARDENAS, MICH.",4,0,4,0,0,4,
11-feb-14,COAH.,"SALTILLO, COAH.",4,0,4,2,0,77,
18-feb-14,COAH.,"MÚZQUIZ, COAH.",2,2,4,0,0,69,
21-feb-14,COAH.,"SALTILLO, COAH.",3,1,4,0,0,98,
27-feb-14,COAH.,"PIEDRAS NEGRAS, COAH.",3,1,4,0,0,0,
28-feb-14,COAH.,"SALTILLO, COAH.",2,2,4,0,0,19,
03-mar-14,VER.,"XALAPA, VER.",3,1,4,0,0,0,
05-mar-14,N.L.,"SAN NICOLAS DE LOS GARZA, N.L.",3,1,4,1,0,0,
06-mar-14,MICH.,"LAZARO CARDENAS, MICH.",4,0,4,1,0,0,
08-mar-14,N.L.,"SAN NICOLAS DE LOS GARZA, N.L.",1,3,4,2,0,234,
09-mar-14,VER.,"ZONGOLICA, VER.",2,2,4,0,0,0,
10-mar-14,VER.,"VER., VER.",3,1,4,0,2,9,
10-mar-14,ZAC.,"VALPARAISO, ZAC.",4,0,4,5,0,0,
13-mar-14,VER.,"VER., VER.",4,0,4,0,0,200,
14-mar-14,TAMPS.,"MATAMOROS, TAMPS.",1,3,4,0,0,300,
14-mar-14,VER.,"SAN RAFAEL, VER.",3,1,4,0,0,0,
19-mar-14,N.L.,"MONTERREY, N.L.",3,1,4,49,0,940,
20-mar-14,VER.,"VER., VER.",2,2,4,5,0,0,
21-mar-14,VER.,"VER., VER.",3,1,4,0,0,243,
21-mar-14,QRO.,"QUERETARO, QRO.",4,0,4,0,0,0,
24-mar-14,ZAC.,"SOMBRERETE, ZAC.",4,0,4,1,0,0,
24-mar-14,MEX.,"ZUMPANGO, MEX.",2,2,4,0,0,0,
26-mar-14,SON.,"HERMOSILLO, SON.",3,1,4,17,0,15,
26-mar-14,B.C.,"TECATE, B.C.",1,3,4,0,0,0,
27-mar-14,SON.,"HERMOSILLO, SON.",4,0,4,0,0,27,
31-mar-14,HGO.,"MIXQUIAHUALA DE JUAREZ, HGO.",4,0,4,0,0,0,
02-abr-14,HGO.,"MIXQUIAHUALA DE JUAREZ, HGO.",4,0,4,0,0,0,
04-abr-14,AGS.,"AGS., AGS.",4,0,4,3,0,240,
04-abr-14,QRO.,"QUERETARO, QRO.",0,4,4,0,3,0,
05-abr-14,B.C.,"TIJUANA, B.C.",2,2,4,0,0,0,
07-abr-14,MEX.,"CUAUTITLAN, MEX.",3,1,4,0,0,0,
09-abr-14,SON.,"CAJEME, SON.",2,2,4,0,0,157,
10-abr-14,OAX.,"MIAHUATLAN DE PORFIRIO DIAZ, OAX.",2,2,4,0,0,0,
10-abr-14,CHIH.,"DELICIAS, CHIH.",3,1,4,0,1,0,
10-abr-14,B.C.,"MEXICALI, B.C.",4,0,4,0,0,0,
15-abr-14,CHIS.,"ACACOYAGUA, CHIS.",3,1,4,0,0,0,
18-abr-14,MEX.,"NAUCALPAN DE JUAREZ, MEX.",0,4,4,0,0,0,
19-abr-14,N.L.,"APODACA, N.L.",2,2,4,2,0,100,
21-abr-14,OAX.,"PINOTEPA DE DON LUIS, OAX.",4,0,4,0,0,0,
21-abr-14,MEX.,"HUIXQUILUCAN, MEX.",3,1,4,0,0,0,
22-abr-14,N.L.,"APODACA, N.L.",2,2,4,23,0,300,
22-abr-14,SIN.,"SALVADOR ALVARADO, SIN.",2,2,4,0,0,0,
23-abr-14,JAL.,"ZAPOPAN, JAL.",4,0,4,0,0,0,
23-abr-14,OAX.,"EL ESPINAL, OAX.",0,4,4,4,0,0,
23-abr-14,MEX.,"CHIMALHUACAN, MEX.",4,0,4,0,0,0,
23-abr-14,B.C.,"ENSENADA, B.C.",2,2,4,0,0,0,
25-abr-14,B.C.,"TIJUANA, B.C.",1,3,4,0,0,0,
25-abr-14,MEX.,"CHIMALHUACAN, MEX.",3,1,4,0,5,0,
25-abr-14,CHIH.,"AHUMADA, CHIH.",2,2,4,1,0,0,
26-abr-14,TAMPS.,"REYNOSA, TAMPS.",0,4,4,0,0,0,
28-abr-14,OAX.,"OAX. DE JUAREZ, OAX.",2,2,4,1,0,56,
29-abr-14,OAX.,"SANTA MARIA HUAZOLOTITLAN, OAX.",1,3,4,0,0,0,
30-abr-14,SIN.,"ANGOSTURA, SIN.",0,4,4,0,0,0,
01-may-14,MEX.,"NAUCALPAN DE JUAREZ, MEX.",4,0,4,8,0,73,
03-may-14,MEX.,"HUEHUETOCA, MEX.",4,0,4,0,0,0,
06-may-14,CHIS.,"SAN CRISTOBAL DE LAS CASAS, CHIS.",3,1,4,1,0,0,
06-may-14,B.C.,"TIJUANA, B.C.",2,2,4,0,0,0,
06-may-14,B.C.,"MEXICALI, B.C.",0,4,4,0,0,0,
07-may-14,OAX.,"OAX. DE JUAREZ, OAX.",0,4,4,0,0,0,
07-may-14,NAY.,"SANTIAGO IXCUINTLA, NAY.",2,2,4,0,0,0,
08-may-14,SIN.,"GUASAVE, SIN.",2,2,4,0,0,0,
09-may-14,OAX.,"PINOTEPA DE DON LUIS, OAX.",4,0,4,0,0,0,
09-may-14,OAX.,"OAX. DE JUAREZ, OAX.",2,2,4,1,0,4,
12-may-14,N.L.,"SAN PEDRO GARZA GARCIA, N.L.",2,2,4,7,0,500,
13-may-14,OAX.,"OAX. DE JUAREZ, OAX.",0,4,4,0,0,0,
13-may-14,OAX.,"LOMA BONITA, OAX.",2,2,4,0,0,0,
14-may-14,B.C.,"MEXICALI, B.C.",2,2,4,0,0,0,
16-may-14,SIN.,"MOCORITO, SIN.",4,0,4,0,4,0,
16-may-14,MEX.,"NOPALTEPEC, MEX.",3,1,4,0,12,0,
17-may-14,TAMPS.,"MATAMOROS, TAMPS.",0,4,4,0,0,0,
17-may-14,MEX.,"NAUCALPAN DE JUAREZ, MEX.",4,0,4,0,2,0,
19-may-14,MEX.,"METEPEC, MEX.",4,0,4,1,0,42,
20-may-14,MEX.,"TENANGO DEL VALLE, MEX.",3,1,4,0,0,0,
21-may-14,CHIH.,"JUÁREZ, CHIH.",0,4,4,0,0,14,
21-may-14,COAH.,"PARRAS, COAH.",4,0,4,0,0,13,
22-may-14,COAH.,"PARRAS, COAH.",1,3,4,2,0,75,
27-may-14,SIN.,"BADIRAGUATO, SIN.",2,2,4,0,0,0,
27-may-14,B.C.,"ENSENADA, B.C.",1,3,4,0,0,0,
28-may-14,MEX.,"HUIXQUILUCAN, MEX.",3,1,4,0,0,0,
28-may-14,B.C.,"TIJUANA, B.C.",3,1,4,0,0,0,
29-may-14,NAY.,"SANTA MARIA DEL ORO, NAY.",4,0,4,0,0,0,
30-may-14,CHIH.,"CHIH., CHIH.",3,1,4,1,1,218,
31-may-14,MEX.,"ZINACANTEPEC, MEX.",3,1,4,2,1,140,
02-jun-14,SIN.,"BADIRAGUATO, SIN.",3,1,4,0,0,0,
02-jun-14,MEX.,"TEJUPILCO, MEX.",4,0,4,0,0,0,
02-jun-14,MEX.,"TEQUIXQUIAC, MEX.",4,0,4,0,0,0,
03-jun-14,MEX.,"HUEYPOXTLA, MEX.",1,3,4,0,0,37,
04-jun-14,MEX.,"TOLUCA, MEX.",1,3,4,0,0,0,
04-jun-14,YUC.,"KANASIN, YUC.",3,1,4,0,0,0,
04-jun-14,MEX.,"TEQUIXQUIAC, MEX.",4,0,4,0,0,0,
06-jun-14,OAX.,"OAX. DE JUAREZ, OAX.",1,3,4,1,0,7,
06-jun-14,MEX.,"SULTEPEC, MEX.",3,1,4,0,0,0,
09-jun-14,SIN.,"CHOIX, SIN.",4,0,4,0,0,0,
09-jun-14,SIN.,"SIN., SIN.",2,2,4,0,0,0,
11-jun-14,B.C.,"TIJUANA, B.C.",2,2,4,0,0,0,
11-jun-14,B.C.,"ENSENADA, B.C.",4,0,4,0,0,0,
11-jun-14,MEX.,"SAN FELIPE DEL PROGRESO, MEX.",2,2,4,0,0,0,
12-jun-14,MEX.,"ALMOLOYA DE ALQUISIRAS, MEX.",2,2,4,1,0,0,
12-jun-14,N.L.,"LOS ALDAMAS, N.L.",1,3,4,4,0,126,
13-jun-14,MEX.,"JILOTEPEC, MEX.",1,3,4,0,0,0,
16-jun-14,SIN.,"SIN., SIN.",1,3,4,0,0,0,
16-jun-14,MEX.,"COACALCO DE BERRIOZABAL, MEX.",3,1,4,1,0,0,
16-jun-14,MEX.,"CUAUTITLAN, MEX.",4,0,4,0,0,0,
17-jun-14,B.C.,"TIJUANA, B.C.",2,2,4,0,0,0,
18-jun-14,MEX.,"VALLE DE CHALCO SOLIDARIDAD, MEX.",1,3,4,0,0,0,
19-jun-14,SIN.,"SIN., SIN.",4,0,4,0,0,0,
19-jun-14,CHIH.,"CHIH., CHIH.",3,1,4,0,0,0,
24-jun-14,SIN.,"NAVOLATO, SIN.",3,1,4,0,0,0,
25-jun-14,MEX.,"TLALNEPANTLA DE BAZ, MEX.",4,0,4,1,0,75,
01-jul-14,NAY.,"ACAPONETA, NAY.",3,1,4,0,0,0,
11-jul-14,TAMPS.,"MATAMOROS, TAMPS.",4,0,4,0,0,0,
11-jul-14,N.L.,"LOS HERRERAS, N.L.",0,4,4,0,0,300,
11-jul-14,TAMPS.,"MATAMOROS, TAMPS.",4,0,4,0,0,0,
14-jul-14,QRO.,"QUERETARO, QRO.",2,2,4,0,0,0,
15-jul-14,COAH.,"MÚZQUIZ, COAH.",2,2,4,0,0,0,
16-jul-14,QRO.,"QUERETARO, QRO.",1,3,4,0,5,0,
17-jul-14,QRO.,"QUERETARO, QRO.",3,1,4,0,5,0,
18-jul-14,B.C.,"TIJUANA, B.C.",2,2,4,0,0,0,
18-jul-14,CHIH.,"JUÁREZ, CHIH.",1,3,4,0,0,0,
24-jul-14,NAY.,"JALA, NAY.",0,4,4,0,0,0,
30-jul-14,JAL.,"GUADALAJARA, JAL.",2,2,4,0,0,0,
04-ago-14,SIN.,"MAZATLAN, SIN.",3,1,4,0,0,0,
09-ago-14,B.C.,"TIJUANA, B.C.",3,1,4,0,0,0,
10-ago-14,CHIH.,"JUÁREZ, CHIH.",3,1,4,0,1,0,
11-ago-14,CHIH.,"JUÁREZ, CHIH.",2,2,4,0,0,0,
12-ago-14,CHIH.,"JUÁREZ, CHIH.",3,1,4,0,0,0,
13-ago-14,B.C.,"MEXICALI, B.C.",0,4,4,0,0,0,
14-ago-14,B.C.,"ENSENADA, B.C.",0,4,4,0,0,0,
15-ago-14,B.C.,"MEXICALI, B.C.",3,1,4,0,0,0,
15-ago-14,CHIH.,"JUÁREZ, CHIH.",3,1,4,0,0,0,
16-ago-14,N.L.,"MONTERREY, N.L.",1,3,4,115,0,640,
21-ago-14,SIN.,"ROSARIO, SIN.",2,2,4,0,0,0,
22-ago-14,PUE.,"PUE., PUE.",3,1,4,0,2,124,
22-ago-14,B.C.,"TIJUANA, B.C.",2,2,4,0,0,0,
26-ago-14,SIN.,"ROSARIO, SIN.",4,0,4,0,2,0,
26-ago-14,NAY.,"IXTLAN DEL RIO, NAY.",1,3,4,0,0,0,
27-ago-14,SIN.,"ROSARIO, SIN.",2,2,4,0,0,0,
28-ago-14,CHIH.,"JUÁREZ, CHIH.",4,0,4,0,0,0,
29-ago-14,SIN.,"ROSARIO, SIN.",4,0,4,0,2,0,
29-ago-14,PUE.,"SAN PEDRO CHOLULA, PUE.",4,0,4,1,0,387,
30-ago-14,MICH.,"LAZARO CARDENAS, MICH.",3,1,4,0,5,600,
31-ago-14,MICH.,"LAZARO CARDENAS, MICH.",4,0,4,5,0,13,
01-sep-14,B.C.,"ENSENADA, B.C.",1,3,4,0,0,0,
04-sep-14,N.L.,"GRAL. ESCOBEDO, N.L.",4,0,4,171,0,30,
06-sep-14,SON.,"HERMOSILLO, SON.",1,3,4,0,0,0,
06-sep-14,AGS.,"EL LLANO, AGS.",2,2,4,1,0,52,
08-sep-14,N.L.,"APODACA, N.L.",3,1,4,0,0,0,
09-sep-14,MICH.,"LAZARO CARDENAS, MICH.",4,0,4,4,0,9,
10-sep-14,N.L.,"GRAL. ESCOBEDO, N.L.",4,0,4,121,0,3500,
18-sep-14,MICH.,"VISTA HERMOSA, MICH.",0,4,4,0,0,0,
23-sep-14,MICH.,"VISTA HERMOSA, MICH.",1,3,4,0,0,0,
25-sep-14,COL.,"COL., COL.",3,1,4,0,0,0,
27-sep-14,B.C.,"TIJUANA, B.C.",3,1,4,0,0,0,
27-sep-14,MICH.,"LAZARO CARDENAS, MICH.",3,1,4,1,0,36,
29-sep-14,MICH.,"LAZARO CARDENAS, MICH.",2,2,4,0,0,50,
01-oct-14,MICH.,"LAZARO CARDENAS, MICH.",2,2,4,0,0,0,
02-oct-14,SIN.,"ELOTA, SIN.",1,3,4,0,0,0,
04-oct-14,MICH.,"HUETAMO, MICH.",4,0,4,2,0,2,
06-oct-14,SIN.,"ELOTA, SIN.",3,1,4,0,0,0,
07-oct-14,MOR.,"CUERNAVACA, MOR.",1,3,4,2,2,250,
08-oct-14,SIN.,"ESCUINAPA, SIN.",1,3,4,0,0,0,
08-oct-14,SON.,"CABORCA, SON.",2,2,4,2,0,20,
09-oct-14,MICH.,"PARACHO, MICH.",3,1,4,1,0,506,
09-oct-14,SON.,"CABORCA, SON.",3,1,4,0,0,20,
09-oct-14,MOR.,"CUERNAVACA, MOR.",0,4,4,0,0,0,
09-oct-14,N.L.,"MONTERREY, N.L.",3,1,4,65,0,4323,
10-oct-14,B.C.,"TIJUANA, B.C.",4,0,4,0,0,0,
10-oct-14,SIN.,"ELOTA, SIN.",2,2,4,0,0,0,
11-oct-14,SON.,"CAJEME, SON.",3,1,4,2,0,8,
12-oct-14,MOR.,"CUERNAVACA, MOR.",3,1,4,3,2,605,
13-oct-14,SON.,"CANANEA, SON.",2,2,4,1,0,0,
13-oct-14,SON.,"NAVOJOA, SON.",3,1,4,0,0,20,
14-oct-14,MICH.,"PARACHO, MICH.",2,2,4,0,0,487,
14-oct-14,SON.,"CABORCA, SON.",1,3,4,0,0,60,
14-oct-14,B.C.,"ENSENADA, B.C.",0,4,4,0,0,0,
15-oct-14,COAH.,"TORREÓN, COAH.",4,0,4,0,0,0,
15-oct-14,TLAX.,"TLAX., TLAX.",4,0,4,4,0,0,
15-oct-14,SIN.,"CONCORDIA, SIN.",2,2,4,0,0,0,
16-oct-14,TLAX.,"TLAX., TLAX.",3,1,4,2,0,0,
16-oct-14,CHIH.,"JUÁREZ, CHIH.",2,2,4,0,0,0,
17-oct-14,B.C.,"ENSENADA, B.C.",1,3,4,0,0,0,
17-oct-14,MICH.,"HGO., MICH.",3,1,4,0,0,0,
17-oct-14,MICH.,"HGO., MICH.",3,1,4,0,0,0,
17-oct-14,CHIS.,"SAN CRISTOBAL DE LAS CASAS, CHIS.",1,3,4,0,1,0,
18-oct-14,MOR.,"CUERNAVACA, MOR.",3,1,4,0,2,0,
18-oct-14,CHIS.,"PICHUCALCO, CHIS.",4,0,4,0,0,0,
18-oct-14,CHIS.,"TUXTLA GUTIÉRREZ, CHIS.",3,1,4,1,1,569,
18-oct-14,CHIS.,"TONALÁ, CHIS.",1,3,4,1,0,2,
19-oct-14,GRO.,"TELOLOAPAN, GRO.",1,3,4,0,0,0,
19-oct-14,CHIS.,"TUXTLA GUTIÉRREZ, CHIS.",4,0,4,4,0,1170,
20-oct-14,MICH.,"PATZCUARO, MICH.",2,2,4,4,0,0,
21-oct-14,MICH.,"ZACAPU, MICH.",3,1,4,1,0,7553,
21-oct-14,NAY.,"AHUACATLAN, NAY.",0,4,4,0,0,0,
22-oct-14,MICH.,"HGO., MICH.",1,3,4,0,0,77,
22-oct-14,MICH.,"ZACAPU, MICH.",2,2,4,2,0,1015,
22-oct-14,CHIS.,"SAN CRISTOBAL DE LAS CASAS, CHIS.",2,2,4,0,0,50,
23-oct-14,SON.,"GUAYMAS, SON.",1,3,4,1,0,94,
23-oct-14,CHIH.,"JUÁREZ, CHIH.",0,4,4,0,0,0,
23-oct-14,NAY.,"AHUACATLAN, NAY.",0,4,4,0,0,0,
26-oct-14,CHIS.,"VILLAFLORES, CHIS.",4,0,4,2,0,0,
26-oct-14,CHIS.,"TONALÁ, CHIS.",1,3,4,5,0,593,
27-oct-14,AGS.,"AGS., AGS.",3,1,4,3,0,0,
28-oct-14,CHIS.,"OCOSINGO, CHIS.",2,2,4,7,0,303,
01-nov-14,SON.,"HERMOSILLO, SON.",2,2,4,35,0,69,
01-nov-14,SON.,"CABORCA, SON.",1,3,4,0,0,0,
03-nov-14,CHIS.,"VILLAFLORES, CHIS.",3,1,4,0,0,0,
03-nov-14,CHIS.,"OCOZOCOAUTLA DE ESPINOSA, CHIS.",1,3,4,0,2,521,
05-nov-14,NAY.,"AMATLAN DE CAÑAS, NAY.",1,3,4,0,0,0,
05-nov-14,GRO.,"PUNGARABATO, GRO.",4,0,4,0,0,0,
06-nov-14,CHIS.,"COMITAN DE DOMÍNGUEZ, CHIS.",4,0,4,1,0,199,
06-nov-14,CHIS.,"SAN CRISTOBAL DE LAS CASAS, CHIS.",3,1,4,1,0,0,
07-nov-14,CHIS.,"COMITAN DE DOMÍNGUEZ, CHIS.",3,1,4,230,0,0,
07-nov-14,CHIS.,"TAPACHULA, CHIS.",4,0,4,6,0,1815,
10-nov-14,CHIS.,"VILLAFLORES, CHIS.",2,2,4,0,4,0,
11-nov-14,SIN.,"SALVADOR ALVARADO, SIN.",2,2,4,0,0,0,
11-nov-14,CHIS.,"TAPACHULA, CHIS.",2,2,4,0,0,1180,
11-nov-14,AGS.,"AGS., AGS.",3,1,4,1,0,0,
13-nov-14,CHIS.,"OCOZOCOAUTLA DE ESPINOSA, CHIS.",1,3,4,0,0,1319,
14-nov-14,AGS.,"CALVILLO, AGS.",2,2,4,1,0,0,
19-nov-14,SIN.,"SALVADOR ALVARADO, SIN.",1,3,4,0,0,0,
28-nov-14,NAY.,"ACAPONETA, NAY.",2,2,4,0,0,0,
10-dic-14,CHIS.,"BENEMÉRITO DE LAS AMÉRICAS, CHIS.",2,2,4,2,0,0,
16-dic-14,CHIS.,"BENEMÉRITO DE LAS AMÉRICAS, CHIS.",2,2,4,0,0,0,
18-dic-14,GRO.,"ACAPULCO DE JUAREZ, GRO.",0,4,4,0,0,390,
19-dic-14,COAH.,"TORREÓN, COAH.",4,0,4,0,0,0,
20-dic-14,DGO.,"LERDO, DGO.",0,4,4,0,2,0,
20-dic-14,DGO.,"DGO., DGO.",4,0,4,4,0,0,
26-dic-14,DGO.,"DGO., DGO.",2,2,4,1,0,0,
28-dic-14,DGO.,"LERDO, DGO.",2,2,4,3,0,0,
29-dic-14,DGO.,"GOMEZ PALACIO, DGO.",2,2,4,0,0,0,
04-ene-15,DGO.,"LERDO, DGO.",1,3,4,0,0,0,
05-ene-15,DGO.,"DGO., DGO.",4,0,4,0,0,0,
26-ene-15,DGO.,"DGO., DGO.",2,2,4,1,0,0,
07-feb-15,B.C.,"TIJUANA, B.C.",2,2,4,0,0,0,
19-feb-15,B.C.,"MEXICALI, B.C.",2,2,4,0,0,0,
20-feb-15,B.C.,"TIJUANA, B.C.",3,1,4,0,0,0,
20-feb-15,GRO.,"ACAPULCO DE JUAREZ, GRO.",4,0,4,0,0,0,
25-feb-15,HGO.,"PACHUCA DE SOTO, HGO.",4,0,4,0,0,500,
26-feb-15,B.C.,"ENSENADA, B.C.",0,4,4,0,0,0,
04-mar-15,B.C.,"MEXICALI, B.C.",1,3,4,0,0,0,
11-mar-15,B.C.,"MEXICALI, B.C.",1,3,4,0,0,0,
12-mar-15,B.C.,"MEXICALI, B.C.",1,3,4,0,0,0,
17-mar-15,OAX.,"CIUDAD IXTEPEC, OAX.",1,3,4,0,0,0,
18-mar-15,DGO.,"GOMEZ PALACIO, DGO.",2,2,4,0,2,0,
20-mar-15,OAX.,"OAX. DE JUAREZ, OAX.",0,4,4,4,0,89,
25-mar-15,HGO.,"TEPEJI DEL RIO DE OCAMPO, HGO.",2,2,4,0,0,0,
27-mar-15,OAX.,"OAX. DE JUAREZ, OAX.",0,4,4,6,0,119,
29-mar-15,OAX.,"OAX. DE JUAREZ, OAX.",0,4,4,2,0,0,
02-ago-15,TAMPS.,"MATAMOROS, TAMPS.",2,2,4,0,0,0,
04-ago-15,MEX.,"TEXCOCO, MEX.",4,0,4,0,0,120,
04-ago-15,OAX.,"OAX. DE JUAREZ, OAX.",1,3,4,0,0,0,
05-ago-15,MEX.,"NAUCALPAN DE JUAREZ, MEX.",3,1,4,2,0,8,
06-ago-15,MEX.,"METEPEC, MEX.",2,2,4,0,1,0,
06-ago-15,MEX.,"HUEHUETOCA, MEX.",3,1,4,3,0,0,
07-ago-15,COAH.,"MONCLOVA, COAH.",3,1,4,1,0,280,
08-ago-15,OAX.,"OAX. DE JUAREZ, OAX.",1,3,4,2,0,0,
08-ago-15,MEX.,"METEPEC, MEX.",4,0,4,2,0,5,
10-ago-15,GRO.,"ACAPULCO DE JUAREZ, GRO.",4,0,4,0,0,0,
10-ago-15,COAH.,"SALTILLO, COAH.",3,1,4,0,0,27,
10-ago-15,COAH.,"SABINAS, COAH.",2,2,4,0,0,100,
10-ago-15,TAMPS.,"GUSTAVO DIAZ ORDAZ, TAMPS.",0,4,4,0,0,0,
11-ago-15,OAX.,"OAX. DE JUAREZ, OAX.",0,4,4,0,0,0,
11-ago-15,COAH.,"TORREÓN, COAH.",3,1,4,6,0,34,
11-ago-15,COAH.,"TORREÓN, COAH.",3,1,4,6,0,34,
11-ago-15,COAH.,"MONCLOVA, COAH.",3,1,4,0,1,10,
12-ago-15,OAX.,"MIAHUATLAN DE PORFIRIO DIAZ, OAX.",4,0,4,0,0,0,
12-ago-15,GRO.,"ACAPULCO DE JUAREZ, GRO.",1,3,4,0,0,0,
12-ago-15,TAMPS.,"MIER, TAMPS.",3,1,4,2,0,32,
13-ago-15,DGO.,"GOMEZ PALACIO, DGO.",3,1,4,1,0,0,
13-ago-15,COAH.,"MONCLOVA, COAH.",3,1,4,0,0,0,
13-ago-15,GRO.,"ACAPULCO DE JUAREZ, GRO.",4,0,4,0,0,22,
14-ago-15,GRO.,"COCHOAPA EL GRANDE, GRO.",3,1,4,0,0,0,
16-ago-15,DGO.,"DGO., DGO.",3,1,4,5,1,0,
17-ago-15,MEX.,"LERMA, MEX.",3,1,4,2,1,0,
17-ago-15,CHIH.,"ALDAMA, CHIH.",0,4,4,0,0,0,
17-ago-15,SIN.,"SALVADOR ALVARADO, SIN.",2,2,4,0,0,0,
17-ago-15,DGO.,"GOMEZ PALACIO, DGO.",4,0,4,0,0,0,
18-ago-15,SIN.,"CULIACAN, SIN.",0,4,4,0,0,0,
19-ago-15,COAH.,"SABINAS, COAH.",1,3,4,0,0,0,
19-ago-15,MEX.,"CUAUTITLAN, MEX.",4,0,4,0,0,0,
19-ago-15,TAMPS.,"MIER, TAMPS.",1,3,4,14,0,342,
20-ago-15,MEX.,"LERMA, MEX.",2,2,4,2,0,0,
21-ago-15,MEX.,"IXTAPAN DE LA SAL, MEX.",3,1,4,0,0,128,
21-ago-15,CHIH.,"CHIH., CHIH.",1,3,4,18,3,2102,
21-ago-15,CHIH.,"HGO. DEL PARRAL, CHIH.",4,0,4,0,0,0,
21-ago-15,TLAX.,"CALPULALPAN, TLAX.",1,3,4,0,0,0,
24-ago-15,MEX.,"SAN MATEO ATENCO, MEX.",4,0,4,4,0,0,
24-ago-15,COAH.,"SABINAS, COAH.",2,2,4,0,0,0,
24-ago-15,TAMPS.,"MIGUEL ALEMAN, TAMPS.",1,3,4,0,0,0,
24-ago-15,MEX.,"CHICONCUAC, MEX.",4,0,4,0,0,0,
25-ago-15,SON.,"CAJEME, SON.",4,0,4,1,0,0,
25-ago-15,MEX.,"TULTEPEC, MEX.",3,1,4,1,0,0,
26-ago-15,MEX.,"MEXICALTZINGO, MEX.",2,2,4,0,0,0,
28-ago-15,COAH.,"MONCLOVA, COAH.",2,2,4,1,0,30,
28-ago-15,COAH.,"ACUÑA, COAH.",3,1,4,1,0,0,
28-ago-15,GRO.,"GENERAL HELIODORO CASTILLO, GRO.",4,0,4,0,0,0,
31-ago-15,CHIH.,"CHIH., CHIH.",3,1,4,6,0,869,
31-ago-15,SON.,"HERMOSILLO, SON.",3,1,4,0,0,0,
31-ago-15,B.C.,"MEXICALI, B.C.",3,1,4,0,0,0,
01-sep-15,COAH.,"MONCLOVA, COAH.",4,0,4,1,0,2,
01-sep-15,GRO.,"CHILPANCINGO DE LOS BRAVO, GRO.",1,3,4,0,0,0,
01-sep-15,CHIH.,"GUADALUPE, CHIH.",1,3,4,0,0,0,
02-sep-15,SIN.,"ROSARIO, SIN.",3,1,4,0,0,0,
02-sep-15,SIN.,"COSALA, SIN.",2,2,4,0,1,0,
02-sep-15,CHIH.,"CHIH., CHIH.",3,1,4,6,1,712,
02-sep-15,MEX.,"COACALCO DE BERRIOZABAL, MEX.",3,1,4,3,6,0,
03-sep-15,OAX.,"OAX. DE JUAREZ, OAX.",0,4,4,2,0,0,
03-sep-15,B.C.,"TIJUANA, B.C.",1,3,4,0,0,0,
05-sep-15,DGO.,"DGO., DGO.",4,0,4,4,2,0,
05-sep-15,DGO.,"GOMEZ PALACIO, DGO.",4,0,4,0,0,0,
06-sep-15,TAMPS.,"MATAMOROS, TAMPS.",2,2,4,1,0,0,
07-sep-15,SIN.,"MAZATLAN, SIN.",2,2,4,0,4,0,
08-sep-15,SIN.,"ROSARIO, SIN.",2,2,4,0,0,0,
09-sep-15,COAH.,"PIEDRAS NEGRAS, COAH.",2,2,4,2,0,40,
09-sep-15,COAH.,"MONCLOVA, COAH.",3,1,4,0,0,51,
09-sep-15,CHIH.,"HGO. DEL PARRAL, CHIH.",3,1,4,0,0,0,
09-sep-15,MEX.,"TONATICO, MEX.",4,0,4,0,0,0,
11-sep-15,COAH.,"PIEDRAS NEGRAS, COAH.",2,2,4,1,0,100,
11-sep-15,MEX.,"TULTITLAN, MEX.",2,2,4,2,2,122,
12-sep-15,HGO.,"TOLCAYUCA, HGO.",1,3,4,0,0,380,
12-sep-15,TAMPS.,"MATAMOROS, TAMPS.",3,1,4,0,0,6,
12-sep-15,MEX.,"TONATICO, MEX.",4,0,4,0,0,0,
14-sep-15,COAH.,"SABINAS, COAH.",2,2,4,0,0,0,
14-sep-15,DGO.,"LERDO, DGO.",4,0,4,0,0,0,
17-sep-15,COAH.,"MONCLOVA, COAH.",4,0,4,1,0,100,
19-sep-15,GRO.,"OLINALA, GRO.",2,2,4,0,0,0,
21-sep-15,COAH.,"SABINAS, COAH.",2,2,4,0,0,0,
22-sep-15,COAH.,"MONCLOVA, COAH.",4,0,4,1,0,38,
23-sep-15,HGO.,"TOLCAYUCA, HGO.",1,3,4,0,0,380,
23-sep-15,COAH.,"SABINAS, COAH.",1,3,4,0,0,0,
23-sep-15,MEX.,"TENANGO DEL VALLE, MEX.",2,2,4,0,0,0,
23-sep-15,TAMPS.,"TAMPICO, TAMPS.",3,1,4,0,0,564,
23-sep-15,TAMPS.,"CIUDAD MADERO, TAMPS.",3,1,4,0,0,0,
24-sep-15,COAH.,"SALTILLO, COAH.",1,3,4,0,4,497,
24-sep-15,MEX.,"TENANCINGO, MEX.",2,2,4,0,0,0,
25-sep-15,B.C.,"MEXICALI, B.C.",1,3,4,0,0,0,
26-sep-15,B.C.,"TIJUANA, B.C.",4,0,4,0,0,0,
29-sep-15,HGO.,"TULANCINGO DE BRAVO, HGO.",2,2,4,0,0,0,
29-sep-15,SIN.,"ESCUINAPA, SIN.",1,3,4,0,0,0,
30-sep-15,DGO.,"DGO., DGO.",4,0,4,0,0,0,
30-sep-15,COAH.,"PIEDRAS NEGRAS, COAH.",3,1,4,3,0,0,
03-oct-15,MEX.,"TEOLOYUCAN, MEX.",2,2,4,0,0,0,
04-oct-15,DGO.,"DGO., DGO.",2,2,4,0,0,0,
05-oct-15,SIN.,"BADIRAGUATO, SIN.",0,4,4,0,0,0,
06-oct-15,SIN.,"NAVOLATO, SIN.",2,2,4,0,0,0,
09-oct-15,COAH.,"SALTILLO, COAH.",1,3,4,1,2,0,
12-oct-15,MEX.,"LA PAZ, MEX.",3,1,4,0,0,0,
12-oct-15,DGO.,"GOMEZ PALACIO, DGO.",2,2,4,0,0,0,
12-oct-15,N.L.,"ANAHUAC, N.L.",2,2,4,0,0,0,
13-oct-15,D.F.,"ALVARO OBREGON, D.F.",3,1,4,0,0,0,
13-oct-15,TAMPS.,"MIGUEL ALEMAN, TAMPS.",0,4,4,0,0,0,
14-oct-15,DGO.,"GOMEZ PALACIO, DGO.",3,1,4,0,0,0,
16-oct-15,COAH.,"MÚZQUIZ, COAH.",2,2,4,0,0,0,
18-oct-15,DGO.,"LERDO, DGO.",4,0,4,0,0,0,
20-oct-15,COAH.,"SALTILLO, COAH.",4,0,4,0,2,182,
21-oct-15,DGO.,"DGO., DGO.",4,0,4,50,0,0,
21-oct-15,HGO.,"IXMIQUILPAN, HGO.",2,2,4,0,0,0,
21-oct-15,B.C.,"MEXICALI, B.C.",0,4,4,0,0,0,
21-oct-15,MEX.,"XONACATLAN, MEX.",3,1,4,1,0,0,
21-oct-15,DGO.,"TLAHUALILO, DGO.",2,2,4,0,0,0,
22-oct-15,MEX.,"ZINACANTEPEC, MEX.",2,2,4,1,0,175,
22-oct-15,DGO.,"GOMEZ PALACIO, DGO.",1,3,4,0,0,0,
23-oct-15,COAH.,"TORREÓN, COAH.",3,1,4,4,0,36,
23-oct-15,GRO.,"GENERAL HELIODORO CASTILLO, GRO.",1,3,4,0,0,0,
23-oct-15,COAH.,"TORREÓN, COAH.",3,1,4,4,0,36,
23-oct-15,MEX.,"XONACATLAN, MEX.",2,2,4,0,0,0,
23-oct-15,B.C.,"TIJUANA, B.C.",3,1,4,0,0,0,
23-oct-15,B.C.,"ENSENADA, B.C.",3,1,4,0,0,0,
24-oct-15,MEX.,"XONACATLAN, MEX.",1,3,4,1,0,0,
26-oct-15,SIN.,"MOCORITO, SIN.",0,4,4,0,0,0,
26-oct-15,D.F.,"ALVARO OBREGON, D.F.",2,2,4,0,0,0,
27-oct-15,HGO.,"ACTOPAN, HGO.",1,3,4,0,0,0,
28-oct-15,COAH.,"MONCLOVA, COAH.",3,1,4,0,0,7,
28-oct-15,COAH.,"SABINAS, COAH.",3,1,4,0,0,0,
29-oct-15,COAH.,"TORREÓN, COAH.",4,0,4,22,0,59,
31-oct-15,DGO.,"GOMEZ PALACIO, DGO.",4,0,4,0,0,0,
03-nov-15,DGO.,"DGO., DGO.",2,2,4,8,0,0,
03-nov-15,COAH.,"TORREÓN, COAH.",3,1,4,14,0,50,
04-nov-15,COAH.,"TORREÓN, COAH.",4,0,4,2,0,37,
04-nov-15,SIN.,"MOCORITO, SIN.",2,2,4,0,0,0,
04-nov-15,COAH.,"SALTILLO, COAH.",4,0,4,1,0,38,
06-nov-15,B.C.,"MEXICALI, B.C.",2,2,4,0,0,0,
06-nov-15,COAH.,"PIEDRAS NEGRAS, COAH.",2,2,4,12,0,27,
08-nov-15,N.L.,"MONTERREY, N.L.",3,1,4,10,0,400,
09-nov-15,COAH.,"TORREÓN, COAH.",4,0,4,35,0,0,
10-nov-15,B.C.,"MEXICALI, B.C.",3,1,4,0,0,0,
10-nov-15,COAH.,"MONCLOVA, COAH.",3,1,4,0,0,46,
11-nov-15,MEX.,"ISIDRO FABELA, MEX.",3,1,4,1,2,0,
13-nov-15,N.L.,"MONTERREY, N.L.",3,1,4,0,0,250,
13-nov-15,COAH.,"PIEDRAS NEGRAS, COAH.",1,3,4,4,0,0,
13-nov-15,COAH.,"TORREÓN, COAH.",4,0,4,5,1,0,
17-nov-15,SON.,"CAJEME, SON.",2,2,4,1,0,500,
17-nov-15,MEX.,"XALATLACO, MEX.",2,2,4,2,0,0,
17-nov-15,MEX.,"OTUMBA, MEX.",4,0,4,2,1,193,
18-nov-15,MEX.,"RAYON, MEX.",2,2,4,0,1,0,
18-nov-15,B.C.,"MEXICALI, B.C.",2,2,4,0,0,0,
19-nov-15,MEX.,"XALATLACO, MEX.",3,1,4,1,0,0,
19-nov-15,COAH.,"MONCLOVA, COAH.",3,1,4,3,4,119,
19-nov-15,MOR.,"CUERNAVACA, MOR.",4,0,4,0,0,51,
20-nov-15,B.C.,"TIJUANA, B.C.",3,1,4,0,0,0,
23-nov-15,COAH.,"FRONTERA, COAH.",2,2,4,0,0,0,
27-nov-15,MOR.,"CUERNAVACA, MOR.",1,3,4,0,2,87,
27-nov-15,COAH.,"TORREÓN, COAH.",4,0,4,1,1,224,
28-nov-15,B.C.,"ENSENADA, B.C.",1,3,4,0,0,0,
28-nov-15,MEX.,"AXAPUSCO, MEX.",3,1,4,0,0,0,
29-nov-15,GRO.,"IGUALA DE LA INDEPENDENCIA, GRO.",1,3,4,346,0,0,
01-dic-15,COAH.,"SALTILLO, COAH.",2,2,4,0,0,0,
04-dic-15,SON.,"HERMOSILLO, SON.",4,0,4,0,0,0,
04-dic-15,GRO.,"TAXCO DE ALARCON, GRO.",3,1,4,0,1,0,
05-dic-15,GRO.,"TAXCO DE ALARCON, GRO.",1,3,4,0,0,0,
06-dic-15,COAH.,"SALTILLO, COAH.",4,0,4,0,1,0,
07-dic-15,QRO.,"SAN JUAN DEL RIO, QRO.",3,1,4,0,0,0,
09-dic-15,SON.,"HERMOSILLO, SON.",4,0,4,2,0,100,
09-dic-15,B.C.,"TIJUANA, B.C.",3,1,4,0,0,0,
10-dic-15,S.L.P.,"SALINAS, S.L.P.",4,0,4,0,0,0,
10-dic-15,SON.,"HERMOSILLO, SON.",4,0,4,2,0,0,
11-dic-15,SON.,"CABORCA, SON.",2,2,4,0,0,0,
11-dic-15,S.L.P.,"CIUDAD VALLES, S.L.P.",2,2,4,0,1,36,
12-dic-15,S.L.P.,"SALINAS, S.L.P.",4,0,4,0,0,0,
13-dic-15,S.L.P.,"SALINAS, S.L.P.",4,0,4,0,0,0,
14-dic-15,QRO.,"SAN JUAN DEL RIO, QRO.",2,2,4,0,0,0,
16-dic-15,DGO.,"DGO., DGO.",2,2,4,1,0,0,
16-dic-15,B.C.,"MEXICALI, B.C.",1,3,4,0,0,0,
19-dic-15,DGO.,"DGO., DGO.",0,4,4,0,0,0,
23-dic-15,B.C.,"MEXICALI, B.C.",0,4,4,0,0,0,
24-dic-15,B.C.,"TIJUANA, B.C.",4,0,4,0,0,0,
28-dic-15,B.C.,"TIJUANA, B.C.",0,4,4,0,0,0,
01-ene-16,TAMPS.,"NUEVO LAREDO, TAMPS.",2,2,4,0,0,171,
12-ene-16,COAH.,"PIEDRAS NEGRAS, COAH.",1,3,4,0,0,0,
13-ene-16,COAH.,"PIEDRAS NEGRAS, COAH.",1,3,4,1,0,30,
18-ene-16,DGO.,"DGO., DGO.",4,0,4,5,0,0,
18-ene-16,COAH.,"SABINAS, COAH.",2,2,4,0,0,0,
18-ene-16,COAH.,"SALTILLO, COAH.",4,0,4,0,0,50,
19-ene-16,COAH.,"SABINAS, COAH.",2,2,4,0,0,0,
23-ene-16,B.C.,"TIJUANA, B.C.",3,1,4,0,0,0,
26-ene-16,OAX.,"SAN JUAN BAUTISTA TUXTEPEC, OAX.",4,0,4,1,0,8,
28-ene-16,DGO.,"DGO., DGO.",1,3,4,1,2,0,
28-ene-16,COAH.,"PIEDRAS NEGRAS, COAH.",1,3,4,0,0,38,
31-ene-16,OAX.,"OAX. DE JUAREZ, OAX.",1,3,4,0,0,0,
01-feb-16,COAH.,"SALTILLO, COAH.",3,1,4,0,2,0,
02-feb-16,COAH.,"SALTILLO, COAH.",4,0,4,0,0,45,
03-feb-16,COAH.,"MONCLOVA, COAH.",3,1,4,2,0,39,
06-feb-16,TAMPS.,"MATAMOROS, TAMPS.",4,0,4,0,0,0,
07-feb-16,TAMPS.,"NUEVO LAREDO, TAMPS.",1,3,4,0,0,0,
09-feb-16,COAH.,"PIEDRAS NEGRAS, COAH.",2,2,4,0,0,0,
09-feb-16,TAMPS.,"NUEVO LAREDO, TAMPS.",0,4,4,0,0,0,
10-feb-16,CHIH.,"ASCENSIÓN, CHIH.",1,3,4,0,0,6,
10-feb-16,COAH.,"SALTILLO, COAH.",4,0,4,0,0,644,
11-feb-16,COAH.,"TORREÓN, COAH.",3,1,4,0,0,41,
12-feb-16,COAH.,"TORREÓN, COAH.",4,0,4,3,0,0,
14-feb-16,TAMPS.,"MATAMOROS, TAMPS.",3,1,4,0,0,80,
23-feb-16,COAH.,"TORREÓN, COAH.",4,0,4,0,0,524,
23-feb-16,COAH.,"SALTILLO, COAH.",4,0,4,0,0,0,
23-feb-16,COAH.,"TORREÓN, COAH.",4,0,4,1,0,120,
24-feb-16,COAH.,"SALTILLO, COAH.",4,0,4,0,9,132,
25-feb-16,COAH.,"SABINAS, COAH.",1,3,4,0,0,0,
01-mar-16,COAH.,"SALTILLO, COAH.",4,0,4,0,0,429,
01-mar-16,OAX.,"OAX. DE JUAREZ, OAX.",0,4,4,0,0,100,
07-mar-16,GRO.,"SAN MIGUEL TOTOLAPAN, GRO.",1,3,4,0,0,0,
09-mar-16,COAH.,"TORREÓN, COAH.",3,1,4,0,0,88,
11-mar-16,COAH.,"TORREÓN, COAH.",3,1,4,0,0,0,
12-mar-16,TAMPS.,"MATAMOROS, TAMPS.",2,2,4,2,0,115,
12-mar-16,COAH.,"NAVA, COAH.",3,1,4,1,0,0,
22-mar-16,COAH.,"TORREÓN, COAH.",4,0,4,0,0,0,
01-abr-16,GTO.,"SALAMANCA, GTO.",3,1,4,0,0,0,
04-abr-16,COAH.,"TORREÓN, COAH.",4,0,4,0,0,0,
14-abr-16,S.L.P.,"SAN LUIS POTOSI, S.L.P.",4,0,4,0,1,0,
14-abr-16,COAH.,"SALTILLO, COAH.",3,1,4,0,0,0,
22-abr-16,COAH.,"SAN PEDRO, COAH.",2,2,4,0,0,0,
26-abr-16,COAH.,"TORREÓN, COAH.",4,0,4,0,0,0,
26-abr-16,COAH.,"SALTILLO, COAH.",2,2,4,0,0,0,
29-abr-16,COAH.,"PIEDRAS NEGRAS, COAH.",3,1,4,4,0,0,
02-may-16,COAH.,"SALTILLO, COAH.",0,4,4,0,0,80,
25-may-16,N.L.,"MONTERREY, N.L.",3,1,4,0,0,387,
02-jun-16,COAH.,"SALTILLO, COAH.",0,4,4,0,0,0,
21-jun-16,SIN.,"MAZATLAN, SIN.",3,1,4,0,11,0,
29-jun-16,COAH.,"TORREÓN, COAH.",4,0,4,0,0,0,
30-jun-16,COAH.,"PIEDRAS NEGRAS, COAH.",2,2,4,0,0,0,
30-jun-16,SIN.,"MAZATLAN, SIN.",3,1,4,0,2,0,
04-jul-16,COAH.,"SALTILLO, COAH.",1,3,4,7,0,268,
05-jul-16,SIN.,"CULIACAN, SIN.",1,3,4,0,0,0,
08-jul-16,SIN.,"CULIACAN, SIN.",4,0,4,0,0,0,
14-jul-16,SIN.,"CULIACAN, SIN.",1,3,4,0,1,0,
21-jul-16,B.C.,"TIJUANA, B.C.",2,2,4,0,0,0,
23-jul-16,COAH.,"MATAMOROS, COAH.",4,0,4,0,0,0,
25-jul-16,B.C.,"TIJUANA, B.C.",3,1,4,0,0,0,
26-jul-16,B.C.,"MEXICALI, B.C.",4,0,4,0,0,0,
27-jul-16,N.L.,"GUADALUPE, N.L.",2,2,4,0,0,8,
03-ago-16,SIN.,"NAVOLATO, SIN.",4,0,4,0,0,0,
08-ago-16,COAH.,"TORREÓN, COAH.",4,0,4,10,0,0,
10-ago-16,S.L.P.,"SAN LUIS POTOSI, S.L.P.",2,2,4,0,0,241,
11-ago-16,MEX.,"HUEHUETOCA, MEX.",2,2,4,0,0,10,
12-ago-16,MEX.,"LERMA, MEX.",4,0,4,2,0,31,
15-ago-16,COAH.,"TORREÓN, COAH.",3,1,4,1,0,40,
16-ago-16,SON.,"HERMOSILLO, SON.",2,2,4,6,0,195,
16-ago-16,MEX.,"ZUMPANGO, MEX.",4,0,4,1,0,0,
18-ago-16,MEX.,"AMECAMECA, MEX.",3,1,4,0,0,0,
22-ago-16,MEX.,"CHIMALHUACAN, MEX.",3,1,4,0,0,0,
24-ago-16,MEX.,"CUAUTITLAN, MEX.",2,2,4,0,0,1,
25-ago-16,B.C.,"TIJUANA, B.C.",2,2,4,0,0,0,
30-ago-16,MEX.,"TULTEPEC, MEX.",4,0,4,2,0,0,
30-ago-16,COAH.,"TORREÓN, COAH.",1,3,4,0,0,0,
31-ago-16,CHIS.,"SAN CRISTOBAL DE LAS CASAS, CHIS.",3,1,4,0,0,0,
31-ago-16,MEX.,"OTZOLOTEPEC, MEX.",3,1,4,0,0,12,
31-ago-16,MEX.,"CHICONCUAC, MEX.",2,2,4,0,0,22,
01-sep-16,B.C.,"TIJUANA, B.C.",2,2,4,0,0,0,
01-sep-16,COAH.,"SALTILLO, COAH.",3,1,4,0,0,0,
02-sep-16,CHIS.,"PUEBLO NUEVO SOLISTAHUACÁN, CHIS.",1,3,4,0,0,232,
02-sep-16,GRO.,"IGUALA DE LA INDEPENDENCIA, GRO.",4,0,4,0,0,6,
05-sep-16,MEX.,"COACALCO DE BERRIOZABAL, MEX.",4,0,4,1,0,273,
06-sep-16,CHIS.,"PUEBLO NUEVO SOLISTAHUACÁN, CHIS.",3,1,4,0,0,119,
07-sep-16,MEX.,"SAN MARTIN DE LAS PIRAMIDES, MEX.",0,4,4,0,0,45,
08-sep-16,MEX.,"COACALCO DE BERRIOZABAL, MEX.",3,1,4,0,0,13,
09-sep-16,MEX.,"COACALCO DE BERRIOZABAL, MEX.",4,0,4,1,1,10,
13-sep-16,SON.,"CAJEME, SON.",1,3,4,0,0,0,
20-sep-16,COAH.,"PIEDRAS NEGRAS, COAH.",1,3,4,2,0,0,
20-sep-16,MEX.,"CHALCO, MEX.",3,1,4,0,2,0,
21-sep-16,SON.,"CAJEME, SON.",3,1,4,0,0,0,
21-sep-16,MEX.,"ATLACOMULCO, MEX.",3,1,4,0,1,0,
23-sep-16,MEX.,"CHALCO, MEX.",3,1,4,0,0,0,
28-sep-16,MEX.,"TEZOYUCA, MEX.",3,1,4,0,0,0,
01-oct-16,MEX.,"TEZOYUCA, MEX.",3,1,4,0,0,0,
04-oct-16,SIN.,"SALVADOR ALVARADO, SIN.",2,2,4,0,1,0,
06-oct-16,MEX.,"OCOYOACAC, MEX.",4,0,4,1,0,0,
07-oct-16,MEX.,"OCOYOACAC, MEX.",1,3,4,0,0,0,
08-oct-16,MEX.,"TEPOTZOTLAN, MEX.",4,0,4,2,0,18,
10-oct-16,COAH.,"ACUÑA, COAH.",2,2,4,0,0,0,
11-oct-16,SIN.,"ROSARIO, SIN.",2,2,4,0,0,0,
13-oct-16,SIN.,"ROSARIO, SIN.",4,0,4,0,0,0,
21-oct-16,CHIS.,"TAPACHULA, CHIS.",3,1,4,0,0,0,
22-oct-16,HGO.,"PACHUCA DE SOTO, HGO.",2,2,4,0,0,0,
22-oct-16,MEX.,"NEXTLALPAN, MEX., MEX.",3,1,4,0,0,0,
24-oct-16,SIN.,"ESCUINAPA, SIN.",3,1,4,0,2,0,
24-oct-16,MEX.,"XONACATLAN, MEX.",2,2,4,0,0,5,
27-oct-16,SIN.,"ESCUINAPA, SIN.",4,0,4,0,3,0,
28-oct-16,MEX.,"XONACATLAN, MEX.",3,1,4,1,0,2,
02-nov-16,SON.,"CAJEME, SON.",4,0,4,1,1,927,
05-nov-16,B.C.,"TIJUANA, B.C.",2,2,4,0,0,0,
08-nov-16,MOR.,"YAUTEPEC, MOR.",2,2,4,3,0,0,
10-nov-16,SON.,"HERMOSILLO, SON.",4,0,4,1,0,20,
11-nov-16,SON.,"NOGALES, SON.",2,2,4,4,0,0,
12-nov-16,MEX.,"TEJUPILCO, MEX.",4,0,4,3,0,0,
15-nov-16,SON.,"CAJEME, SON.",4,0,4,0,0,50,
17-nov-16,MOR.,"YAUTEPEC, MOR.",2,2,4,0,0,0,
18-nov-16,MOR.,"YAUTEPEC, MOR.",2,2,4,0,3,251,
19-nov-16,MEX.,"DONATO GUERRA, MEX.",4,0,4,2,0,0,
22-nov-16,MEX.,"RAYON, MEX.",4,0,4,5,0,0,
22-nov-16,MOR.,"YAUTEPEC, MOR.",2,2,4,2,0,193,
23-nov-16,B.C.,"ENSENADA, B.C.",3,1,4,0,0,0,
23-nov-16,MICH.,"PATZCUARO, MICH.",2,2,4,0,0,0,
26-nov-16,MEX.,"RAYON, MEX.",0,4,4,0,0,103,
28-nov-16,SON.,"SAN LUIS RIO COLORADO, SON.",2,2,4,1,0,55,
30-nov-16,SON.,"HERMOSILLO, SON.",4,0,4,19,0,0,
01-dic-16,MEX.,"TEMASCALAPA, MEX.",3,1,4,0,3,0,
01-dic-16,B.C.,"TIJUANA, B.C.",3,1,4,0,0,0,
02-dic-16,MOR.,"YAUTEPEC, MOR.",3,1,4,0,0,0,
02-dic-16,B.C.,"TIJUANA, B.C.",0,4,4,0,0,0,
06-dic-16,S.L.P.,"SAN LUIS POTOSI, S.L.P.",4,0,4,0,4,0,
11-ene-17,D.F.,"CUAUHTEMOC, D.F.",1,3,4,0,0,0,
18-ene-17,D.F.,"CUAUHTEMOC, D.F.",2,2,4,0,0,86,
23-ene-17,DGO.,"SANTIAGO PAPASQUIARO, DGO.",1,3,4,0,0,0,
31-ene-17,GRO.,"COAHUAYUTLA DE JOSE MARIA IZAZAGA, GRO.",1,3,4,0,0,6,
01-feb-17,GRO.,"COAHUAYUTLA DE JOSE MARIA IZAZAGA, GRO.",1,3,4,0,0,6,
05-feb-17,TAMPS.,"MATAMOROS, TAMPS.",3,1,4,0,0,30,
07-feb-17,SIN.,"MAZATLAN, SIN.",2,2,4,0,4,0,
08-feb-17,SIN.,"MAZATLAN, SIN.",4,0,4,0,8,0,
08-feb-17,MICH.,"LAZARO CARDENAS, MICH.",3,1,4,1,0,0,
18-feb-17,D.F.,"TLAHUAC, D.F.",3,1,4,0,0,119,
20-feb-17,VER.,"MOLOACAN, VER.",3,1,4,0,0,0,
20-feb-17,COAH.,"MATAMOROS, COAH.",3,1,4,0,0,0,
20-feb-17,COAH.,"MATAMOROS, COAH.",3,1,4,0,0,0,
21-feb-17,SIN.,"MAZATLAN, SIN.",4,0,4,0,0,0,
23-feb-17,TAMPS.,"NUEVO LAREDO, TAMPS.",4,0,4,8,0,157,
08-mar-17,D.F.,"IZTAPALAPA, D.F.",4,0,4,0,2,0,
08-mar-17,MEX.,"TLALNEPANTLA DE BAZ, MEX.",3,1,4,1,0,51,
08-mar-17,MEX.,"SAN FELIPE DEL PROGRESO, MEX.",3,1,4,0,0,0,
10-mar-17,N.L.,"MONTERREY, N.L.",2,2,4,0,0,46,
10-mar-17,MEX.,"TLALNEPANTLA DE BAZ, MEX.",3,1,4,1,0,15,
11-mar-17,N.L.,"MONTERREY, N.L.",1,3,4,0,0,0,
14-mar-17,MEX.,"TEMOAYA, MEX.",0,4,4,0,0,0,
15-mar-17,QRO.,"SAN JUAN DEL RIO, QRO.",2,2,4,38,0,0,
17-mar-17,QRO.,"QUERETARO, QRO.",1,3,4,0,0,0,
21-mar-17,MEX.,"TECAMAC, MEX.",1,3,4,0,0,0,
25-mar-17,TAMPS.,"MATAMOROS, TAMPS.",1,3,4,0,0,22,
28-mar-17,D.F.,"IZTAPALAPA, D.F.",2,2,4,211,0,0,
29-mar-17,MICH.,"LAZARO CARDENAS, MICH.",3,1,4,0,0,0,
31-mar-17,COAH.,"TORREÓN, COAH.",3,1,4,0,0,0,
04-abr-17,QRO.,"QUERETARO, QRO.",4,0,4,0,0,0,
07-abr-17,DGO.,"DGO., DGO.",3,1,4,2,0,0,
08-abr-17,DGO.,"DGO., DGO.",4,0,4,3,0,0,
18-abr-17,S.L.P.,"SAN LUIS POTOSI, S.L.P.",3,1,4,0,0,104,
25-abr-17,DGO.,"DGO., DGO.",3,1,4,0,0,0,
25-abr-17,JAL.,"ZAPOPAN, JAL.",2,2,4,0,2,52,
28-abr-17,D.F.,"XOCHIMILCO, D.F.",2,2,4,0,0,0,
29-abr-17,JAL.,"ZAPOPAN, JAL.",2,2,4,0,0,0,
30-abr-17,JAL.,"TONALA, JAL.",0,4,4,0,0,0,
01-may-17,JAL.,"TONALA, JAL.",1,3,4,0,0,0,
11-may-17,JAL.,"TONALA, JAL.",1,3,4,3,0,0,
11-may-17,GTO.,"SALAMANCA, GTO.",3,1,4,0,0,0,
18-may-17,D.F.,"IZTACALCO, D.F.",4,0,4,0,0,0,
21-may-17,GRO.,"ATOYAC DE ALVAREZ, GRO.",4,0,4,4,0,0,
25-may-17,DGO.,"DGO., DGO.",2,2,4,1,2,0,
25-may-17,D.F.,"BENITO JUAREZ, D.F.",4,0,4,0,0,980,
25-may-17,D.F.,"ALVARO OBREGON, D.F.",3,1,4,0,0,0,
04-jun-17,MOR.,"CUERNAVACA, MOR.",4,0,4,0,2,134,
04-jun-17,CHIH.,"HGO. DEL PARRAL, CHIH.",3,1,4,1,0,3350,
05-jun-17,CHIS.,"TAPACHULA, CHIS.",4,0,4,2,0,124,
05-jun-17,JAL.,"TONALA, JAL.",1,3,4,2,0,20,
05-jun-17,TAB.,"TENOSIQUE, TAB.",0,4,4,0,0,0,
05-jun-17,N.L.,"SAN PEDRO GARZA GARCIA, N.L.",1,3,4,0,0,0,
05-jun-17,CHIS.,"TUXTLA GUTIÉRREZ, CHIS.",3,1,4,0,0,310,
05-jun-17,CHIS.,"SAN CRISTOBAL DE LAS CASAS, CHIS.",4,0,4,0,0,0,
06-jun-17,CHIS.,"CHIAPA DE CORZO, CHIS.",3,1,4,0,0,0,
07-jun-17,CHIS.,"COMITAN DE DOMÍNGUEZ, CHIS.",2,2,4,6,2,610,
07-jun-17,TAMPS.,"TAMPICO, TAMPS.",4,0,4,2,0,142,
07-jun-17,CHIS.,"CHIAPA DE CORZO, CHIS.",1,3,4,4,2,132,
07-jun-17,CHIS.,"SAN CRISTOBAL DE LAS CASAS, CHIS.",3,1,4,4,0,0,
08-jun-17,CHIS.,"COMITAN DE DOMÍNGUEZ, CHIS.",2,2,4,24,1,1022,
08-jun-17,CHIS.,"TAPACHULA, CHIS.",2,2,4,10,0,1050,
09-jun-17,JAL.,"GUADALAJARA, JAL.",3,1,4,2,0,0,
09-jun-17,TAMPS.,"MATAMOROS, TAMPS.",0,4,4,1,0,26,
10-jun-17,CHIS.,"VILLAFLORES, CHIS.",4,0,4,11,0,811,
10-jun-17,CHIS.,"PALENQUE, CHIS.",1,3,4,5,0,831,
13-jun-17,SIN.,"SALVADOR ALVARADO, SIN.",1,3,4,0,0,0,
13-jun-17,ZAC.,"GENERAL FRANCISCO R. MURGUIA, ZAC.",3,1,4,3,0,0,
15-jun-17,SIN.,"CHOIX, SIN.",3,1,4,0,0,0,
15-jun-17,JAL.,"ZAPOPAN, JAL.",4,0,4,0,0,0,
16-jun-17,TAMPS.,"MATAMOROS, TAMPS.",2,2,4,0,0,6,
22-jun-17,QRO.,"PEDRO ESCOBEDO, QRO.",2,2,4,0,0,0,
22-jun-17,SIN.,"CHOIX, SIN.",2,2,4,0,0,0,
23-jun-17,JAL.,"TLAQUEPAQUE, JAL.",3,1,4,0,0,117,
26-jun-17,JAL.,"ZAPOTLANEJO, JAL.",4,0,4,0,0,0,
27-jun-17,SIN.,"SALVADOR ALVARADO, SIN.",1,3,4,0,3,0,
28-jun-17,COAH.,"MONCLOVA, COAH.",4,0,4,0,0,0,
28-jun-17,B.C.,"TIJUANA, B.C.",0,4,4,0,0,0,
30-jun-17,SIN.,"SALVADOR ALVARADO, SIN.",2,2,4,0,0,0,
06-jul-17,MICH.,"BUENAVISTA, MICH.",3,1,4,0,0,5,
06-jul-17,JAL.,"EL SALTO, JAL.",2,2,4,0,0,144,
07-jul-17,D.F.,"IZTAPALAPA, D.F.",4,0,4,0,0,0,
08-jul-17,MOR.,"TEPOZTLAN, MOR.",4,0,4,1,0,0,
10-jul-17,B.C.,"TIJUANA, B.C.",0,4,4,0,0,0,
17-jul-17,MOR.,"TEPOZTLAN, MOR.",3,1,4,2,0,215,
18-jul-17,MEX.,"RAYON, MEX.",2,2,4,1,0,3,
19-jul-17,MEX.,"RAYON, MEX.",1,3,4,0,0,0,
20-jul-17,B.C.,"MEXICALI, B.C.",0,4,4,0,0,0,
25-jul-17,MEX.,"CHAPA DE MOTA, MEX.",1,3,4,0,0,0,
27-jul-17,AGS.,"AGS., AGS.",4,0,4,0,0,0,
28-jul-17,AGS.,"AGS., AGS.",4,0,4,0,0,0,
31-jul-17,MOR.,"EMILIANO ZAPATA, MOR.",2,2,4,1,4,0,
31-jul-17,COAH.,"SALTILLO, COAH.",3,1,4,0,0,0,
02-ago-17,CHIS.,"TAPACHULA, CHIS.",3,1,4,0,0,0,
02-ago-17,CHIS.,"TUXTLA GUTIÉRREZ, CHIS.",4,0,4,2,0,61,
05-ago-17,CHIS.,"TUXTLA GUTIÉRREZ, CHIS.",3,1,4,0,2,240,
08-ago-17,MEX.,"ATIZAPAN, MEX.",3,1,4,4,0,217,
09-ago-17,SIN.,"EL FUERTE, SIN.",3,1,4,0,0,0,
10-ago-17,QRO.,"EL MARQUES, QRO.",2,2,4,0,0,0,
11-ago-17,CHIS.,"TUXTLA GUTIÉRREZ, CHIS.",1,3,4,0,0,593,
13-ago-17,QRO.,"EL MARQUES, QRO.",1,3,4,0,0,0,
15-ago-17,QRO.,"EL MARQUES, QRO.",4,0,4,0,0,0,
16-ago-17,S.L.P.,"SAN LUIS POTOSI, S.L.P.",4,0,4,1,0,0,
16-ago-17,S.L.P.,"SAN LUIS POTOSI, S.L.P.",4,0,4,1,0,0,
16-ago-17,D.F.,"VENUSTIANO CARRANZA, D.F.",3,1,4,0,0,67,
17-ago-17,MOR.,"EMILIANO ZAPATA, MOR.",0,4,4,2,0,59,
19-ago-17,MEX.,"TEXCOCO, MEX.",3,1,4,2,0,492,
22-ago-17,MEX.,"IXTAPALUCA, MEX.",4,0,4,0,0,1696,
23-ago-17,VER.,"COATEPEC, VER.",4,0,4,3,0,214,
25-ago-17,COAH.,"ACUÑA, COAH.",2,2,4,0,0,0,
27-ago-17,COAH.,"MONCLOVA, COAH.",2,2,4,0,0,119,
31-ago-17,COAH.,"MONCLOVA, COAH.",4,0,4,0,3,326,
09-sep-17,MEX.,"CHIAUTLA, MEX.",4,0,4,0,0,0,
11-sep-17,ZAC.,"TLALTENANGO DE SANCHEZ ROMAN, ZAC.",2,2,4,0,0,102,
11-sep-17,N.L.,"MONTERREY, N.L.",4,0,4,1,0,45,
12-sep-17,DGO.,"DGO., DGO.",3,1,4,3,0,0,
12-sep-17,COAH.,"SALTILLO, COAH.",3,1,4,3,0,104,
12-sep-17,ZAC.,"GUADALUPE, ZAC.",3,1,4,6,2,918,
14-sep-17,GTO.,"GTO., GTO.",3,1,4,0,4,76,
14-sep-17,COAH.,"SALTILLO, COAH.",4,0,4,0,0,0,
19-sep-17,SIN.,"AHOME, SIN.",1,3,4,0,0,0,
20-sep-17,N.L.,"MONTERREY, N.L.",3,1,4,0,0,0,
21-sep-17,COAH.,"SALTILLO, COAH.",3,1,4,0,0,387,
22-sep-17,MEX.,"AMATEPEC, MEX.",1,3,4,1,0,0,
27-sep-17,SIN.,"MOCORITO, SIN.",3,1,4,0,3,0,
28-sep-17,ZAC.,"GUADALUPE, ZAC.",2,2,4,0,0,538,
28-sep-17,ZAC.,"ZAC., ZAC.",4,0,4,0,0,638,
28-sep-17,DGO.,"DGO., DGO.",3,1,4,0,0,0,
29-sep-17,N.L.,"MONTERREY, N.L.",3,1,4,0,0,0,
29-sep-17,ZAC.,"ZAC., ZAC.",3,1,4,0,0,0,
29-sep-17,MEX.,"ATIZAPAN, MEX.",2,2,4,2,0,55,
29-sep-17,TAMPS.,"TAMPICO, TAMPS.",0,4,4,2,0,123,
01-oct-17,MEX.,"TIANGUISTENCO, MEX.",1,3,4,1,0,0,
02-oct-17,ZAC.,"JEREZ, ZAC.",4,0,4,2,0,4,
06-oct-17,ZAC.,"GUADALUPE, ZAC.",4,0,4,0,0,50,
07-oct-17,N.L.,"GRAL. BRAVO, N.L.",1,3,4,0,3,0,
12-oct-17,SIN.,"CULIACAN, SIN.",3,1,4,0,1,0,
13-oct-17,N.L.,"MONTERREY, N.L.",4,0,4,0,0,0,
13-oct-17,SIN.,"GUASAVE, SIN.",2,2,4,0,0,0,
17-oct-17,SIN.,"CULIACAN, SIN.",3,1,4,0,11,0,
19-oct-17,AGS.,"AGS., AGS.",4,0,4,0,0,0,
24-oct-17,D.F.,"LA MAGDALENA CONTRERAS, D.F.",3,1,4,0,0,114,
24-oct-17,SON.,"HERMOSILLO, SON.",4,0,4,0,0,5,
01-nov-17,ZAC.,"GUADALUPE, ZAC.",2,2,4,11,0,400,
02-nov-17,S.L.P.,"SAN LUIS POTOSI, S.L.P.",2,2,4,0,0,0,
04-nov-17,DGO.,"GOMEZ PALACIO, DGO.",2,2,4,0,0,0,
06-nov-17,VER.,"PANUCO, VER.",4,0,4,0,0,0,
14-nov-17,SIN.,"MAZATLAN, SIN.",1,3,4,0,0,0,
30-nov-17,S.L.P.,"SAN LUIS POTOSI, S.L.P.",1,3,4,0,0,0,
01-dic-17,B.C.,"TIJUANA, B.C.",0,4,4,0,0,0,
05-dic-17,B.C.,"TIJUANA, B.C.",1,3,4,0,0,0,
14-dic-17,S.L.P.,"SAN LUIS POTOSI, S.L.P.",3,1,4,0,0,0,
14-dic-17,ZAC.,"GUADALUPE, ZAC.",3,1,4,38,0,991,
16-dic-17,TAMPS.,"MATAMOROS, TAMPS.",3,1,4,1,0,51,
03-ene-18,B.C.,"TIJUANA, B.C.",3,1,4,0,0,0,
11-ene-18,COAH.,"SALTILLO, COAH.",2,2,4,0,0,0,
18-ene-18,COAH.,"MONCLOVA, COAH.",3,1,4,0,0,54,
19-ene-18,COAH.,"TORREÓN, COAH.",3,1,4,0,0,11,
23-ene-18,COAH.,"MONCLOVA, COAH.",3,1,4,0,0,0,
26-ene-18,COAH.,"SAN PEDRO, COAH.",3,1,4,0,0,0,
27-ene-18,COAH.,"MÚZQUIZ, COAH.",1,3,4,0,0,57,
29-ene-18,B.C.,"TIJUANA, B.C.",3,1,4,0,0,0,
30-ene-18,ZAC.,"GUADALUPE, ZAC.",4,0,4,6,0,58,
30-ene-18,GTO.,"IRAPUATO, GTO.",2,2,4,0,0,0,
30-ene-18,DGO.,"GOMEZ PALACIO, DGO.",4,0,4,0,0,0,
30-ene-18,COAH.,"SALTILLO, COAH.",4,0,4,2,0,62,
30-ene-18,COAH.,"MONCLOVA, COAH.",3,1,4,0,0,24,
30-ene-18,COAH.,"MÚZQUIZ, COAH.",4,0,4,7,0,0,
01-feb-18,D.F.,"CUAUHTEMOC, D.F.",4,0,4,0,0,480,
02-feb-18,COAH.,"SALTILLO, COAH.",4,0,4,0,0,12,
02-feb-18,ZAC.,"GUADALUPE, ZAC.",1,3,4,9,0,278,
02-feb-18,ZAC.,"FRESNILLO, ZAC.",4,0,4,9,0,155,
03-feb-18,COAH.,"SABINAS, COAH.",4,0,4,1,0,0,
03-feb-18,TAMPS.,"MATAMOROS, TAMPS.",0,4,4,5,0,848,
05-feb-18,COAH.,"PIEDRAS NEGRAS, COAH.",4,0,4,8,0,1162,
06-feb-18,ZAC.,"FRESNILLO, ZAC.",4,0,4,39,0,267,
06-feb-18,COAH.,"ACUÑA, COAH.",1,3,4,0,0,0,
06-feb-18,D.F.,"TLAHUAC, D.F.",1,3,4,0,0,0,
09-feb-18,COAH.,"TORREÓN, COAH.",3,1,4,0,0,81,
12-feb-18,COAH.,"TORREÓN, COAH.",4,0,4,0,1,48,
12-feb-18,ZAC.,"ZAC., ZAC.",4,0,4,8,0,20,
14-feb-18,ZAC.,"FRESNILLO, ZAC.",4,0,4,8,0,44,
24-feb-18,COAH.,"PIEDRAS NEGRAS, COAH.",2,2,4,0,0,0,
26-feb-18,COAH.,"MONCLOVA, COAH.",2,2,4,0,0,181,
26-feb-18,COAH.,"MÚZQUIZ, COAH.",1,3,4,8,0,300,
27-feb-18,SIN.,"CULIACAN, SIN.",4,0,4,0,0,0,
27-feb-18,D.F.,"IZTAPALAPA, D.F.",2,2,4,0,0,24,
07-mar-18,SIN.,"CULIACAN, SIN.",2,2,4,0,2,0,
07-mar-18,S.L.P.,"SAN LUIS POTOSI, S.L.P.",3,1,4,0,0,0,
09-mar-18,D.F.,"TLALPAN, D.F.",1,3,4,0,0,0,
12-mar-18,COAH.,"SAN PEDRO, COAH.",1,3,4,0,0,0,
14-mar-18,QRO.,"QUERETARO, QRO.",3,1,4,0,0,0,
15-mar-18,S.L.P.,"SAN LUIS POTOSI, S.L.P.",3,1,4,0,0,0,
16-mar-18,QRO.,"QUERETARO, QRO.",3,1,4,0,0,2,
17-mar-18,DGO.,"LERDO, DGO.",2,2,4,0,0,0,
20-mar-18,COAH.,"PIEDRAS NEGRAS, COAH.",4,0,4,1,0,0,
23-mar-18,COAH.,"TORREÓN, COAH.",3,1,4,1,0,973,
24-mar-18,S.L.P.,"CIUDAD VALLES, S.L.P.",4,0,4,0,0,0,
24-mar-18,S.L.P.,"SAN LUIS POTOSI, S.L.P.",4,0,4,5,4,0,
25-mar-18,S.L.P.,"SAN LUIS POTOSI, S.L.P.",4,0,4,9,0,0,
18-jul-18,ZAC.,"GUADALUPE, ZAC.",1,3,4,7,1,88,
20-jul-18,B.C.,"TIJUANA, B.C.",4,0,4,0,0,0,
23-jul-18,B.C.,"TIJUANA, B.C.",4,0,4,0,0,0,
30-jul-18,D.F.,"GUSTAVO A. MADERO, D.F.",4,0,4,0,2,773,
02-ago-18,CHIH.,"HGO. DEL PARRAL, CHIH.",3,1,4,5,0,1314,
06-ago-18,MEX.,"CHALCO, MEX.",3,1,4,0,0,149,
06-ago-18,B.C.,"TIJUANA, B.C.",2,2,4,0,0,0,
06-ago-18,MEX.,"ATLACOMULCO, MEX.",1,3,4,0,0,148,
07-ago-18,MEX.,"ATLACOMULCO, MEX.",1,3,4,6,0,201,
09-ago-18,TAMPS.,"NUEVO LAREDO, TAMPS.",3,1,4,0,0,25,
11-ago-18,MEX.,"ZUMPANGO, MEX.",3,1,4,0,0,317,
13-ago-18,MEX.,"CHALCO, MEX.",3,1,4,0,2,0,
14-ago-18,TAMPS.,"TAMPICO, TAMPS.",0,4,4,0,3,201,
14-ago-18,TAMPS.,"VICTORIA, TAMPS.",4,0,4,0,0,19,
14-ago-18,B.C.,"TIJUANA, B.C.",1,3,4,0,0,0,
14-ago-18,DGO.,"DGO., DGO.",2,2,4,0,0,0,
15-ago-18,CHIS.,"CHICOASÉN, CHIS.",4,0,4,0,0,15,
15-ago-18,CHIH.,"HGO. DEL PARRAL, CHIH.",3,1,4,4,0,740,
17-ago-18,TAMPS.,"MATAMOROS, TAMPS.",3,1,4,1,0,159,
17-ago-18,CHIS.,"TUXTLA GUTIÉRREZ, CHIS.",2,2,4,0,0,0,
21-ago-18,N.L.,"LINARES, N.L.",4,0,4,2,0,0,
23-ago-18,MEX.,"ZACUALPAN, MEX.",3,1,4,0,0,0,
23-ago-18,MEX.,"TLALNEPANTLA DE BAZ, MEX.",2,2,4,0,0,39,
24-ago-18,MEX.,"ZACUALPAN, MEX.",1,3,4,1,0,0,
24-ago-18,GTO.,"CELAYA, GTO.",3,1,4,0,0,9,
29-ago-18,MEX.,"TLALNEPANTLA DE BAZ, MEX.",3,1,4,0,0,6353,
31-ago-18,TAMPS.,"ALTAMIRA, TAMPS.",3,1,4,0,0,0,
02-sep-18,TAMPS.,"MATAMOROS, TAMPS.",0,4,4,0,0,0,
03-sep-18,COAH.,"TORREÓN, COAH.",4,0,4,8,0,16,
04-sep-18,D.F.,"AZCAPOTZALCO, D.F.",4,0,4,0,0,6739,
04-sep-18,MEX.,"NEZAHUALCOYOTL, MEX.",4,0,4,0,1,10600,
05-sep-18,MEX.,"AMECAMECA, MEX.",2,2,4,1,0,13,
06-sep-18,D.F.,"AZCAPOTZALCO, D.F.",3,1,4,0,0,173,
07-sep-18,TAMPS.,"MATAMOROS, TAMPS.",2,2,4,1,0,467,
09-sep-18,MEX.,"SOYANIQUILPAN DE JUAREZ, MEX.",4,0,4,0,0,0,
11-sep-18,TAMPS.,"CIUDAD MADERO, TAMPS.",4,0,4,1,0,113,
12-sep-18,AGS.,"AGS., AGS.",4,0,4,0,0,213,
12-sep-18,MEX.,"SOYANIQUILPAN DE JUAREZ, MEX.",4,0,4,0,0,0,
12-sep-18,MEX.,"TOLUCA, MEX.",1,3,4,1,0,0,
13-sep-18,D.F.,"XOCHIMILCO, D.F.",2,2,4,0,0,8907,
14-sep-18,MOR.,"EMILIANO ZAPATA, MOR.",4,0,4,5,4,198,
17-sep-18,MEX.,"NEZAHUALCOYOTL, MEX.",4,0,4,0,0,0,
19-sep-18,MEX.,"TULTEPEC, MEX.",2,2,4,0,0,0,
21-sep-18,N.L.,"LOS RAMONES, N.L.",2,2,4,0,0,35,
26-sep-18,COAH.,"TORREÓN, COAH.",2,2,4,0,0,19,
26-sep-18,MEX.,"IXTAPALUCA, MEX.",4,0,4,0,1,546,
01-oct-18,N.L.,"MELCHOR OCAMPO, N.L.",2,2,4,0,0,0,
03-oct-18,MEX.,"JILOTEPEC, MEX.",4,0,4,0,0,0,
03-oct-18,N.L.,"MELCHOR OCAMPO, N.L.",2,2,4,0,0,0,
03-oct-18,MEX.,"IXTAPALUCA, MEX.",3,1,4,0,7,0,
08-oct-18,MEX.,"NAUCALPAN DE JUAREZ, MEX.",4,0,4,3,0,3,
09-oct-18,D.F.,"MIGUEL HGO., D.F.",2,2,4,0,0,1099,
12-oct-18,MEX.,"NAUCALPAN DE JUAREZ, MEX.",4,0,4,3,0,498,
22-oct-18,D.F.,"VENUSTIANO CARRANZA, D.F.",3,1,4,0,0,2825,
24-oct-18,MEX.,"ALMOLOYA DE JUAREZ, MEX.",1,3,4,0,1,5,
25-oct-18,ZAC.,"GUADALUPE, ZAC.",3,1,4,8,0,50,
03-nov-18,MEX.,"OCOYOACAC, MEX.",3,1,4,0,0,0,
05-nov-18,COAH.,"PIEDRAS NEGRAS, COAH.",3,1,4,0,0,300,
08-nov-18,COAH.,"RAMOS ARIZPE, COAH.",4,0,4,1,0,7,
08-nov-18,MEX.,"METEPEC, MEX.",2,2,4,0,0,0,
24-nov-18,MEX.,"SAN MARTIN DE LAS PIRAMIDES, MEX.",4,0,4,0,0,12717,
26-nov-18,SIN.,"MAZATLAN, SIN.",4,0,4,0,0,0,
29-nov-18,N.L.,"LOS ALDAMAS, N.L.",4,0,4,1,0,0,
29-nov-18,D.F.,"IZTACALCO, D.F.",4,0,4,0,2,33500,
05-dic-18,SIN.,"AHOME, SIN.",4,0,4,0,0,0,
18-dic-18,SIN.,"CULIACAN, SIN.",1,3,4,0,0,0,
22-ene-19,COAH.,"PIEDRAS NEGRAS, COAH.",1,3,4,4,0,107,
18-feb-19,ZAC.,"ZAC., ZAC.",4,0,4,0,0,0,
27-feb-19,COAH.,"ACUÑA, COAH.",2,2,4,0,0,0,
07-mar-19,ZAC.,"ZAC., ZAC.",4,0,4,15,0,125,
09-mar-19,CHIS.,"TUXTLA GUTIÉRREZ, CHIS.",2,2,4,0,2,4717,
14-mar-19,COAH.,"SALTILLO, COAH.",3,1,4,0,0,16,
04-abr-19,CD. MÉX.,"IZTAPALAPA, CD. MÉX.",4,0,4,0,3,217,
05-abr-19,CD. MÉX.,"MIGUEL HGO., CD. MÉX.",4,0,4,0,0,335,
05-abr-19,ZAC.,"FRESNILLO, ZAC.",3,1,4,0,0,0,
05-abr-19,CD. MÉX.,"XOCHIMILCO, CD. MÉX.",2,2,4,0,0,17,
11-abr-19,CD. MÉX.,"XOCHIMILCO, CD. MÉX.",3,1,4,0,0,871,
29-abr-19,CD. MÉX.,"ALVARO OBREGON, CD. MÉX.",4,0,4,0,0,810,
06-may-19,CD. MÉX.,"TLALPAN, CD. MÉX.",2,2,4,0,4,28,
09-may-19,CD. MÉX.,"TLALPAN, CD. MÉX.",3,1,4,0,0,154,
10-may-19,CD. MÉX.,"IZTAPALAPA, CD. MÉX.",4,0,4,0,0,96,
13-may-19,CHIH.,"JUÁREZ, CHIH.",4,0,4,14,0,630,
14-may-19,CD. MÉX.,"IZTAPALAPA, CD. MÉX.",3,1,4,0,0,0,
15-may-19,CHIH.,"JUÁREZ, CHIH.",0,4,4,7,0,267,
16-may-19,CD. MÉX.,"VENUSTIANO CARRANZA, CD. MÉX.",3,1,4,0,0,48,
17-may-19,CD. MÉX.,"VENUSTIANO CARRANZA, CD. MÉX.",3,1,4,0,0,185,
20-may-19,CD. MÉX.,"MILPA ALTA, CD. MÉX.",3,1,4,0,0,48,
20-may-19,CHIH.,"JUÁREZ, CHIH.",3,1,4,3,0,176,
21-may-19,CD. MÉX.,"MILPA ALTA, CD. MÉX.",3,1,4,0,0,32,
30-may-19,MÉX.,"ECATEPEC DE MOR., MEX.",4,0,4,0,0,0,
31-may-19,ZAC.,"FRESNILLO, ZAC.",1,3,4,0,0,0,
31-may-19,QRO.,"CORREGIDORA, QRO.",3,1,4,0,0,0,
03-jun-19,MÉX.,"ECATEPEC DE MOR., MEX.",2,2,4,0,1,0,
04-jun-19,CD. MÉX.,"IZTAPALAPA, CD. MÉX.",4,0,4,0,0,213,
07-jun-19,CD. MÉX.,"IZTAPALAPA, CD. MÉX.",4,0,4,0,0,438,
10-jun-19,CD. MÉX.,"IZTAPALAPA, CD. MÉX.",3,1,4,0,0,95,
11-jun-19,DGO.,"DGO., DGO.",1,3,4,0,0,0,
11-jun-19,CD. MÉX.,"LA MAGDALENA CONTRERAS, CD. MÉX.",4,0,4,0,0,114,
12-jun-19,DGO.,"DGO., DGO.",1,3,4,20,0,0,
14-jun-19,CD. MÉX.,"IZTAPALAPA, CD. MÉX.",3,1,4,0,0,0,
14-jun-19,QRO.,"CORREGIDORA, QRO.",3,1,4,0,0,0,
17-jun-19,CD. MÉX.,"IZTAPALAPA, CD. MÉX.",4,0,4,0,0,52,
21-jun-19,CD. MÉX.,"TLAHUAC, CD. MÉX.",4,0,4,0,0,52,
03-jul-19,CD. MÉX.,"IZTAPALAPA, CD. MÉX.",3,1,4,0,1,344,
04-jul-19,CD. MÉX.,"XOCHIMILCO, CD. MÉX.",3,1,4,0,0,4,
04-jul-19,DGO.,"DGO., DGO.",4,0,4,0,0,0,
10-jul-19,JAL.,"LA HUERTA, JAL.",1,3,4,0,0,54,
12-jul-19,ZAC.,"FRESNILLO, ZAC.",1,3,4,1,0,21,
17-jul-19,NAY.,"TEPIC, NAY.",4,0,4,0,0,0,
18-jul-19,NAY.,"TEPIC, NAY.",4,0,4,4,0,0,
18-jul-19,CD. MÉX.,"CUAJIMALPA DE MOR., CD. MÉX.",3,1,4,0,0,6914,
19-jul-19,CD. MÉX.,"IZTAPALAPA, CD. MÉX.",4,0,4,0,0,237,
22-jul-19,CD. MÉX.,"TLAHUAC, CD. MÉX.",4,0,4,0,0,20,
23-jul-19,NAY.,"XALISCO, NAY.",4,0,4,0,0,0,
24-jul-19,CD. MÉX.,"TLAHUAC, CD. MÉX.",3,1,4,0,0,243,
26-jul-19,CD. MÉX.,"CUAJIMALPA DE MOR., CD. MÉX.",4,0,4,0,0,7049,
29-jul-19,MOR.,"CUERNAVACA, MOR.",4,0,4,4,0,169,
31-jul-19,CD. MÉX.,"IZTAPALAPA, CD. MÉX.",4,0,4,0,0,32,
31-jul-19,MOR.,"CUERNAVACA, MOR.",4,0,4,1,1,556,
06-ago-19,MÉX.,"OCOYOACAC, MEX.",2,2,4,4,32,150,
08-ago-19,QRO.,"QUERETARO, QRO.",1,3,4,0,0,0,
08-ago-19,CD. MÉX.,"CUAUHTEMOC, CD. MÉX.",4,0,4,0,0,968,
09-ago-19,CD. MÉX.,"CUAUHTEMOC, CD. MÉX.",4,0,4,0,0,6264,
13-ago-19,MÉX.,"AMECAMECA, MEX.",4,0,4,1,4,0,
13-ago-19,CD. MÉX.,"GUSTAVO A. MADERO, CD. MÉX.",3,1,4,0,0,3,
14-ago-19,CHIH.,"NUEVO CASAS GRANDES, CHIH.",3,1,4,0,0,70,
21-ago-19,QRO.,"QUERETARO, QRO.",2,2,4,0,0,0,
22-ago-19,MÉX.,"TECAMAC, MEX.",2,2,4,1,0,0,
22-ago-19,S.L.P.,"SAN LUIS POTOSI, S.L.P.",4,0,4,0,2,0,
22-ago-19,S.L.P.,"SOLEDAD DE GRACIANO SANCHEZ, S.L.P.",4,0,4,1,0,259,
24-ago-19,TAMPS.,"TAMPICO, TAMPS.",4,0,4,0,0,43,
26-ago-19,GTO.,"IRAPUATO, GTO.",3,1,4,0,0,65,
26-ago-19,CD. MÉX.,"GUSTAVO A. MADERO, CD. MÉX.",2,2,4,0,0,164,
27-ago-19,GTO.,"IRAPUATO, GTO.",3,1,4,0,2,65,
27-ago-19,CD. MÉX.,"MIGUEL HGO., CD. MÉX.",2,2,4,0,0,237,
29-ago-19,TAMPS.,"TAMPICO, TAMPS.",1,3,4,0,0,0,
03-sep-19,TAMPS.,"REYNOSA, TAMPS.",4,0,4,25,0,165,
04-sep-19,CD. MÉX.,"IZTAPALAPA, CD. MÉX.",2,2,4,0,0,762,
06-sep-19,TAMPS.,"MATAMOROS, TAMPS.",1,3,4,1,0,0,
13-sep-19,CD. MÉX.,"COYOACAN, CD. MÉX.",2,2,4,0,0,12,
13-sep-19,MÉX.,"CUAUTITLAN IZCALLI, MEX.",4,0,4,0,0,137,
17-sep-19,MÉX.,"NEZAHUALCOYOTL, MEX.",4,0,4,7,0,286,
18-sep-19,MÉX.,"NEZAHUALCOYOTL, MEX.",4,0,4,0,0,108,
19-sep-19,CD. MÉX.,"COYOACAN, CD. MÉX.",4,0,4,0,0,4281,
20-sep-19,MÉX.,"NEZAHUALCOYOTL, MEX.",3,1,4,3,0,449,
23-sep-19,CD. MÉX.,"IZTAPALAPA, CD. MÉX.",3,1,4,0,0,90,
26-sep-19,CD. MÉX.,"IZTAPALAPA, CD. MÉX.",3,1,4,0,0,61,
01-oct-19,CD. MÉX.,"IZTAPALAPA, CD. MÉX.",1,3,4,0,0,5070,
01-oct-19,MÉX.,"ZUMPANGO, MEX.",3,1,4,0,0,4,
04-oct-19,MÉX.,"ZUMPANGO, MEX.",3,1,4,0,0,8,
07-oct-19,MÉX.,"HUIXQUILUCAN, MEX.",3,1,4,0,0,29,
14-oct-19,CD. MÉX.,"IZTACALCO, CD. MÉX.",3,1,4,0,0,0,
18-oct-19,CD. MÉX.,"IZTAPALAPA, CD. MÉX.",2,2,4,0,0,178,
18-oct-19,CD. MÉX.,"CUAJIMALPA DE MOR., CD. MÉX.",4,0,4,0,0,0,
21-oct-19,CD. MÉX.,"CUAJIMALPA DE MOR., CD. MÉX.",3,1,4,0,0,1291,
21-oct-19,CD. MÉX.,"IZTACALCO, CD. MÉX.",3,1,4,0,0,0,
22-oct-19,CD. MÉX.,"IZTACALCO, CD. MÉX.",3,1,4,0,0,93,
23-oct-19,CD. MÉX.,"AZCAPOTZALCO, CD. MÉX.",3,1,4,0,0,5,
30-oct-19,CD. MÉX.,"AZCAPOTZALCO, CD. MÉX.",2,2,4,0,0,52,
30-oct-19,CD. MÉX.,"IZTAPALAPA, CD. MÉX.",3,1,4,0,0,773,
01-nov-19,CD. MÉX.,"AZCAPOTZALCO, CD. MÉX.",1,3,4,0,0,0,
04-nov-19,CD. MÉX.,"AZCAPOTZALCO, CD. MÉX.",3,1,4,0,0,17,
05-nov-19,CD. MÉX.,"BENITO JUAREZ, CD. MÉX.",4,0,4,0,0,137,
06-nov-19,MÉX.,"TEXCOCO, MEX.",4,0,4,2,0,1254,
07-nov-19,CD. MÉX.,"BENITO JUAREZ, CD. MÉX.",2,2,4,0,0,165,
08-nov-19,MÉX.,"LA PAZ, MEX.",3,1,4,0,0,76,
11-nov-19,MÉX.,"TEPETLAOXTOC, MEX.",3,1,4,1,3,0,
12-nov-19,MÉX.,"JOCOTITLAN, MEX.",0,4,4,0,1,0,
14-nov-19,CHIS.,"VILLAFLORES, CHIS.",0,4,4,0,3,355,
16-nov-19,MÉX.,"EL ORO, MEX.",2,2,4,0,0,0,
16-nov-19,MÉX.,"CUAUTITLAN IZCALLI, MEX.",1,3,4,0,0,691,
19-nov-19,MÉX.,"CHALCO, MEX.",4,0,4,3,0,328,
20-nov-19,MÉX.,"VALLE DE CHALCO SOLIDARIDAD, MEX.",4,0,4,2,0,5,
22-nov-19,MÉX.,"VALLE DE CHALCO SOLIDARIDAD, MEX.",3,1,4,2,25,0,
23-nov-19,MÉX.,"TEPETLAOXTOC, MEX.",4,0,4,0,0,0,
23-nov-19,MÉX.,"COYOTEPEC, MEX.",3,1,4,0,0,0,
28-nov-19,CD. MÉX.,"COYOACAN, CD. MÉX.",4,0,4,0,1,105,
28-nov-19,ZAC.,"GUADALUPE, ZAC.",4,0,4,3,0,142,
29-nov-19,CD. MÉX.,"COYOACAN, CD. MÉX.",4,0,4,0,0,106,
13-dic-19,CD. MÉX.,"IZTACALCO, CD. MÉX.",0,4,4,0,0,32,
13-dic-19,GTO.,"LEON, GTO.",4,0,4,0,0,0,
16-dic-19,JAL.,"GUADALAJARA, JAL.",0,4,4,0,0,0,
18-dic-19,CD. MÉX.,"MIGUEL HGO., CD. MÉX.",2,2,4,0,0,5649,
20-dic-19,JAL.,"GUADALAJARA, JAL.",1,3,4,0,0,6,
30-ene-20,VER.,"MINATITLAN, VER.",2,2,4,0,0,0,
06-feb-20,CD. MÉX.,"MILPA ALTA, CD. MÉX.",1,3,4,0,3,144,
07-feb-20,COAH.,"SABINAS, COAH.",1,3,4,0,0,0,
10-feb-20,CD. MÉX.,"GUSTAVO A. MADERO, CD. MÉX.",3,1,4,0,0,651,
11-feb-20,SIN.,"SALVADOR ALVARADO, SIN.",4,0,4,0,2,0,
12-feb-20,CD. MÉX.,"TLALPAN, CD. MÉX.",3,1,4,0,0,161,
12-feb-20,CD. MÉX.,"CUAUHTEMOC, CD. MÉX.",4,0,4,0,0,0,
12-feb-20,SIN.,"SALVADOR ALVARADO, SIN.",2,2,4,0,4,0,
14-feb-20,SIN.,"SALVADOR ALVARADO, SIN.",2,2,4,0,3,0,
25-feb-20,CD. MÉX.,"XOCHIMILCO, CD. MÉX.",2,2,4,0,1,146,
27-feb-20,CD. MÉX.,"BENITO JUAREZ, CD. MÉX.",4,0,4,0,1,0,
27-feb-20,COAH.,"MONCLOVA, COAH.",2,2,4,0,2,43,
28-feb-20,VER.,"POZA RICA DE HGO., VER.",2,2,4,1,0,204,
28-feb-20,COAH.,"TORREÓN, COAH.",2,2,4,0,0,0,
28-feb-20,COAH.,"SALTILLO, COAH.",3,1,4,0,0,439,
03-mar-20,CD. MÉX.,"XOCHIMILCO, CD. MÉX.",2,2,4,0,0,0,
04-mar-20,COAH.,"TORREÓN, COAH.",4,0,4,0,0,0,
04-mar-20,CD. MÉX.,"XOCHIMILCO, CD. MÉX.",2,2,4,0,0,97,
05-mar-20,COAH.,"SALTILLO, COAH.",4,0,4,0,0,0,
06-mar-20,VER.,"VER., VER.",4,0,4,5,1,12,
06-mar-20,SIN.,"SAN IGNACIO, SIN.",2,2,4,0,0,0,
08-mar-20,VER.,"VER., VER.",3,1,4,6,1,439,
10-mar-20,CD. MÉX.,"BENITO JUAREZ, CD. MÉX.",4,0,4,0,0,96,
10-mar-20,CD. MÉX.,"IZTAPALAPA, CD. MÉX.",3,1,4,0,0,986,
11-mar-20,VER.,"VER., VER.",4,0,4,3,0,899,
12-mar-20,VER.,"COATZACOALCOS, VER.",3,1,4,3,0,45,
13-mar-20,CD. MÉX.,"CUAJIMALPA DE MOR., CD. MÉX.",3,1,4,0,0,0,
16-mar-20,COAH.,"TORREÓN, COAH.",2,2,4,0,0,0,
20-mar-20,CHIS.,"COMITAN DE DOMÍNGUEZ, CHIS.",1,3,4,0,0,404,
25-mar-20,COAH.,"TORREÓN, COAH.",3,1,4,0,0,0,
08-jul-20,CD. MÉX.,"GUSTAVO A. MADERO, CD. MÉX.",4,0,4,0,0,17,
16-jul-20,CD. MÉX.,"CUAUHTEMOC, CD. MÉX.",4,0,4,0,0,98,
30-jul-20,CD. MÉX.,"GUSTAVO A. MADERO, CD. MÉX.",2,2,4,0,0,11,
08-sep-20,CD. MÉX.,"GUSTAVO A. MADERO, CD. MÉX.",3,1,4,0,0,116,
20-sep-20,VER.,"MARTINEZ DE LA TORRE, VER.",2,2,4,0,0,5,
21-sep-20,VER.,"MARTINEZ DE LA TORRE, VER.",2,2,4,2,0,0,
22-sep-20,VER.,"MARTINEZ DE LA TORRE, VER.",2,2,4,1,0,18,
16-oct-20,CD. MÉX.,"GUSTAVO A. MADERO, CD. MÉX.",0,4,4,0,0,0,
22-oct-20,CD. MÉX.,"GUSTAVO A. MADERO, CD. MÉX.",0,4,4,0,0,0,
23-oct-20,CD. MÉX.,"GUSTAVO A. MADERO, CD. MÉX.",3,1,4,0,0,316,
26-oct-20,CD. MÉX.,"TLALPAN, CD. MÉX.",4,0,4,0,0,0,
03-nov-20,CD. MÉX.,"GUSTAVO A. MADERO, CD. MÉX.",1,3,4,0,0,35,
23-nov-20,CD. MÉX.,"GUSTAVO A. MADERO, CD. MÉX.",1,3,4,0,0,0,
24-nov-20,CD. MÉX.,"GUSTAVO A. MADERO, CD. MÉX.",2,2,4,0,0,0,
30-nov-20,CD. MÉX.,"GUSTAVO A. MADERO, CD. MÉX.",1,3,4,0,0,0,
03-dic-20,CD. MÉX.,"GUSTAVO A. MADERO, CD. MÉX.",0,4,4,0,0,0,
04-dic-20,CD. MÉX.,"GUSTAVO A. MADERO, CD. MÉX.",1,3,4,0,0,0,
11-dic-20,CD. MÉX.,"VENUSTIANO CARRANZA, CD. MÉX.",4,0,4,0,0,109,
16-dic-20,CD. MÉX.,"VENUSTIANO CARRANZA, CD. MÉX.",4,0,4,0,0,573,
16-dic-20,CD. MÉX.,"CUAUHTEMOC, CD. MÉX.",0,4,4,0,0,0,
17-dic-20,CD. MÉX.,"GUSTAVO A. MADERO, CD. MÉX.",2,2,4,0,0,0,
19-jul-21,COAH.,"MONCLOVA, COAH.",4,0,4,2,1,141,
20-jul-21,VER.,"MINATITLAN, VER.",3,1,4,2,0,674,
22-jul-21,VER.,"POZA RICA DE HGO., VER.",3,1,4,3,0,206,
23-jul-21,COAH.,"TORREÓN, COAH.",1,3,4,0,0,0,
20-oct-21,CD. MÉX.,"IZTACALCO, CD. MÉX.",4,0,4,0,0,4,
09-nov-21,TLAX.,"ZACATELCO, TLAX.",3,1,4,0,0,0,
10-nov-21,TLAX.,"CONTLA DE JUAN CUAMATZI, TLAX.",3,1,4,0,0,62,
10-nov-21,TLAX.,"ZACATELCO, TLAX.",4,0,4,0,0,0,
11-nov-21,TLAX.,"CONTLA DE JUAN CUAMATZI, TLAX.",2,2,4,0,0,78,
12-nov-21,TLAX.,"CONTLA DE JUAN CUAMATZI, TLAX.",4,0,4,0,0,19,
18-nov-21,TLAX.,"SAN PABLO DEL MONTE, TLAX.",1,3,4,0,0,0,
25-nov-21,TLAX.,"HUAMANTLA, TLAX.",3,1,4,0,0,70,
30-nov-21,CHIS.,"BERRIOZÁBAL, CHIS.",3,1,4,2,6,722,
06-dic-21,CHIH.,"CHIH., CHIH.",2,2,4,0,0,0,
07-dic-21,CHIH.,"JUÁREZ, CHIH.",3,1,4,4,0,1141,
07-dic-21,SON.,"HERMOSILLO, SON.",1,3,4,0,1,42,
10-dic-21,CHIS.,"PUEBLO NUEVO SOLISTAHUACÁN, CHIS.",4,0,4,0,0,0,
11-dic-21,CHIS.,"PUEBLO NUEVO SOLISTAHUACÁN, CHIS.",3,1,4,0,0,0,
17-dic-21,SON.,"HERMOSILLO, SON.",1,3,4,0,0,13,
17-dic-21,CHIS.,"SAN CRISTOBAL DE LAS CASAS, CHIS.",1,3,4,0,0,1,
11-abr-22,CD. MÉX.,"CUAUHTEMOC, CD. MÉX.",4,0,4,0,0,79,
23-abr-22,S.L.P.,"SOLEDAD DE GRACIANO SANCHEZ, S.L.P.",3,1,4,0,0,0,
29-abr-22,S.L.P.,"CIUDAD VALLES, S.L.P.",3,1,4,0,0,79,
13-may-22,SIN.,"EL FUERTE, SIN.",1,3,4,0,0,0,
13-may-22,SIN.,"SIN., SIN.",3,1,4,0,0,0,
14-may-22,SIN.,"EL FUERTE, SIN.",2,2,4,1,2,0,
21-may-22,VER.,"COATZACOALCOS, VER.",4,0,4,16,0,86,
21-may-22,VER.,"XALAPA, VER.",4,0,4,0,0,219,
24-may-22,CD. MÉX.,"GUSTAVO A. MADERO, CD. MÉX.",3,1,4,0,0,467,
26-may-22,CD. MÉX.,"IZTAPALAPA, CD. MÉX.",4,0,4,0,0,315,
26-may-22,CD. MÉX.,"VENUSTIANO CARRANZA, CD. MÉX.",2,2,4,0,0,89,
26-may-22,VER.,"COATZACOALCOS, VER.",4,0,4,2,0,139,
30-may-22,VER.,"XALAPA, VER.",4,0,4,2,0,13,
01-jun-22,B.C.,"TIJUANA, B.C.",1,3,4,0,0,0,
06-jun-22,SIN.,"AHOME, SIN.",4,0,4,0,0,0,
06-jun-22,TLAX.,"APIZACO, TLAX.",4,0,4,0,0,0,
07-jun-22,TLAX.,"TLAX., TLAX.",3,1,4,0,0,0,
13-jun-22,CD. MÉX.,"AZCAPOTZALCO, CD. MÉX.",4,0,4,0,0,400,
14-jun-22,SIN.,"AHOME, SIN.",3,1,4,0,0,0,
14-jun-22,SIN.,"ANGOSTURA, SIN.",2,2,4,0,0,0,
16-jun-22,SIN.,"AHOME, SIN.",3,1,4,0,0,32,
17-jun-22,SIN.,"GUASAVE, SIN.",4,0,4,0,0,0,
18-jun-22,CHIH.,,4,0,4,17,0,156,
22-jun-22,N.L.,"MONTERREY, N.L.",3,1,4,3,0,196,
28-jun-22,CD. MÉX.,"BENITO JUAREZ, CD. MÉX.",3,1,4,0,0,60,
28-jun-22,JAL.,"ZAPOPAN, JAL.",4,0,4,2,0,1126,
29-jun-22,CD. MÉX.,"ALVARO OBREGON, CD. MÉX.",0,4,4,0,0,0,
30-jun-22,CD. MÉX.,"BENITO JUAREZ, CD. MÉX.",3,1,4,0,0,812,
04-jul-22,CD. MÉX.,"ALVARO OBREGON, CD. MÉX.",2,2,4,0,0,534,
04-jul-22,JAL.,"ZAPOPAN, JAL.",2,2,4,0,1,116,
07-jul-22,SIN.,"BADIRAGUATO, SIN.",3,1,4,0,1,0,
07-jul-22,JAL.,"TLAQUEPAQUE, JAL.",2,2,4,3,0,36,
08-jul-22,CHIH.,"JUÁREZ, CHIH.",1,3,4,24,0,116,
08-jul-22,S.L.P.,"SAN LUIS POTOSI, S.L.P.",3,1,4,0,0,0,
12-jul-22,JAL.,"TLAQUEPAQUE, JAL.",2,2,4,4,2,46,
13-jul-22,SIN.,"BADIRAGUATO, SIN.",2,2,4,0,0,0,
14-jul-22,CHIH.,"JUÁREZ, CHIH.",2,2,4,3,0,197,
15-jul-22,VER.,"VER., VER.",3,1,4,3,0,39,
16-jul-22,VER.,"VER., VER.",4,0,4,8,0,0,
20-jul-22,VER.,"VER., VER.",4,0,4,7,3,447,
20-jul-22,TAMPS.,"CIUDAD MADERO, TAMPS.",4,0,4,0,0,110,
21-jul-22,TAMPS.,"CIUDAD MADERO, TAMPS.",4,0,4,0,0,268,
22-jul-22,JAL.,"TONALA, JAL.",4,0,4,8,0,215,
29-jul-22,TAMPS.,"CIUDAD MADERO, TAMPS.",4,0,4,0,0,54,
02-ago-22,CD. MÉX.,"BENITO JUAREZ, CD. MÉX.",4,0,4,0,0,172,
02-ago-22,PUE.,"ATLIXCO, PUE.",4,0,4,0,0,0,
05-ago-22,CD. MÉX.,"BENITO JUAREZ, CD. MÉX.",4,0,4,0,1,242,
08-ago-22,CHIS.,"TUXTLA GUTIÉRREZ, CHIS.",1,3,4,0,0,1369,
09-ago-22,CD. MÉX.,"BENITO JUAREZ, CD. MÉX.",3,1,4,0,0,286,
12-ago-22,CD. MÉX.,"CUAUHTEMOC, CD. MÉX.",4,0,4,0,0,2,
15-ago-22,COAH.,"ARTEAGA, COAH.",2,2,4,0,0,0,
17-ago-22,SIN.,"SIN., SIN.",3,1,4,0,0,50,
17-ago-22,TAMPS.,"REYNOSA, TAMPS.",3,1,4,8,0,164,
21-ago-22,QRO.,"AMEALCO DE BONFIL, QRO.",1,3,4,0,0,0,
22-ago-22,COAH.,"PIEDRAS NEGRAS, COAH.",3,1,4,0,0,0,
23-ago-22,N.L.,"APODACA, N.L.",3,1,4,1,0,68,
23-ago-22,COAH.,"SABINAS, COAH.",1,3,4,0,0,51,
24-ago-22,MÉX.,"NEZAHUALCOYOTL, MEX.",3,1,4,19,1,224,
25-ago-22,MÉX.,"NEZAHUALCOYOTL, MEX.",3,1,4,0,2,715,
26-ago-22,MÉX.,"HUIXQUILUCAN, MEX.",3,1,4,1,0,108,
26-ago-22,COAH.,"SALTILLO, COAH.",1,3,4,8,0,249,
29-ago-22,MÉX.,"TEPETLAOXTOC, MEX.",2,2,4,0,0,2,
30-ago-22,MÉX.,"NEZAHUALCOYOTL, MEX.",4,0,4,29,0,977,
31-ago-22,MÉX.,"CHIMALHUACAN, MEX.",2,2,4,3,0,100,
02-sep-22,ZAC.,"GUADALUPE, ZAC.",3,1,4,1,1,286,
02-sep-22,MÉX.,"ATIZAPAN, MEX.",4,0,4,1,0,511,
03-sep-22,ZAC.,"ZAC., ZAC.",2,2,4,2,0,106,
03-sep-22,TAMPS.,"MATAMOROS, TAMPS.",4,0,4,3,0,49,
05-sep-22,COAH.,"ACUÑA, COAH.",1,3,4,0,0,0,
06-sep-22,MÉX.,"NAUCALPAN DE JUAREZ, MEX.",4,0,4,0,0,0,
08-sep-22,MÉX.,"TOLUCA, MEX.",4,0,4,0,0,3,
08-sep-22,MÉX.,"NAUCALPAN DE JUAREZ, MEX.",4,0,4,0,0,17,
10-sep-22,MÉX.,"CUAUTITLAN IZCALLI, MEX.",2,2,4,0,1,262,
15-sep-22,MÉX.,"ECATEPEC DE MOR., MEX.",1,3,4,0,0,0,
19-sep-22,MÉX.,"NEZAHUALCOYOTL, MEX.",3,1,4,0,0,6,
21-sep-22,MÉX.,"NEZAHUALCOYOTL, MEX.",4,0,4,0,0,816,
22-sep-22,MÉX.,"TECAMAC, MEX.",3,1,4,0,0,129,
23-sep-22,MÉX.,"NICOLAS ROMERO, MEX.",2,2,4,0,0,11,
25-sep-22,S.L.P.,"SAN LUIS POTOSI, S.L.P.",1,3,4,0,0,0,
26-sep-22,MÉX.,"ALMOLOYA DE JUAREZ, MEX.",2,2,4,0,0,0,
29-sep-22,MÉX.,"OCOYOACAC, MEX.",0,4,4,0,0,0,
30-sep-22,MÉX.,"TECAMAC, MEX.",2,2,4,0,0,3,
01-oct-22,MÉX.,"ALMOLOYA DE JUAREZ, MEX.",2,2,4,0,0,0,
07-oct-22,CD. MÉX.,"CUAUHTEMOC, CD. MÉX.",1,3,4,0,0,11,
08-oct-22,MÉX.,"TULTEPEC, MEX.",1,3,4,0,0,0,
08-oct-22,MÉX.,"CHALCO, MEX.",4,0,4,0,0,245,
11-oct-22,JAL.,"PUERTO VALLARTA, JAL.",2,2,4,0,0,0,
12-oct-22,DGO.,"DGO., DGO.",3,1,4,1,0,281,
13-oct-22,JAL.,"PUERTO VALLARTA, JAL.",3,1,4,0,155,950,
13-oct-22,CD. MÉX.,"CUAUHTEMOC, CD. MÉX.",3,1,4,0,0,0,
17-oct-22,CD. MÉX.,"ALVARO OBREGON, CD. MÉX.",2,2,4,0,0,0,
18-oct-22,MÉX.,"EL ORO, MEX.",4,0,4,0,0,0,
24-oct-22,MÉX.,"LERMA, MEX.",4,0,4,0,0,0,
24-oct-22,MÉX.,"COYOTEPEC, MEX.",4,0,4,0,0,0,
24-oct-22,TAMPS.,"NUEVO LAREDO, TAMPS.",3,1,4,0,0,186,
25-oct-22,TAMPS.,"NUEVO LAREDO, TAMPS.",3,1,4,0,0,1070,
28-oct-22,TAMPS.,"NUEVO LAREDO, TAMPS.",3,1,4,0,0,16,
29-oct-22,TLAX.,"CONTLA DE JUAN CUAMATZI, TLAX.",2,2,4,0,0,0,
31-oct-22,MÉX.,"CHICOLOAPAN, MEX.",4,0,4,0,0,47,
03-nov-22,TLAX.,"TLAX., TLAX.",4,0,4,0,0,0,
03-nov-22,MÉX.,"CHICOLOAPAN, MEX.",3,1,4,0,0,201,
05-nov-22,VER.,"ACAYUCAN, VER.",4,0,4,0,0,83,
05-nov-22,MÉX.,"CHICOLOAPAN, MEX.",4,0,4,0,0,28,
08-nov-22,OAX.,"SANTIAGO PINOTEPA NACIONAL, OAX.",4,0,4,18,0,146,
08-nov-22,TAMPS.,"NUEVO LAREDO, TAMPS.",2,2,4,0,0,309,
09-nov-22,MOR.,"AYALA, MOR.",4,0,4,0,0,0,
24-nov-22,TAB.,"CARDENAS, TAB.",2,2,4,9,0,0,
02-dic-22,SIN.,"CULIACAN, SIN.",4,0,4,0,0,98,
09-dic-22,SIN.,"NAVOLATO, SIN.",1,3,4,0,0,9,
13-dic-22,SIN.,"CULIACAN, SIN.",4,0,4,0,0,177,
15-dic-22,SON.,"HERMOSILLO, SON.",3,1,4,4,0,0,
13-feb-23,Cd. de México,"TLALPAN, CD. MÉX.",4,0,4,0,0,99,
23-feb-23,Cd. de México,"BENITO JUAREZ, CD. MÉX.",4,0,4,0,0,83,
01-mar-23,Cd. de México,"CUAUHTEMOC, CD. MÉX.",4,0,4,0,0,521,
02-mar-23,Cd. de México,"IZTAPALAPA, CD. MÉX.",3,1,4,0,0,40,
05-mar-23,Veracruz,"JALTIPAN, VER.",2,2,4,0,0,"13,058",
07-mar-23,Veracruz,"JALTIPAN, VER.",3,1,4,0,0,"11,119",
09-mar-23,Cd. de México,"AZCAPOTZALCO, CD. MÉX.",0,4,4,0,0,168,
09-mar-23,México,"NEZAHUALCOYOTL, MEX.",3,1,4,0,1,255,
10-mar-23,México,"NEZAHUALCOYOTL, MEX.",4,0,4,0,5,55,
16-mar-23,México,"IXTAPALUCA, MEX.",3,1,4,0,1,23,
18-mar-23,México,"IXTAPALUCA, MEX.",3,1,4,0,2,155,
21-mar-23,Cd. de México,"MIGUEL HIDALGO, CD. MÉX.",3,1,4,0,0,94,
21-mar-23,México,"CUAUTITLAN, MEX.",3,1,4,0,0,0,
24-mar-23,Cd. de México,"CUAUHTEMOC, CD. MÉX.",3,1,4,0,0,39,
27-mar-23,México,"NAUCALPAN DE JUAREZ, MEX.",4,0,4,0,0,4,
27-mar-23,México,"CUAUTITLAN IZCALLI, MEX.",1,3,4,0,0,244,
29-mar-23,México,"TLALNEPANTLA DE BAZ, MEX.",1,3,4,0,1,0,
10-abr-23,Cd. de México,"CUAUHTEMOC, CD. MÉX.",4,0,4,0,0,598,
12-abr-23,Cd. de México,"CUAUHTEMOC, CD. MÉX.",3,1,4,0,0,201,
12-abr-23,Guanajuato,"DOLORES HIDALGO CUNA DE LA INDEPENDENCIA NACIONAL, GTO.",2,2,4,0,0,0,
13-abr-23,Cd. de México,"ALVARO OBREGON, CD. MÉX.",1,3,4,0,0,0,
17-abr-23,Cd. de México,"BENITO JUAREZ, CD. MÉX.",3,1,4,0,0,715,
18-abr-23,Cd. de México,"TLALPAN, CD. MÉX.",3,1,4,0,0,0,
18-abr-23,Cd. de México,"CUAUHTEMOC, CD. MÉX.",3,1,4,0,0,180,
21-abr-23,Cd. de México,"COYOACAN, CD. MÉX.",4,0,4,0,0,79,
26-abr-23,Cd. de México,"CUAUHTEMOC, CD. MÉX.",2,2,4,0,0,423,
26-abr-23,Cd. de México,"COYOACAN, CD. MÉX.",2,2,4,0,0,307,
27-abr-23,Cd. de México,"CUAUHTEMOC, CD. MÉX.",3,1,4,0,0,0,
04-may-23,Cd. de México,"CUAUHTEMOC, CD. MÉX.",2,2,4,0,0,72,
10-may-23,Cd. de México,"CUAUHTEMOC, CD. MÉX.",3,1,4,0,0,0,
13-may-23,Querétaro,"CORREGIDORA, QRO.",3,1,4,3,0,46,
15-may-23,Michoacán,"TARIMBARO, MICH.",4,0,4,5,0,0,
16-may-23,Sinaloa,"NAVOLATO, SIN.",2,2,4,0,0,29,
18-may-23,Sinaloa,"NAVOLATO, SIN.",3,1,4,0,1,"1,573",
18-may-23,Cd. de México,"CUAUHTEMOC, CD. MÉX.",3,1,4,0,0,188,
19-may-23,Colima,"TECOMÁN, COL.",1,3,4,2,1,14,
26-may-23,Michoacán,"HIDALGO, MICH.",4,0,4,85,0,115,
31-may-23,Cd. de México,"LA MAGDALENA CONTRERAS, CD. MÉX.",4,0,4,0,0,184,
05-jun-23,Cd. de México,"CUAUHTEMOC, CD. MÉX.",1,3,4,0,1,519,
13-jun-23,Cd. de México,"CUAUHTEMOC, CD. MÉX.",4,0,4,0,0,169,
17-jun-23,México,"LA PAZ, MEX.",3,1,4,0,0,5,
17-jun-23,México,"NEXTLALPAN, MEX., MEX.",2,2,4,0,0,0,
19-jun-23,Cd. de México,"CUAUHTEMOC, CD. MÉX.",4,0,4,0,0,235,
22-jun-23,Tlaxcala,"HUAMANTLA, TLAX.",1,3,4,0,0,0,
24-jun-23,Guanajuato,"SALAMANCA, GTO.",4,0,4,6,0,183,
24-jun-23,México,"ZINACANTEPEC, MEX.",4,0,4,0,0,0,
28-jun-23,Sinaloa,"GUASAVE, SIN.",2,2,4,0,0,0,
29-jun-23,Guanajuato,"APASEO EL GRANDE, GTO.",2,2,4,2,0,109,
04-jul-23,México,"XALATLACO, MEX.",4,0,4,0,2,0,
06-jul-23,México,"VALLE DE CHALCO SOLIDARIDAD, MEX.",4,0,4,0,0,0,
09-jul-23,Tlaxcala,"SANTA CRUZ TLAXCALA, TLAX.",2,2,4,0,0,0,
13-jul-23,Tlaxcala,"APIZACO, TLAX.",3,1,4,0,0,0,
13-jul-23,México,"VALLE DE BRAVO, MEX.",2,2,4,0,0,0,
13-jul-23,México,"CHIMALHUACAN, MEX.",4,0,4,0,0,84,
14-jul-23,Cd. de México,"CUAUHTEMOC, CD. MÉX.",4,0,4,0,0,13,
15-jul-23,Puebla,"ATLIXCO, PUE.",2,2,4,5,3,"1,658",
18-jul-23,México,"TULTITLAN, MEX.",3,1,4,0,0,31,
18-jul-23,Cd. de México,"CUAUHTEMOC, CD. MÉX.",2,2,4,0,0,0,
18-jul-23,Durango,"GOMEZ PALACIO, DGO.",1,3,4,1,0,17,
19-jul-23,México,"CAPULHUAC, MEX.",2,2,4,0,0,0,
27-jul-23,Chiapas,"HUIXTÁN, CHIS.",0,4,4,0,0,0,
01-ago-23,México,"CUAUTITLAN, MEX.",1,3,4,0,0,168,
04-ago-23,México,"XONACATLAN, MEX.",4,0,4,0,4,"2,000",
05-ago-23,México,"CUAUTITLAN, MEX.",2,2,4,1,2,54,
07-ago-23,México,"ATLACOMULCO, MEX.",1,3,4,0,0,72,
15-ago-23,Sinaloa,"BADIRAGUATO, SIN.",3,1,4,0,0,142,
15-ago-23,Cd. de México,"CUAUHTEMOC, CD. MÉX.",2,2,4,0,0,5,
17-ago-23,Sinaloa,"SALVADOR ALVARADO, SIN.",4,0,4,0,0,81,
18-ago-23,Michoacán,"CUITZEO, MICH.",4,0,4,8,0,145,
25-ago-23,Michoacán,"COPANDARO, MICH.",3,1,4,4,0,29,
28-ago-23,Cd. de México,"BENITO JUAREZ, CD. MÉX.",2,2,4,0,0,133,
28-ago-23,Tabasco,"CARDENAS, TAB.",3,1,4,0,0,566,
31-ago-23,Cd. de México,"CUAUHTEMOC, CD. MÉX.",1,3,4,0,1,10,
01-sep-23,Tamaulipas,"REYNOSA, TAMPS.",2,2,4,8,0,191,
06-sep-23,Michoacán,"MARAVATIO, MICH.",4,0,4,112,0,30,
07-sep-23,Chihuahua,"JUÁREZ, CHIH.",4,0,4,23,0,548,
07-sep-23,Tabasco,"PICHUCALCO, CHIS.",3,1,4,0,0,0,
22-sep-23,Cd. de México,"CUAUHTEMOC, CD. MÉX.",4,0,4,0,0,136,
03-oct-23,Chihuahua,"CHIHUAHUA, CHIH.",2,2,4,0,0,196,
03-oct-23,Sinaloa,"MAZATLAN, SIN.",2,2,4,0,1,119,
03-oct-23,Cd. de México,"CUAUHTEMOC, CD. MÉX.",4,0,4,0,0,242,
06-oct-23,Sinaloa,"MAZATLAN, SIN.",2,2,4,0,0,0,
09-oct-23,Sinaloa,"ROSARIO, SIN.",2,2,4,0,1,0,
10-oct-23,Sinaloa,"MAZATLAN, SIN.",1,3,4,0,0,26,
11-oct-23,Sinaloa,"ESCUINAPA, SIN.",1,3,4,0,0,0,
14-oct-23,Chihuahua,"JUÁREZ, CHIH.",3,1,4,16,0,120,
19-oct-23,Michoacán,"URUAPAN, MICH.",2,2,4,14,0,399,
10-nov-23,Sinaloa,"COSALA, SIN.",3,1,4,0,0,0,
19-nov-23,Nvo. León,"MONTERREY, N.L.",4,0,4,47,1,637,
25-nov-23,Guanajuato,"SAN MIGUEL DE ALLENDE, GTO.",3,1,4,0,0,0,
27-nov-23,Sinaloa,"CULIACAN, SIN.",0,4,4,0,2,500,
28-nov-23,México,"NEZAHUALCOYOTL, MEX.",3,1,4,4,20,298,
29-nov-23,México,"NEZAHUALCOYOTL, MEX.",3,1,4,28,2,718,
30-nov-23,Chihuahua,"JUÁREZ, CHIH.",1,3,4,0,0,16,
30-nov-23,Sinaloa,"CULIACAN, SIN.",2,2,4,0,4,588,
05-dic-23,Sinaloa,"CULIACAN, SIN.",4,0,4,0,0,251,
14-dic-23,Sinaloa,"CULIACAN, SIN.",4,0,4,0,0,348,
06-mar-24,Cd. de México,"CUAUHTEMOC, CD. MÉX.",4,0,4,0,0,0,
24-may-24,Cd. de México,"CUAUHTEMOC, CD. MÉX.",4,0,4,0,0,516,
29-may-24,Cd. de México,"CUAUHTEMOC, CD. MÉX.",1,3,4,0,0,113,
13-jun-24,Cd. de México,"AZCAPOTZALCO, CD. MÉX.",3,1,4,0,0,98,
15-jun-24,Michoacán,"BUENAVISTA, MICH.",4,0,4,25,0,0,
16-jun-24,Michoacán,"BUENAVISTA, MICH.",3,1,4,22,0,0,
18-jun-24,Cd. de México,"BENITO JUAREZ, CD. MÉX.",3,1,4,0,0,157,
18-jun-24,Sinaloa,"CULIACAN, SIN.",2,2,4,0,2,2,
18-jun-24,Cd. de México,"BENITO JUAREZ, CD. MÉX.",3,1,4,0,0,157,
20-jun-24,Sinaloa,"MOCORITO, SIN.",1,3,4,0,0,0,
20-jun-24,Sinaloa,"BADIRAGUATO, SIN.",2,2,4,0,0,139,
24-jun-24,Sinaloa,"NAVOLATO, SIN.",4,0,4,0,0,0,
24-jun-24,Sinaloa,"COSALA, SIN.",1,3,4,0,0,0,
26-jun-24,Cd. de México,"CUAUHTEMOC, CD. MÉX.",4,0,4,0,0,7,
20-jun-24,Baja California,"TIJUANA, B.C.",2,2,4,21,0,300,
21-jun-24,Baja California,"TIJUANA, B.C.",2,2,4,30,0,150,
22-jun-24,Sinaloa,"MAZATLAN, SIN.",2,2,4,10,0,6,
28-jun-24,Sinaloa,"COSALA, SIN.",2,2,4,0,0,0,
27-jun-24,Sinaloa,"NAVOLATO, SIN.",4,0,4,0,0,29,
26-jun-24,Sinaloa,"BADIRAGUATO, SIN.",2,2,4,0,0,11,
26-ene-13,D.F.,"IZTAPALAPA, D.F.",2,1,3,0,0,0,
01-feb-13,B.C.,"ENSENADA, B.C.",0,3,3,0,0,0,
08-feb-13,TAMPS.,"NUEVO LAREDO, TAMPS.",0,3,3,2,0,50,
08-feb-13,B.C.,"TIJUANA, B.C.",1,2,3,0,0,0,
09-feb-13,B.C.,"TIJUANA, B.C.",1,2,3,0,0,0,
09-feb-13,TAMPS.,"TAMPICO, TAMPS.",1,2,3,3,0,701,
11-feb-13,B.C.,"TIJUANA, B.C.",3,0,3,0,0,0,
13-feb-13,JAL.,"GUADALAJARA, JAL.",3,0,3,0,0,0,
15-feb-13,CAMP.,"CAMP., CAMP.",3,0,3,0,0,0,
15-feb-13,TAMPS.,"VICTORIA, TAMPS.",3,0,3,0,0,0,
16-feb-13,TAMPS.,"VICTORIA, TAMPS.",1,2,3,0,0,0,
17-feb-13,TAMPS.,"TAMPICO, TAMPS.",3,0,3,3,2,1148,
18-feb-13,JAL.,"GUADALAJARA, JAL.",2,1,3,0,0,0,
19-feb-13,GRO.,"ACAPULCO DE JUAREZ, GRO.",2,1,3,0,1,97,
21-feb-13,TAMPS.,"NUEVO LAREDO, TAMPS.",3,0,3,9,0,210,
22-feb-13,CAMP.,"CAMP., CAMP.",3,0,3,0,0,0,
22-feb-13,TAMPS.,"NUEVO LAREDO, TAMPS.",1,2,3,3,3,101,
22-feb-13,TAMPS.,"RIO BRAVO, TAMPS.",1,2,3,0,0,0,
23-feb-13,TAMPS.,"CIUDAD MADERO, TAMPS.",3,0,3,19,0,872,
23-feb-13,HGO.,"TULA DE ALLENDE, HGO.",2,1,3,0,2,0,
24-feb-13,GRO.,"ACAPULCO DE JUAREZ, GRO.",2,1,3,2,4,48,
25-feb-13,HGO.,"TULA DE ALLENDE, HGO.",3,0,3,0,0,0,
25-feb-13,HGO.,"HUEJUTLA DE REYES, HGO.",2,1,3,0,0,0,
25-feb-13,CHIH.,"CHIH., CHIH.",1,2,3,0,0,153,
26-feb-13,HGO.,"TULANCINGO DE BRAVO, HGO.",2,1,3,0,0,200,
26-feb-13,JAL.,"ZAPOTLAN EL GRANDE, JAL.",1,2,3,0,0,0,
28-feb-13,CHIH.,"CHIH., CHIH.",3,0,3,0,0,541,
01-mar-13,TAMPS.,"TAMPICO, TAMPS.",2,1,3,0,2,0,
01-mar-13,B.C.,"MEXICALI, B.C.",0,3,3,0,0,0,
03-mar-13,TAMPS.,"CIUDAD MADERO, TAMPS.",3,0,3,3,0,183,
03-mar-13,CHIS.,"SAN CRISTOBAL DE LAS CASAS, CHIS.",2,1,3,0,0,110,
03-mar-13,N.L.,"JUAREZ, N.L.",0,3,3,0,0,100,
03-mar-13,JAL.,"TOMATLAN, JAL.",3,0,3,0,0,0,
04-mar-13,N.L.,"SAN NICOLAS DE LOS GARZA, N.L.",2,1,3,0,0,314,
05-mar-13,TAMPS.,"VICTORIA, TAMPS.",3,0,3,0,4,0,
06-mar-13,N.L.,"GARCIA, N.L.",2,1,3,0,0,135,
07-mar-13,N.L.,"GUADALUPE, N.L.",1,2,3,0,0,3905,
08-mar-13,HGO.,"TULA DE ALLENDE, HGO.",2,1,3,0,0,400,
08-mar-13,N.L.,"GUADALUPE, N.L.",3,0,3,1,0,5082,
08-mar-13,MICH.,"LAZARO CARDENAS, MICH.",3,0,3,3,0,44,
08-mar-13,TAMPS.,"CIUDAD MADERO, TAMPS.",3,0,3,21,0,569,
09-mar-13,N.L.,"SAN PEDRO GARZA GARCIA, N.L.",2,1,3,2,1,850,
09-mar-13,TAMPS.,"NUEVO LAREDO, TAMPS.",1,2,3,0,1,25,
10-mar-13,N.L.,"GARCIA, N.L.",1,2,3,0,0,16778,
10-mar-13,TAMPS.,"CIUDAD MADERO, TAMPS.",3,0,3,1,0,5,
11-mar-13,TAMPS.,"VICTORIA, TAMPS.",3,0,3,0,0,10,
11-mar-13,COAH.,"TORREÓN, COAH.",3,0,3,0,0,0,
13-mar-13,AGS.,"AGS., AGS.",3,0,3,1,0,18,
13-mar-13,HGO.,"TIZAYUCA, HGO.",3,0,3,0,2,0,
13-mar-13,CHIH.,"CHIH., CHIH.",3,0,3,0,0,0,
15-mar-13,HGO.,"TEPEAPULCO, HGO.",3,0,3,0,0,26,
15-mar-13,CAMP.,"CARMEN, CAMP.",2,1,3,0,0,0,
15-mar-13,TAMPS.,"CIUDAD MADERO, TAMPS.",3,0,3,0,0,19,
15-mar-13,CHIH.,"CUAUHTÉMOC, CHIH.",2,1,3,0,0,0,
17-mar-13,TAMPS.,"CIUDAD MADERO, TAMPS.",1,2,3,0,0,474,
19-mar-13,HGO.,"IXMIQUILPAN, HGO.",3,0,3,0,0,419,
20-mar-13,S.L.P.,"SOLEDAD DE GRACIANO SANCHEZ, S.L.P.",1,2,3,0,0,7,
20-mar-13,HGO.,"TEPEAPULCO, HGO.",3,0,3,0,0,444,
22-mar-13,CHIH.,"ASCENSIÓN, CHIH.",1,2,3,0,0,0,
23-mar-13,HGO.,"TEPEAPULCO, HGO.",1,2,3,0,5,0,
24-mar-13,N.L.,"VILLALDAMA, N.L.",1,2,3,0,0,0,
24-mar-13,TAMPS.,"CIUDAD MADERO, TAMPS.",2,1,3,0,0,0,
26-mar-13,HGO.,"TIZAYUCA, HGO.",3,0,3,0,0,91,
27-mar-13,AGS.,"AGS., AGS.",3,0,3,2,0,106,
27-mar-13,YUC.,"VALLADOLID, YUC.",1,2,3,0,0,0,
28-mar-13,N.L.,"BUSTAMANTE, N.L.",2,1,3,0,0,5200,
29-mar-13,N.L.,"BUSTAMANTE, N.L.",3,0,3,10,0,300,
30-mar-13,N.L.,"CERRALVO, N.L.",2,1,3,3,0,0,
31-mar-13,GRO.,"ACAPULCO DE JUAREZ, GRO.",2,1,3,0,10,0,
01-abr-13,MEX.,"IXTLAHUACA, MEX.",3,0,3,2,0,77,
03-abr-13,N.L.,"ALLENDE, N.L.",3,0,3,0,0,320,
03-abr-13,COL.,"COL., COL.",2,1,3,0,0,0,
03-abr-13,MICH.,"SALVADOR ESCALANTE, MICH.",2,1,3,0,1,0,
04-abr-13,N.L.,"LOS ALDAMAS, N.L.",0,3,3,3,0,0,
04-abr-13,Q. ROO,"BENITO JUAREZ, Q. ROO",1,2,3,0,0,219,
05-abr-13,AGS.,"COSÍO, AGS.",2,1,3,0,0,0,
05-abr-13,TAMPS.,"CIUDAD MADERO, TAMPS.",2,1,3,0,1,0,
07-abr-13,MICH.,"SALVADOR ESCALANTE, MICH.",3,0,3,0,0,0,
09-abr-13,OAX.,"SANTA MARIA ATZOMPA, OAX.",2,1,3,1,1,0,
10-abr-13,B.C.,"TIJUANA, B.C.",2,1,3,0,0,0,
11-abr-13,MEX.,"ALMOLOYA DE JUAREZ, MEX.",2,1,3,0,0,0,
11-abr-13,HGO.,"TIZAYUCA, HGO.",3,0,3,0,0,0,
11-abr-13,OAX.,"SANTIAGO JAMILTEPEC, OAX.",1,2,3,0,0,0,
11-abr-13,OAX.,"SANTIAGO JAMILTEPEC, OAX.",1,2,3,0,0,0,
12-abr-13,N.L.,"MINA, N.L.",2,1,3,1,0,300,
12-abr-13,MEX.,"IXTAPAN DE LA SAL, MEX.",3,0,3,2,0,0,
13-abr-13,COL.,"COL., COL.",3,0,3,0,0,94,
13-abr-13,JAL.,"CABO CORRIENTES, JAL.",1,2,3,0,0,0,
15-abr-13,S.L.P.,"MATEHUALA, S.L.P.",1,2,3,0,0,0,
15-abr-13,OAX.,"MATIAS ROMERO AVENDAÑO, OAX.",2,1,3,11,0,0,
15-abr-13,MICH.,"LA PIEDAD, MICH.",2,1,3,0,0,0,
15-abr-13,MICH.,"TACAMBARO, MICH.",1,2,3,0,0,0,
15-abr-13,CAMP.,"CALAKMUL, CAMP.",0,3,3,0,0,0,
16-abr-13,NAY.,"TEPIC, NAY.",0,3,3,0,0,0,
16-abr-13,NAY.,"ACAPONETA, NAY.",0,3,3,0,0,0,
16-abr-13,MICH.,"TACAMBARO, MICH.",3,0,3,0,0,0,
17-abr-13,S.L.P.,"MATEHUALA, S.L.P.",2,1,3,0,0,0,
17-abr-13,MICH.,"MARAVATIO, MICH.",1,2,3,0,0,0,
17-abr-13,TAMPS.,"MATAMOROS, TAMPS.",0,3,3,0,0,0,
18-abr-13,MEX.,"ATIZAPAN, MEX.",1,2,3,1,0,0,
18-abr-13,OAX.,"SAN LUCAS OJITLAN, OAX.",0,3,3,0,0,0,
18-abr-13,NAY.,"TEPIC, NAY.",3,0,3,0,0,0,
19-abr-13,AGS.,"SAN FRANCISCO DE LOS ROMO, AGS.",2,1,3,1,0,110,
19-abr-13,OAX.,"ZIMATLAN DE ALVAREZ, OAX.",2,1,3,0,0,0,
19-abr-13,N.L.,"ARAMBERRI, N.L.",2,1,3,1,0,250,
19-abr-13,CHIH.,"NUEVO CASAS GRANDES, CHIH.",2,1,3,0,0,0,
19-abr-13,MICH.,"TACAMBARO, MICH.",1,2,3,0,0,0,
20-abr-13,S.L.P.,"MATEHUALA, S.L.P.",3,0,3,0,0,0,
20-abr-13,HGO.,"HUAUTLA, HGO.",2,1,3,0,0,0,
20-abr-13,MEX.,"ATIZAPAN, MEX.",3,0,3,1,0,0,
20-abr-13,CHIS.,"SALTO DE AGUA, CHIS.",2,1,3,0,0,0,
20-abr-13,TAMPS.,"REYNOSA, TAMPS.",0,3,3,0,0,0,
21-abr-13,QRO.,"PEÑAMILLER, QRO.",3,0,3,0,0,0,
21-abr-13,OAX.,"SAN DIONISIO OCOTEPEC, OAX.",1,2,3,0,0,0,
22-abr-13,B.C.,"TIJUANA, B.C.",1,2,3,0,0,0,
22-abr-13,TAMPS.,"MATAMOROS, TAMPS.",1,2,3,0,0,0,
22-abr-13,TAMPS.,"MATAMOROS, TAMPS.",1,2,3,0,0,0,
22-abr-13,MICH.,"APATZINGAN, MICH.",2,1,3,0,1,0,
23-abr-13,N.L.,"SALINAS VICTORIA, N.L.",1,2,3,7,0,250,
23-abr-13,GRO.,"ACAPULCO DE JUAREZ, GRO.",3,0,3,0,3,0,
24-abr-13,SIN.,"GUASAVE, SIN.",2,1,3,0,5,0,
24-abr-13,NAY.,"ACAPONETA, NAY.",3,0,3,0,0,0,
24-abr-13,OAX.,"SANTA MARIA JACATEPEC, OAX.",2,1,3,0,0,0,
25-abr-13,YUC.,"CHEMAX, YUC.",0,3,3,0,0,0,
25-abr-13,CHIS.,"LAS MARGARITAS, CHIS.",2,1,3,0,0,0,
25-abr-13,MICH.,"TACAMBARO, MICH.",2,1,3,0,0,0,
25-abr-13,B.C.,"TIJUANA, B.C.",1,2,3,0,0,0,
26-abr-13,AGS.,"SAN FRANCISCO DE LOS ROMO, AGS.",2,1,3,0,0,6,
26-abr-13,N.L.,"HUALAHUISES, N.L.",2,1,3,0,0,300,
27-abr-13,HGO.,"HUEJUTLA DE REYES, HGO.",3,0,3,0,0,0,
28-abr-13,MICH.,"TACAMBARO, MICH.",1,2,3,0,0,0,
29-abr-13,MICH.,"JIQUILPAN, MICH.",3,0,3,0,0,0,
29-abr-13,B.C.,"TIJUANA, B.C.",3,0,3,0,0,0,
02-may-13,TAB.,"CARDENAS, TAB.",2,1,3,0,0,0,
02-may-13,B.C.,"TIJUANA, B.C.",1,2,3,0,0,0,
03-may-13,N.L.,"LINARES, N.L.",1,2,3,0,0,0,
03-may-13,MICH.,"JIQUILPAN, MICH.",2,1,3,0,0,0,
03-may-13,B.C.,"TIJUANA, B.C.",2,1,3,0,0,0,
04-may-13,TAB.,"CENTRO, TAB.",3,0,3,2,0,0,
05-may-13,MICH.,"ZACAPU, MICH.",3,0,3,0,2,0,
06-may-13,AGS.,"CALVILLO, AGS.",2,1,3,0,0,0,
08-may-13,NAY.,"TEPIC, NAY.",3,0,3,1,0,5,
08-may-13,AGS.,"CALVILLO, AGS.",0,3,3,0,0,0,
10-may-13,MICH.,"APATZINGAN, MICH.",2,1,3,0,0,0,
10-may-13,N.L.,"CHINA, N.L.",2,1,3,0,0,0,
11-may-13,MICH.,"JIQUILPAN, MICH.",3,0,3,0,0,0,
12-may-13,N.L.,"DR. GONZALEZ, N.L.",2,1,3,0,0,500,
13-may-13,GRO.,"TIXTLA DE GRO., GRO.",1,2,3,0,0,0,
13-may-13,CHIS.,"LAS MARGARITAS, CHIS.",3,0,3,0,0,0,
14-may-13,MICH.,"HUETAMO, MICH.",2,1,3,1,0,0,
15-may-13,B.C.,"TIJUANA, B.C.",0,3,3,0,0,0,
16-may-13,N.L.,"DR. COSS, N.L.",0,3,3,4,0,0,
16-may-13,TAMPS.,"VICTORIA, TAMPS.",3,0,3,2,3,830,
16-may-13,B.C.,"ENSENADA, B.C.",0,3,3,0,0,0,
16-may-13,B.C.,"MEXICALI, B.C.",1,2,3,0,0,0,
17-may-13,AGS.,"PABELLÓN DE ARTEAGA, AGS.",2,1,3,0,0,117,
18-may-13,VER.,"COATZACOALCOS, VER.",0,3,3,0,0,315,
19-may-13,MICH.,"HUETAMO, MICH.",1,2,3,0,0,0,
19-may-13,N.L.,"PESQUERIA, N.L.",1,2,3,2,0,150,
19-may-13,JAL.,"GUADALAJARA, JAL.",0,3,3,0,0,56,
20-may-13,MICH.,"HUETAMO, MICH.",1,2,3,0,0,0,
20-may-13,CHIS.,"COMITAN DE DOMÍNGUEZ, CHIS.",2,1,3,0,0,0,
20-may-13,MICH.,"LAZARO CARDENAS, MICH.",3,0,3,3,0,0,
20-may-13,TAMPS.,"GONZALEZ, TAMPS.",2,1,3,0,0,0,
21-may-13,B.C.S.,"MULEGÉ, B.C.S.",2,1,3,0,0,0,
21-may-13,MICH.,"HUETAMO, MICH.",1,2,3,0,0,0,
21-may-13,COAH.,"MONCLOVA, COAH.",3,0,3,0,0,0,
22-may-13,JAL.,"TOMATLAN, JAL.",0,3,3,0,0,0,
22-may-13,CHIS.,"COMITAN DE DOMÍNGUEZ, CHIS.",1,2,3,0,0,4,
22-may-13,MICH.,"HUETAMO, MICH.",1,2,3,0,0,0,
22-may-13,MICH.,"HUETAMO, MICH.",1,2,3,0,0,0,
23-may-13,MICH.,"HUETAMO, MICH.",3,0,3,3,0,0,
23-may-13,MICH.,"LAZARO CARDENAS, MICH.",3,0,3,1,0,0,
24-may-13,CAMP.,"CAMP., CAMP.",2,1,3,0,0,0,
24-may-13,NAY.,"TEPIC, NAY.",1,2,3,0,0,0,
24-may-13,OAX.,"CIUDAD IXTEPEC, OAX.",2,1,3,1,0,0,
24-may-13,N.L.,"GRAL. ZARAGOZA, N.L.",2,1,3,14,0,100,
24-may-13,S.L.P.,"SAN LUIS POTOSI, S.L.P.",3,0,3,0,0,0,
24-may-13,MICH.,"LAZARO CARDENAS, MICH.",2,1,3,0,0,0,
24-may-13,B.C.,"TIJUANA, B.C.",2,1,3,0,0,0,
24-may-13,TAMPS.,"MATAMOROS, TAMPS.",0,3,3,0,0,0,
24-may-13,OAX.,"CIUDAD IXTEPEC, OAX.",2,1,3,2,0,0,
26-may-13,MICH.,"URUAPAN, MICH.",1,2,3,0,0,0,
26-may-13,TAMPS.,"MATAMOROS, TAMPS.",0,3,3,0,0,0,
27-may-13,MICH.,"HUETAMO, MICH.",3,0,3,1,0,0,
27-may-13,MICH.,"LAZARO CARDENAS, MICH.",3,0,3,1,0,5,
27-may-13,S.L.P.,"SAN LUIS POTOSI, S.L.P.",0,3,3,0,0,0,
28-may-13,MICH.,"HUETAMO, MICH.",2,1,3,3,0,0,
29-may-13,S.L.P.,"SAN LUIS POTOSI, S.L.P.",3,0,3,0,0,0,
29-may-13,CAMP.,"CAMP., CAMP.",3,0,3,0,0,0,
29-may-13,MICH.,"HUETAMO, MICH.",0,3,3,0,0,0,
29-may-13,B.C.,"TIJUANA, B.C.",0,3,3,0,0,0,
30-may-13,MICH.,"URUAPAN, MICH.",3,0,3,2,0,0,
30-may-13,TAMPS.,"MATAMOROS, TAMPS.",2,1,3,0,0,0,
31-may-13,S.L.P.,"CIUDAD VALLES, S.L.P.",2,1,3,0,0,0,
01-jun-13,MICH.,"HUETAMO, MICH.",2,1,3,2,0,0,
03-jun-13,SIN.,"ANGOSTURA, SIN.",2,1,3,0,5,0,
04-jun-13,S.L.P.,"SAN LUIS POTOSI, S.L.P.",3,0,3,0,0,0,
05-jun-13,MICH.,"TEPALCATEPEC, MICH.",1,2,3,1,0,0,
05-jun-13,SIN.,"ANGOSTURA, SIN.",2,1,3,0,3,0,
06-jun-13,TAB.,"BALANCAN, TAB.",2,1,3,0,0,0,
06-jun-13,B.C.,"TIJUANA, B.C.",3,0,3,0,0,0,
07-jun-13,B.C.,"ENSENADA, B.C.",3,0,3,0,0,0,
08-jun-13,NAY.,"TEPIC, NAY.",3,0,3,0,1,0,
10-jun-13,B.C.,"TIJUANA, B.C.",1,2,3,0,0,0,
10-jun-13,S.L.P.,"SAN LUIS POTOSI, S.L.P.",3,0,3,0,1,0,
11-jun-13,CAMP.,"HECELCHAKÁN, CAMP.",2,1,3,0,0,0,
11-jun-13,MICH.,"APATZINGAN, MICH.",3,0,3,0,0,0,
11-jun-13,SIN.,"MOCORITO, SIN.",3,0,3,0,2,0,
12-jun-13,S.L.P.,"SAN LUIS POTOSI, S.L.P.",2,1,3,0,0,0,
12-jun-13,MICH.,"APATZINGAN, MICH.",2,1,3,0,0,0,
12-jun-13,B.C.,"MEXICALI, B.C.",2,1,3,0,0,0,
13-jun-13,COAH.,"TORREÓN, COAH.",2,1,3,0,0,0,
13-jun-13,B.C.,"ENSENADA, B.C.",1,2,3,0,0,0,
14-jun-13,S.L.P.,"SAN LUIS POTOSI, S.L.P.",2,1,3,0,0,0,
14-jun-13,TAB.,"COMALCALCO, TAB.",2,1,3,0,0,0,
15-jun-13,B.C.,"TIJUANA, B.C.",2,1,3,0,0,0,
16-jun-13,JAL.,"AUTLAN DE NAVARRO, JAL.",2,1,3,0,0,6,
18-jun-13,B.C.,"TIJUANA, B.C.",2,1,3,0,0,0,
19-jun-13,CHIH.,"AHUMADA, CHIH.",3,0,3,0,0,0,
20-jun-13,B.C.,"ENSENADA, B.C.",1,2,3,0,0,0,
22-jun-13,CHIS.,"CHICOMUSELO, CHIS.",2,1,3,0,0,0,
22-jun-13,TAMPS.,"REYNOSA, TAMPS.",2,1,3,0,0,0,
25-jun-13,CHIS.,"CHICOMUSELO, CHIS.",2,1,3,0,0,0,
27-jun-13,B.C.,"ENSENADA, B.C.",1,2,3,0,0,0,
27-jun-13,B.C.,"MEXICALI, B.C.",0,3,3,0,0,0,
27-jun-13,COAH.,"SAN BUENAVENTURA, COAH.",1,2,3,0,0,0,
27-jun-13,S.L.P.,"SAN LUIS POTOSI, S.L.P.",0,3,3,0,0,0,
28-jun-13,NAY.,"RUIZ, NAY.",3,0,3,0,0,0,
29-jun-13,JAL.,"AUTLAN DE NAVARRO, JAL.",2,1,3,0,0,0,
29-jun-13,B.C.S.,"LA PAZ, B.C.S.",1,2,3,0,0,0,
02-jul-13,CHIS.,"TONALÁ, CHIS.",2,1,3,0,0,16,
02-jul-13,TAMPS.,"VICTORIA, TAMPS.",0,3,3,0,0,0,
03-jul-13,PUE.,"TEHUACAN, PUE.",1,2,3,0,0,0,
03-jul-13,NAY.,"IXTLAN DEL RIO, NAY.",2,1,3,0,0,0,
05-jul-13,PUE.,"PUE., PUE.",3,0,3,56,2,2486,
05-jul-13,PUE.,"XICOTEPEC, PUE.",2,1,3,0,0,0,
05-jul-13,CHIS.,"CHICOMUSELO, CHIS.",1,2,3,0,0,0,
05-jul-13,CHIS.,"TONALÁ, CHIS.",2,1,3,1,0,41,
05-jul-13,CHIS.,"CINTALAPA, CHIS.",1,2,3,1,0,115,
06-jul-13,MOR.,"CUERNAVACA, MOR.",1,2,3,0,0,55,
06-jul-13,NAY.,"HUAJICORI, NAY.",2,1,3,0,0,0,
08-jul-13,MOR.,"CUERNAVACA, MOR.",2,1,3,0,4,0,
08-jul-13,B.C.,"TIJUANA, B.C.",1,2,3,0,0,0,
08-jul-13,COAH.,"TORREÓN, COAH.",2,1,3,0,0,0,
09-jul-13,B.C.,"TIJUANA, B.C.",1,2,3,0,0,0,
10-jul-13,TAB.,"BALANCAN, TAB.",1,2,3,0,0,0,
10-jul-13,PUE.,"PUE., PUE.",1,2,3,0,3,521,
10-jul-13,B.C.,"TIJUANA, B.C.",2,1,3,0,0,0,
11-jul-13,MEX.,"NAUCALPAN DE JUAREZ, MEX.",0,3,3,0,0,150,
11-jul-13,COAH.,"SALTILLO, COAH.",1,2,3,0,0,0,
12-jul-13,PUE.,"PUE., PUE.",3,0,3,0,3,766,
14-jul-13,JAL.,"CIHUATLAN, JAL.",1,2,3,0,0,5,
18-jul-13,CHIS.,"ESCUINTLA, CHIS.",2,1,3,2,0,0,
18-jul-13,B.C.,"TIJUANA, B.C.",1,2,3,0,0,0,
18-jul-13,PUE.,"TECAMACHALCO, PUE.",3,0,3,0,0,0,
18-jul-13,PUE.,"HUITZILAN DE SERDAN, PUE.",1,2,3,0,0,0,
18-jul-13,NAY.,"AHUACATLAN, NAY.",0,3,3,0,0,0,
18-jul-13,TAMPS.,"NUEVO LAREDO, TAMPS.",0,3,3,0,0,131,
19-jul-13,TAMPS.,"REYNOSA, TAMPS.",2,1,3,1,0,60,
20-jul-13,B.C.,"TIJUANA, B.C.",0,3,3,0,0,0,
20-jul-13,B.C.,"TECATE, B.C.",0,3,3,0,0,0,
21-jul-13,PUE.,"SAN MARTIN TEXMELUCAN, PUE.",3,0,3,0,2,23,
22-jul-13,VER.,"COATZACOALCOS, VER.",3,0,3,0,0,0,
22-jul-13,MOR.,"PUENTE DE IXTLA, MOR.",3,0,3,0,0,148,
22-jul-13,CHIS.,"TUXTLA GUTIÉRREZ, CHIS.",3,0,3,1,0,52,
23-jul-13,N.L.,"GRAL. ESCOBEDO, N.L.",2,1,3,4,0,90,
23-jul-13,NAY.,"TECUALA, NAY.",3,0,3,0,0,0,
23-jul-13,B.C.,"ENSENADA, B.C.",0,3,3,0,0,0,
23-jul-13,MOR.,"PUENTE DE IXTLA, MOR.",3,0,3,0,2,0,
24-jul-13,PUE.,"PUE., PUE.",2,1,3,1,0,270,
24-jul-13,NAY.,"TECUALA, NAY.",0,3,3,1,0,0,
25-jul-13,B.C.,"TIJUANA, B.C.",0,3,3,0,0,0,
25-jul-13,NAY.,"COMPOSTELA, NAY.",2,1,3,0,0,0,
26-jul-13,PUE.,"PUE., PUE.",3,0,3,0,0,75,
26-jul-13,B.C.,"TIJUANA, B.C.",1,2,3,0,0,0,
27-jul-13,PUE.,"VENUSTIANO CARRANZA, PUE.",2,1,3,0,0,0,
30-jul-13,MOR.,"CUERNAVACA, MOR.",2,1,3,0,0,25,
30-jul-13,SIN.,"COSALA, SIN.",2,1,3,0,0,0,
31-jul-13,MOR.,"PUENTE DE IXTLA, MOR.",2,1,3,0,0,0,
31-jul-13,CHIS.,"TUXTLA GUTIÉRREZ, CHIS.",3,0,3,2,1,514,
01-ago-13,N.L.,"GUADALUPE, N.L.",1,2,3,0,0,198,
02-ago-13,NAY.,"COMPOSTELA, NAY.",1,2,3,0,0,0,
02-ago-13,N.L.,"GUADALUPE, N.L.",2,1,3,0,0,402,
03-ago-13,B.C.,"TIJUANA, B.C.",2,1,3,0,0,0,
03-ago-13,N.L.,"GUADALUPE, N.L.",1,2,3,0,0,198,
03-ago-13,PUE.,"SAN MARTIN TEXMELUCAN, PUE.",1,2,3,0,0,212,
05-ago-13,SIN.,"ELOTA, SIN.",2,1,3,0,0,0,
05-ago-13,B.C.,"MEXICALI, B.C.",0,3,3,0,0,0,
06-ago-13,PUE.,"ATLIXCO, PUE.",1,2,3,8,8,597,
06-ago-13,HGO.,"HUEJUTLA DE REYES, HGO.",2,1,3,0,0,0,
07-ago-13,CHIH.,"ASCENSIÓN, CHIH.",2,1,3,0,0,0,
08-ago-13,N.L.,"SAN NICOLAS DE LOS GARZA, N.L.",3,0,3,9,0,43,
08-ago-13,COAH.,"TORREÓN, COAH.",3,0,3,0,0,0,
09-ago-13,JAL.,"ZAPOPAN, JAL.",3,0,3,0,0,0,
09-ago-13,SIN.,"CULIACAN, SIN.",1,2,3,0,4,0,
09-ago-13,MOR.,"PUENTE DE IXTLA, MOR.",3,0,3,0,2,0,
10-ago-13,N.L.,"SAN NICOLAS DE LOS GARZA, N.L.",1,2,3,6,0,395,
10-ago-13,N.L.,"SANTA CATARINA, N.L.",2,1,3,3,0,128,
10-ago-13,TAMPS.,"REYNOSA, TAMPS.",2,1,3,0,0,0,
11-ago-13,PUE.,"ATLIXCO, PUE.",2,1,3,4,0,650,
12-ago-13,MOR.,"CUAUTLA, MOR.",2,1,3,0,0,0,
13-ago-13,HGO.,"HUEJUTLA DE REYES, HGO.",3,0,3,0,0,0,
13-ago-13,GRO.,"CHILPANCINGO DE LOS BRAVO, GRO.",1,2,3,0,0,0,
13-ago-13,N.L.,"SANTA CATARINA, N.L.",3,0,3,0,0,0,
15-ago-13,B.C.,"MEXICALI, B.C.",2,1,3,0,0,0,
16-ago-13,HGO.,"IXMIQUILPAN, HGO.",3,0,3,0,0,0,
16-ago-13,MOR.,"CUAUTLA, MOR.",2,1,3,0,0,0,
17-ago-13,B.C.,"TIJUANA, B.C.",2,1,3,0,0,0,
17-ago-13,QRO.,"TEQUISQUIAPAN, QRO.",2,1,3,0,0,0,
18-ago-13,B.C.,"TECATE, B.C.",1,2,3,0,0,0,
19-ago-13,B.C.,"MEXICALI, B.C.",3,0,3,0,0,0,
19-ago-13,PUE.,"ZACATLAN, PUE.",1,2,3,2,0,113,
19-ago-13,TAMPS.,"VICTORIA, TAMPS.",1,2,3,1,0,0,
20-ago-13,SIN.,"MAZATLAN, SIN.",3,0,3,0,0,0,
21-ago-13,HGO.,"JACALA DE LEDEZMA, HGO.",3,0,3,0,0,0,
22-ago-13,MOR.,"CUAUTLA, MOR.",3,0,3,0,0,0,
22-ago-13,JAL.,"TLAJOMULCO DE ZUÑIGA, JAL.",3,0,3,0,1,0,
23-ago-13,PUE.,"ATLIXCO, PUE.",1,2,3,0,0,25,
24-ago-13,JAL.,"TLAJOMULCO DE ZUÑIGA, JAL.",1,2,3,20,0,0,
25-ago-13,JAL.,"CUAUTITLAN DE GARCIA BARRAGAN, JAL.",0,3,3,0,0,0,
26-ago-13,B.C.,"TIJUANA, B.C.",2,1,3,0,0,0,
26-ago-13,HGO.,"JACALA DE LEDEZMA, HGO.",2,1,3,0,0,0,
28-ago-13,JAL.,"TEPATITLAN DE MOR., JAL.",3,0,3,0,0,0,
28-ago-13,COAH.,"ACUÑA, COAH.",1,2,3,0,0,0,
29-ago-13,HGO.,"SAN BARTOLO TUTOTEPEC, HGO.",3,0,3,0,0,0,
29-ago-13,SIN.,"MAZATLAN, SIN.",1,2,3,0,4,0,
29-ago-13,N.L.,"CHINA, N.L.",2,1,3,4,0,0,
29-ago-13,GTO.,"SAN FRANCISCO DEL RINCON, GTO.",1,2,3,0,0,0,
31-ago-13,HGO.,"JACALA DE LEDEZMA, HGO.",2,1,3,0,0,0,
03-sep-13,YUC.,"TEKOM, YUC.",1,2,3,0,0,0,
04-sep-13,N.L.,"AGUALEGUAS, N.L.",1,2,3,0,0,1240,
04-sep-13,N.L.,"GRAL. BRAVO, N.L.",0,3,3,6,0,900,
04-sep-13,TAMPS.,"VICTORIA, TAMPS.",0,3,3,0,6,100,
05-sep-13,B.C.,"TECATE, B.C.",1,2,3,0,0,0,
05-sep-13,MOR.,"XOCHITEPEC, MOR.",3,0,3,0,1,0,
06-sep-13,N.L.,"GRAL. BRAVO, N.L.",0,3,3,0,0,202,
07-sep-13,MOR.,"XOCHITEPEC, MOR.",2,1,3,1,2,0,
07-sep-13,B.C.,"ENSENADA, B.C.",2,1,3,0,0,0,
08-sep-13,B.C.,"TIJUANA, B.C.",1,2,3,0,0,0,
09-sep-13,N.L.,"DR. COSS, N.L.",0,3,3,0,0,0,
10-sep-13,B.C.,"ENSENADA, B.C.",1,2,3,0,0,0,
10-sep-13,B.C.,"MEXICALI, B.C.",2,1,3,0,0,0,
10-sep-13,PUE.,"ATLIXCO, PUE.",2,1,3,0,0,176,
12-sep-13,CHIH.,"GALEANA, CHIH.",3,0,3,0,0,65,
12-sep-13,MOR.,"XOCHITEPEC, MOR.",3,0,3,1,0,99,
12-sep-13,B.C.,"TIJUANA, B.C.",2,1,3,0,0,0,
13-sep-13,SON.,"SAN LUIS RIO COLORADO, SON.",0,3,3,6,0,0,
14-sep-13,MOR.,"XOCHITEPEC, MOR.",2,1,3,1,2,0,
14-sep-13,B.C.,"MEXICALI, B.C.",3,0,3,0,0,0,
20-sep-13,SON.,"SAN LUIS RIO COLORADO, SON.",1,2,3,0,1,0,
24-sep-13,PUE.,"ATLIXCO, PUE.",2,1,3,0,2,35,
25-sep-13,YUC.,"TIXKOKOB, YUC.",3,0,3,0,0,0,
25-sep-13,B.C.,"TIJUANA, B.C.",2,1,3,0,0,0,
26-sep-13,MOR.,"XOCHITEPEC, MOR.",3,0,3,0,0,65,
26-sep-13,ZAC.,"TLALTENANGO DE SANCHEZ ROMAN, ZAC.",1,2,3,0,0,0,
28-sep-13,ZAC.,"GUADALUPE, ZAC.",3,0,3,0,0,7,
02-oct-13,N.L.,"CADEREYTA JIMENEZ, N.L.",2,1,3,1,0,0,
02-oct-13,B.C.,"TIJUANA, B.C.",3,0,3,0,0,0,
02-oct-13,ZAC.,"ZAC., ZAC.",3,0,3,4,2,449,
03-oct-13,N.L.,"CADEREYTA JIMENEZ, N.L.",3,0,3,0,0,50,
04-oct-13,NAY.,"TEPIC, NAY.",3,0,3,0,0,0,
04-oct-13,SIN.,"ROSARIO, SIN.",2,1,3,0,3,0,
07-oct-13,N.L.,"BUSTAMANTE, N.L.",1,2,3,0,0,50,
07-oct-13,COAH.,"SALTILLO, COAH.",3,0,3,0,0,100,
07-oct-13,COAH.,"MÚZQUIZ, COAH.",1,2,3,0,0,0,
08-oct-13,AGS.,"AGS., AGS.",3,0,3,0,0,44,
08-oct-13,SON.,"HERMOSILLO, SON.",1,2,3,7,0,17,
08-oct-13,COAH.,"MÚZQUIZ, COAH.",3,0,3,10,0,50,
08-oct-13,COAH.,"NUEVA ROSITA, COAH.",1,2,3,0,0,0,
08-oct-13,N.L.,"PESQUERIA, N.L.",1,2,3,2,0,50,
09-oct-13,CHIS.,"TAPACHULA, CHIS.",3,0,3,0,0,95,
09-oct-13,ZAC.,"GUADALUPE, ZAC.",3,0,3,3,0,270,
09-oct-13,ZAC.,"TLALTENANGO DE SANCHEZ ROMAN, ZAC.",2,1,3,0,0,184,
10-oct-13,OAX.,"CIUDAD IXTEPEC, OAX.",0,3,3,0,0,0,
11-oct-13,ZAC.,"GUADALUPE, ZAC.",3,0,3,0,0,180,
11-oct-13,OAX.,"SANTA MARIA MIXTEQUILLA, OAX.",0,3,3,0,0,0,
12-oct-13,SON.,"HERMOSILLO, SON.",2,1,3,0,0,40,
14-oct-13,COAH.,"MONCLOVA, COAH.",2,1,3,4,0,155,
14-oct-13,ZAC.,"TLALTENANGO DE SANCHEZ ROMAN, ZAC.",2,1,3,0,0,27,
14-oct-13,ZAC.,"JEREZ, ZAC.",3,0,3,0,0,30,
15-oct-13,COAH.,"NUEVA ROSITA, COAH.",3,0,3,0,0,233,
16-oct-13,SON.,"HERMOSILLO, SON.",0,3,3,1,0,780,
16-oct-13,B.C.,"TIJUANA, B.C.",0,3,3,0,0,0,
16-oct-13,ZAC.,"ZAC., ZAC.",2,1,3,0,0,345,
17-oct-13,VER.,"XALAPA, VER.",3,0,3,0,0,25,
17-oct-13,B.C.,"TIJUANA, B.C.",2,1,3,0,0,0,
18-oct-13,B.C.,"MEXICALI, B.C.",3,0,3,0,0,0,
19-oct-13,HGO.,"TULANCINGO DE BRAVO, HGO.",1,2,3,0,0,500,
22-oct-13,AGS.,"AGS., AGS.",2,1,3,6,0,80,
24-oct-13,HGO.,"TULANCINGO DE BRAVO, HGO.",0,3,3,0,0,0,
24-oct-13,N.L.,"GALEANA, N.L.",2,1,3,5,0,0,
26-oct-13,COAH.,"ACUÑA, COAH.",1,2,3,0,0,89,
28-oct-13,N.L.,"LINARES, N.L.",3,0,3,0,0,0,
30-oct-13,COAH.,"NUEVA ROSITA, COAH.",1,2,3,0,0,0,
01-nov-13,B.C.,"TIJUANA, B.C.",1,2,3,0,0,0,
02-nov-13,B.C.,"MEXICALI, B.C.",3,0,3,0,0,0,
04-nov-13,JAL.,"ACATLAN DE JUAREZ, JAL.",2,1,3,0,0,0,
05-nov-13,B.C.,"MEXICALI, B.C.",2,1,3,0,0,0,
12-nov-13,HGO.,"TEPEJI DEL RIO DE OCAMPO, HGO.",2,1,3,0,0,0,
12-nov-13,HGO.,"PACHUCA DE SOTO, HGO.",1,2,3,0,0,220,
14-nov-13,HGO.,"PACHUCA DE SOTO, HGO.",3,0,3,0,0,0,
15-nov-13,PUE.,"PUE., PUE.",2,1,3,8,0,308,
18-nov-13,HGO.,"PACHUCA DE SOTO, HGO.",3,0,3,0,0,0,
19-nov-13,PUE.,"PUE., PUE.",3,0,3,0,0,74,
20-nov-13,N.L.,"APODACA, N.L.",3,0,3,8,0,100,
21-nov-13,N.L.,"SAN PEDRO GARZA GARCIA, N.L.",1,2,3,3,0,213,
22-nov-13,SON.,"HERMOSILLO, SON.",1,2,3,0,0,0,
22-nov-13,SON.,"HUATABAMPO, SON.",3,0,3,0,0,76,
25-nov-13,D.F.,"CUAJIMALPA DE MOR., D.F.",2,1,3,0,0,0,
25-nov-13,SON.,"SANTA ANA, SON.",3,0,3,0,0,0,
25-nov-13,SON.,"HERMOSILLO, SON.",2,1,3,1,0,246,
25-nov-13,COAH.,"PIEDRAS NEGRAS, COAH.",0,3,3,0,0,232,
26-nov-13,COL.,"MANZANILLO, COL.",3,0,3,0,2,39,
28-nov-13,SON.,"HERMOSILLO, SON.",3,0,3,17,0,160,
29-nov-13,COAH.,"PIEDRAS NEGRAS, COAH.",3,0,3,0,0,188,
02-dic-13,SON.,"CAJEME, SON.",1,2,3,0,1,80,
02-dic-13,SON.,"HUATABAMPO, SON.",2,1,3,1,0,0,
03-dic-13,SON.,"ALTAR, SON.",1,2,3,0,0,0,
03-dic-13,COAH.,"PIEDRAS NEGRAS, COAH.",2,1,3,1,0,41,
04-dic-13,SON.,"GENERAL PLUTARCO ELIAS CALLES, SON.",3,0,3,3,0,0,
05-dic-13,SON.,"NAVOJOA, SON.",2,1,3,1,0,0,
05-dic-13,CHIH.,"NUEVO CASAS GRANDES, CHIH.",3,0,3,0,0,0,
06-dic-13,SON.,"BANAMICHI, SON.",0,3,3,0,0,0,
06-dic-13,SON.,"ETCHOJOA, SON.",1,2,3,0,0,0,
07-dic-13,SON.,"EMPALME, SON.",2,1,3,0,0,20,
07-dic-13,SON.,"ETCHOJOA, SON.",3,0,3,2,0,40,
08-dic-13,N.L.,"SANTA CATARINA, N.L.",3,0,3,0,0,0,
09-dic-13,SON.,"HERMOSILLO, SON.",2,1,3,7,1,0,
10-dic-13,SON.,"NAVOJOA, SON.",1,2,3,1,0,10,
10-dic-13,COAH.,"MONCLOVA, COAH.",1,2,3,0,0,223,
11-dic-13,COAH.,"MONCLOVA, COAH.",2,1,3,0,0,439,
11-dic-13,COAH.,"SALTILLO, COAH.",3,0,3,3,0,403,
14-dic-13,COAH.,"ACUÑA, COAH.",0,3,3,0,0,0,
18-dic-13,CHIH.,"OJINAGA, CHIH.",0,3,3,0,0,0,
19-dic-13,CHIH.,"OJINAGA, CHIH.",0,3,3,0,0,0,
20-dic-13,TAMPS.,"NUEVO LAREDO, TAMPS.",1,2,3,10,0,495,
22-dic-13,TAMPS.,"GONZALEZ, TAMPS.",3,0,3,0,0,35,
29-dic-13,TAMPS.,"GONZALEZ, TAMPS.",3,0,3,8,0,222,
01-ene-14,TAMPS.,"MATAMOROS, TAMPS.",1,2,3,0,0,32,
03-ene-14,PUE.,"PALMAR DE BRAVO, PUE.",3,0,3,0,0,0,
03-ene-14,TAMPS.,"NUEVO LAREDO, TAMPS.",2,1,3,5,0,1933,
10-ene-14,CHIH.,"CHIH., CHIH.",0,3,3,0,0,0,
16-ene-14,Q. ROO,"BENITO JUAREZ, Q. ROO",3,0,3,0,0,259,
17-ene-14,TAMPS.,"NUEVO LAREDO, TAMPS.",1,2,3,7,0,1571,
22-ene-14,COAH.,"SALTILLO, COAH.",2,1,3,0,0,52,
22-ene-14,PUE.,"TEHUACAN, PUE.",3,0,3,0,4,0,
24-ene-14,S.L.P.,"SAN LUIS POTOSI, S.L.P.",3,0,3,0,0,0,
24-ene-14,COAH.,"SALTILLO, COAH.",1,2,3,1,1,401,
25-ene-14,PUE.,"TEHUACAN, PUE.",2,1,3,0,0,45,
27-ene-14,S.L.P.,"SAN LUIS POTOSI, S.L.P.",3,0,3,0,0,0,
29-ene-14,COAH.,"SALTILLO, COAH.",3,0,3,0,0,79,
30-ene-14,COAH.,"SALTILLO, COAH.",3,0,3,0,0,80,
04-feb-14,VER.,"BOCA DEL RIO, VER.",2,1,3,0,1,0,
04-feb-14,PUE.,"TEHUACAN, PUE.",0,3,3,0,0,0,
10-feb-14,COAH.,"MÚZQUIZ, COAH.",3,0,3,2,0,14,
11-feb-14,MICH.,"LAZARO CARDENAS, MICH.",0,3,3,14,0,73,
11-feb-14,VER.,"BOCA DEL RIO, VER.",1,2,3,0,0,0,
12-feb-14,VER.,"BOCA DEL RIO, VER.",1,2,3,0,0,0,
12-feb-14,COAH.,"SALTILLO, COAH.",3,0,3,0,0,104,
12-feb-14,COAH.,"PIEDRAS NEGRAS, COAH.",2,1,3,0,0,0,
14-feb-14,COAH.,"SALTILLO, COAH.",2,1,3,0,0,49,
17-feb-14,MICH.,"LAZARO CARDENAS, MICH.",1,2,3,1,0,0,
19-feb-14,VER.,"MARTINEZ DE LA TORRE, VER.",3,0,3,0,0,0,
28-feb-14,HGO.,"SAN BARTOLO TUTOTEPEC, HGO.",2,1,3,0,0,0,
28-feb-14,COAH.,"PIEDRAS NEGRAS, COAH.",0,3,3,0,0,124,
04-mar-14,SON.,"CAJEME, SON.",3,0,3,0,0,4,
04-mar-14,TAMPS.,"EL MANTE, TAMPS.",2,1,3,1,0,100,
13-mar-14,VER.,"SAN RAFAEL, VER.",2,1,3,0,0,0,
13-mar-14,COAH.,"ACUÑA, COAH.",0,3,3,0,0,0,
13-mar-14,MICH.,"LAZARO CARDENAS, MICH.",3,0,3,2,0,0,
14-mar-14,CHIH.,"SAUCILLO, CHIH.",3,0,3,0,0,0,
14-mar-14,SON.,"CAJEME, SON.",2,1,3,1,0,0,
15-mar-14,TAMPS.,"MATAMOROS, TAMPS.",1,2,3,0,0,0,
15-mar-14,B.C.,"TIJUANA, B.C.",1,2,3,0,0,0,
19-mar-14,N.L.,"SAN NICOLAS DE LOS GARZA, N.L.",2,1,3,0,0,112,
20-mar-14,SON.,"HERMOSILLO, SON.",3,0,3,1,0,0,
21-mar-14,CHIH.,"HGO. DEL PARRAL, CHIH.",2,1,3,1,0,0,
21-mar-14,JAL.,"GUADALAJARA, JAL.",2,1,3,1,0,0,
24-mar-14,N.L.,"SAN NICOLAS DE LOS GARZA, N.L.",2,1,3,12,0,1365,
25-mar-14,MEX.,"CHICOLOAPAN, MEX.",2,1,3,0,0,0,
26-mar-14,B.C.,"MEXICALI, B.C.",2,1,3,0,0,0,
28-mar-14,ZAC.,"SOMBRERETE, ZAC.",2,1,3,0,0,0,
28-mar-14,JAL.,"GUADALAJARA, JAL.",0,3,3,0,0,0,
28-mar-14,VER.,"TANTOYUCA, VER.",2,1,3,0,0,0,
28-mar-14,PUE.,"PUE., PUE.",3,0,3,0,0,0,
29-mar-14,SON.,"HERMOSILLO, SON.",0,3,3,0,0,0,
29-mar-14,CHIS.,"TUXTLA GUTIÉRREZ, CHIS.",1,2,3,3,0,1491,
29-mar-14,MEX.,"ZUMPANGO, MEX.",2,1,3,0,0,0,
31-mar-14,OAX.,"OAX. DE JUAREZ, OAX.",2,1,3,2,0,0,
02-abr-14,B.C.,"MEXICALI, B.C.",0,3,3,0,0,0,
02-abr-14,QRO.,"HUIMILPAN, QRO.",2,1,3,0,0,0,
02-abr-14,QRO.,"SAN JOAQUIN, QRO.",1,2,3,0,3,0,
03-abr-14,N.L.,"GUADALUPE, N.L.",1,2,3,0,1,1050,
03-abr-14,HGO.,"MIXQUIAHUALA DE JUAREZ, HGO.",2,1,3,0,3,0,
03-abr-14,OAX.,"OAX. DE JUAREZ, OAX.",3,0,3,1,0,56,
04-abr-14,OAX.,"SAN JUAN BAUTISTA TUXTEPEC, OAX.",3,0,3,4,0,171,
04-abr-14,CHIH.,"DELICIAS, CHIH.",1,2,3,0,0,0,
05-abr-14,CHIH.,"DELICIAS, CHIH.",3,0,3,0,0,0,
07-abr-14,JAL.,"TLAQUEPAQUE, JAL.",1,2,3,0,0,0,
07-abr-14,AGS.,"AGS., AGS.",3,0,3,4,0,280,
07-abr-14,B.C.,"TIJUANA, B.C.",2,1,3,0,0,0,
08-abr-14,OAX.,"OAX. DE JUAREZ, OAX.",3,0,3,4,0,98,
08-abr-14,AGS.,"AGS., AGS.",2,1,3,1,0,11,
08-abr-14,MEX.,"CUAUTITLAN IZCALLI, MEX.",2,1,3,0,0,0,
08-abr-14,CHIH.,"DELICIAS, CHIH.",3,0,3,0,0,0,
10-abr-14,JAL.,"TLAQUEPAQUE, JAL.",2,1,3,0,0,0,
11-abr-14,OAX.,"MIAHUATLAN DE PORFIRIO DIAZ, OAX.",2,1,3,0,0,48,
12-abr-14,OAX.,"OAX. DE JUAREZ, OAX.",2,1,3,0,0,0,
13-abr-14,B.C.,"MEXICALI, B.C.",3,0,3,0,0,0,
14-abr-14,OAX.,"SANTIAGO PINOTEPA NACIONAL, OAX.",3,0,3,0,0,0,
14-abr-14,SON.,"HERMOSILLO, SON.",3,0,3,28,0,42,
15-abr-14,YUC.,"SOTUTA, YUC.",0,3,3,0,0,0,
17-abr-14,CHIS.,"ACACOYAGUA, CHIS.",2,1,3,0,0,250,
19-abr-14,MEX.,"NAUCALPAN DE JUAREZ, MEX.",1,2,3,0,0,215,
22-abr-14,B.C.,"ENSENADA, B.C.",2,1,3,0,0,0,
23-abr-14,N.L.,"APODACA, N.L.",1,2,3,40,0,316,
23-abr-14,CHIS.,"HUEHUETÁN, CHIS.",2,1,3,0,0,295,
24-abr-14,SIN.,"SALVADOR ALVARADO, SIN.",1,2,3,0,0,0,
25-abr-14,OAX.,"OAX. DE JUAREZ, OAX.",2,1,3,2,0,0,
25-abr-14,SIN.,"SALVADOR ALVARADO, SIN.",3,0,3,0,1,0,
26-abr-14,MEX.,"NAUCALPAN DE JUAREZ, MEX.",2,1,3,1,0,46,
26-abr-14,N.L.,"GRAL. ESCOBEDO, N.L.",3,0,3,4,0,0,
28-abr-14,SIN.,"SALVADOR ALVARADO, SIN.",2,1,3,0,0,0,
29-abr-14,S.L.P.,"CIUDAD VALLES, S.L.P.",1,2,3,0,0,0,
29-abr-14,B.C.,"MEXICALI, B.C.",2,1,3,0,0,0,
29-abr-14,MEX.,"HUEHUETOCA, MEX.",3,0,3,0,0,0,
02-may-14,OAX.,"SANTA MARIA HUATULCO, OAX.",1,2,3,2,0,0,
02-may-14,CHIS.,"SAN CRISTOBAL DE LAS CASAS, CHIS.",1,2,3,0,0,0,
03-may-14,OAX.,"OAX. DE JUAREZ, OAX.",3,0,3,0,0,21,
05-may-14,SIN.,"GUASAVE, SIN.",1,2,3,0,0,0,
05-may-14,MEX.,"NAUCALPAN DE JUAREZ, MEX.",3,0,3,2,0,0,
06-may-14,SIN.,"GUASAVE, SIN.",2,1,3,0,0,0,
07-may-14,OAX.,"OCOTLAN DE MOR., OAX.",2,1,3,2,0,18,
08-may-14,NAY.,"SANTIAGO IXCUINTLA, NAY.",1,2,3,0,0,0,
08-may-14,MEX.,"SAN MATEO ATENCO, MEX.",2,1,3,1,0,0,
09-may-14,CHIS.,"SAN CRISTOBAL DE LAS CASAS, CHIS.",2,1,3,0,0,0,
12-may-14,MEX.,"NAUCALPAN DE JUAREZ, MEX.",3,0,3,1,0,0,
12-may-14,SIN.,"MOCORITO, SIN.",0,3,3,0,0,0,
13-may-14,CHIS.,"SAN CRISTOBAL DE LAS CASAS, CHIS.",2,1,3,0,0,0,
13-may-14,MEX.,"TENANGO DEL VALLE, MEX.",3,0,3,0,0,0,
13-may-14,NAY.,"ACAPONETA, NAY.",0,3,3,0,0,0,
14-may-14,B.C.,"ENSENADA, B.C.",1,2,3,0,0,0,
14-may-14,PUE.,"PUE., PUE.",3,0,3,1,0,17,
16-may-14,JAL.,"GUADALAJARA, JAL.",2,1,3,0,0,10,
16-may-14,PUE.,"PUE., PUE.",0,3,3,0,0,115,
17-may-14,MEX.,"NOPALTEPEC, MEX.",2,1,3,0,5,0,
19-may-14,MEX.,"TIANGUISTENCO, MEX.",2,1,3,0,0,0,
22-may-14,OAX.,"OAX. DE JUAREZ, OAX.",0,3,3,0,0,0,
22-may-14,NAY.,"SANTA MARIA DEL ORO, NAY.",1,2,3,0,0,0,
22-may-14,N.L.,"LINARES, N.L.",3,0,3,2,0,54,
22-may-14,MEX.,"TULTEPEC, MEX.",3,0,3,1,1,13,
23-may-14,N.L.,"GARCIA, N.L.",3,0,3,19,0,2253,
28-may-14,SIN.,"EL FUERTE, SIN.",3,0,3,0,0,0,
28-may-14,SIN.,"CHOIX, SIN.",2,1,3,0,0,0,
30-may-14,SIN.,"BADIRAGUATO, SIN.",1,2,3,0,0,0,
02-jun-14,COL.,"COL., COL.",2,1,3,0,0,0,
03-jun-14,OAX.,"OAX. DE JUAREZ, OAX.",0,3,3,0,0,0,
03-jun-14,YUC.,"KANASIN, YUC.",2,1,3,0,0,0,
04-jun-14,HGO.,"TIZAYUCA, HGO.",1,2,3,0,0,75,
04-jun-14,MEX.,"HUEYPOXTLA, MEX.",3,0,3,0,0,0,
05-jun-14,MEX.,"TEJUPILCO, MEX.",2,1,3,1,0,0,
05-jun-14,B.C.,"TIJUANA, B.C.",2,1,3,0,0,0,
05-jun-14,N.L.,"JUAREZ, N.L.",2,1,3,0,0,0,
07-jun-14,SON.,"CAJEME, SON.",2,1,3,1,0,0,
09-jun-14,OAX.,"OAX. DE JUAREZ, OAX.",0,3,3,0,0,0,
10-jun-14,MEX.,"IXTLAHUACA, MEX.",0,3,3,0,0,0,
11-jun-14,CHIH.,"CHIH., CHIH.",3,0,3,0,0,182,
12-jun-14,COAH.,"FRONTERA, COAH.",3,0,3,0,0,0,
13-jun-14,B.C.,"TIJUANA, B.C.",3,0,3,0,0,0,
13-jun-14,B.C.,"ENSENADA, B.C.",2,1,3,0,0,0,
13-jun-14,MEX.,"SAN FELIPE DEL PROGRESO, MEX.",1,2,3,0,0,0,
14-jun-14,N.L.,"LOS ALDAMAS, N.L.",0,3,3,4,0,42,
14-jun-14,MEX.,"SAN FELIPE DEL PROGRESO, MEX.",2,1,3,0,0,0,
16-jun-14,B.C.S.,"LA PAZ, B.C.S.",2,1,3,0,0,0,
17-jun-14,B.C.S.,"LA PAZ, B.C.S.",0,3,3,0,0,0,
18-jun-14,CHIH.,"CHIH., CHIH.",1,2,3,1,0,205,
18-jun-14,MEX.,"IXTAPALUCA, MEX.",2,1,3,0,0,300,
18-jun-14,MEX.,"COACALCO DE BERRIOZABAL, MEX.",2,1,3,0,0,0,
19-jun-14,MEX.,"COACALCO DE BERRIOZABAL, MEX.",1,2,3,0,0,0,
19-jun-14,COL.,"COL., COL.",3,0,3,0,0,0,
20-jun-14,B.C.S.,"MULEGÉ, B.C.S.",0,3,3,0,0,0,
21-jun-14,B.C.S.,"MULEGÉ, B.C.S.",0,3,3,0,0,0,
21-jun-14,MEX.,"COACALCO DE BERRIOZABAL, MEX.",3,0,3,0,0,0,
22-jun-14,B.C.S.,"MULEGÉ, B.C.S.",0,3,3,0,0,0,
23-jun-14,NAY.,"ACAPONETA, NAY.",2,1,3,0,0,0,
24-jun-14,CHIH.,"CHIH., CHIH.",1,2,3,2,0,182,
25-jun-14,CHIH.,"CHIH., CHIH.",0,3,3,0,0,0,
26-jun-14,COAH.,"MONCLOVA, COAH.",1,2,3,0,0,0,
27-jun-14,HGO.,"TULANCINGO DE BRAVO, HGO.",3,0,3,0,0,0,
27-jun-14,COAH.,"MÚZQUIZ, COAH.",3,0,3,0,0,64,
27-jun-14,CHIH.,"CHIH., CHIH.",3,0,3,1,0,534,
28-jun-14,B.C.,"TIJUANA, B.C.",2,1,3,0,0,0,
28-jun-14,B.C.,"ENSENADA, B.C.",1,2,3,0,0,0,
04-jul-14,SIN.,"NAVOLATO, SIN.",3,0,3,0,5,0,
11-jul-14,SON.,"CAJEME, SON.",1,2,3,0,0,22,
11-jul-14,COAH.,"MÚZQUIZ, COAH.",1,2,3,0,0,0,
12-jul-14,N.L.,"LOS HERRERAS, N.L.",1,2,3,1,0,65,
14-jul-14,COAH.,"MONCLOVA, COAH.",1,2,3,0,0,0,
17-jul-14,COAH.,"MÚZQUIZ, COAH.",1,2,3,0,0,0,
24-jul-14,SON.,"CAJEME, SON.",1,2,3,1,0,0,
25-jul-14,NAY.,"JALA, NAY.",0,3,3,0,0,0,
26-jul-14,B.C.,"TIJUANA, B.C.",3,0,3,0,0,0,
29-jul-14,JAL.,"GUADALAJARA, JAL.",2,1,3,0,0,0,
30-jul-14,YUC.,"YAXKUKUL, YUC.",1,2,3,0,0,0,
30-jul-14,B.C.,"TECATE, B.C.",1,2,3,0,0,0,
02-ago-14,AGS.,"EL LLANO, AGS.",3,0,3,13,0,312,
04-ago-14,B.C.,"TIJUANA, B.C.",0,3,3,0,0,0,
05-ago-14,CHIH.,"JUÁREZ, CHIH.",3,0,3,0,0,0,
11-ago-14,SON.,"HERMOSILLO, SON.",2,1,3,0,0,0,
13-ago-14,B.C.,"TIJUANA, B.C.",1,2,3,0,0,0,
14-ago-14,NAY.,"IXTLAN DEL RIO, NAY.",3,0,3,0,0,0,
15-ago-14,NAY.,"IXTLAN DEL RIO, NAY.",2,1,3,0,0,0,
16-ago-14,CHIH.,"JUÁREZ, CHIH.",2,1,3,0,0,0,
18-ago-14,SIN.,"COSALA, SIN.",1,2,3,0,0,0,
18-ago-14,QRO.,"CORREGIDORA, QRO.",1,2,3,0,0,0,
19-ago-14,SIN.,"ROSARIO, SIN.",2,1,3,0,0,0,
19-ago-14,N.L.,"MONTERREY, N.L.",2,1,3,65,0,2210,
19-ago-14,SON.,"CAJEME, SON.",3,0,3,2,0,0,
20-ago-14,SIN.,"ROSARIO, SIN.",2,1,3,0,1,0,
20-ago-14,N.L.,"MONTERREY, N.L.",3,0,3,116,0,2556,
20-ago-14,B.C.S.,"MULEGÉ, B.C.S.",2,1,3,0,0,0,
21-ago-14,PUE.,"PUE., PUE.",2,1,3,2,0,12,
21-ago-14,QRO.,"CORREGIDORA, QRO.",3,0,3,0,0,0,
25-ago-14,B.C.,"TIJUANA, B.C.",2,1,3,0,0,0,
26-ago-14,CHIS.,"IXTACOMITÁN, CHIS.",2,1,3,0,0,0,
26-ago-14,B.C.,"TIJUANA, B.C.",2,1,3,0,0,0,
26-ago-14,TAB.,"TENOSIQUE, TAB.",0,3,3,0,0,0,
26-ago-14,AGS.,"JESÚS MARÍA, AGS.",1,2,3,2,0,0,
27-ago-14,CHIH.,"JUÁREZ, CHIH.",2,1,3,0,0,0,
28-ago-14,B.C.,"TIJUANA, B.C.",1,2,3,0,0,0,
28-ago-14,PUE.,"PUE., PUE.",3,0,3,2,0,198,
28-ago-14,MICH.,"TACAMBARO, MICH.",2,1,3,2,0,0,
29-ago-14,COAH.,"PIEDRAS NEGRAS, COAH.",2,1,3,0,0,0,
29-ago-14,B.C.,"ENSENADA, B.C.",0,3,3,0,0,0,
29-ago-14,MICH.,"LAZARO CARDENAS, MICH.",3,0,3,3,0,210,
30-ago-14,MICH.,"APATZINGAN, MICH.",3,0,3,0,0,56,
30-ago-14,MICH.,"TEPALCATEPEC, MICH.",1,2,3,0,0,34,
02-sep-14,PUE.,"AMOZOC, PUE.",3,0,3,2,0,112,
03-sep-14,MICH.,"BUENAVISTA, MICH.",1,2,3,2,0,82,
04-sep-14,MICH.,"BUENAVISTA, MICH.",0,3,3,0,0,0,
04-sep-14,MICH.,"SAHUAYO, MICH.",2,1,3,0,0,51,
05-sep-14,NAY.,"IXTLAN DEL RIO, NAY.",2,1,3,0,0,0,
06-sep-14,MICH.,"ZITACUARO, MICH.",3,0,3,0,0,0,
08-sep-14,MICH.,"LAZARO CARDENAS, MICH.",3,0,3,0,0,0,
09-sep-14,COAH.,"SALTILLO, COAH.",3,0,3,9,0,37,
19-sep-14,MICH.,"VISTA HERMOSA, MICH.",2,1,3,2,0,0,
20-sep-14,MICH.,"COALCOMAN DE VAZQUEZ PALLARES, MICH.",3,0,3,2,0,0,
21-sep-14,MICH.,"VISTA HERMOSA, MICH.",1,2,3,0,0,0,
24-sep-14,MICH.,"VISTA HERMOSA, MICH.",1,2,3,0,0,0,
28-sep-14,MICH.,"LAZARO CARDENAS, MICH.",3,0,3,2,0,32,
29-sep-14,MICH.,"GABRIEL ZAMORA, MICH.",2,1,3,0,0,23,
30-sep-14,MICH.,"ZAMORA, MICH.",3,0,3,0,0,320,
01-oct-14,N.L.,"MONTERREY, N.L.",3,0,3,19,0,60,
03-oct-14,COL.,"TECOMÁN, COL.",2,1,3,0,0,0,
04-oct-14,MICH.,"ZINAPECUARO, MICH.",3,0,3,2,0,0,
06-oct-14,SIN.,"ESCUINAPA, SIN.",3,0,3,0,1,0,
06-oct-14,MOR.,"CUERNAVACA, MOR.",2,1,3,2,0,0,
07-oct-14,SIN.,"ELOTA, SIN.",1,2,3,0,4,0,
07-oct-14,MICH.,"HUETAMO, MICH.",2,1,3,2,0,0,
07-oct-14,COL.,"COL., COL.",1,2,3,2,0,290,
07-oct-14,SON.,"IMURIS, SON.",3,0,3,2,0,0,
08-oct-14,B.C.S.,"COMONDÚ, B.C.S.",0,3,3,0,0,0,
08-oct-14,COAH.,"SALTILLO, COAH.",3,0,3,0,0,408,
08-oct-14,MICH.,"ZINAPECUARO, MICH.",3,0,3,1,0,128,
08-oct-14,MICH.,"TIQUICHEO DE NICOLAS ROMERO, MICH.",2,1,3,3,0,0,
10-oct-14,MICH.,"PARACHO, MICH.",2,1,3,0,0,1675,
10-oct-14,MOR.,"CUERNAVACA, MOR.",2,1,3,0,2,232,
11-oct-14,SON.,"NAVOJOA, SON.",3,0,3,0,0,460,
11-oct-14,SON.,"ALAMOS, SON.",3,0,3,1,0,0,
11-oct-14,MICH.,"PARACHO, MICH.",1,2,3,0,0,2694,
11-oct-14,TAMPS.,"MATAMOROS, TAMPS.",0,3,3,0,0,0,
11-oct-14,SON.,"CABORCA, SON.",0,3,3,0,0,0,
13-oct-14,SON.,"ALAMOS, SON.",2,1,3,1,0,0,
14-oct-14,N.L.,"GUADALUPE, N.L.",1,2,3,0,0,1189,
14-oct-14,MICH.,"CHURUMUCO, MICH.",2,1,3,0,0,0,
14-oct-14,SON.,"GUAYMAS, SON.",0,3,3,0,0,143,
14-oct-14,SON.,"NAVOJOA, SON.",3,0,3,2,0,0,
14-oct-14,JAL.,"ZAPOPAN, JAL.",2,1,3,0,0,0,
15-oct-14,SON.,"NAVOJOA, SON.",2,1,3,0,0,0,
15-oct-14,SON.,"ALAMOS, SON.",2,1,3,0,0,0,
15-oct-14,MICH.,"PARACHO, MICH.",1,2,3,0,0,1754,
16-oct-14,MICH.,"PATZCUARO, MICH.",0,3,3,0,0,0,
16-oct-14,SON.,"HERMOSILLO, SON.",3,0,3,1,0,40,
17-oct-14,CHIS.,"PICHUCALCO, CHIS.",1,2,3,0,0,0,
18-oct-14,CHIS.,"OCOSINGO, CHIS.",2,1,3,1,0,0,
19-oct-14,MICH.,"HGO., MICH.",2,1,3,1,0,0,
19-oct-14,CHIS.,"OCOZOCOAUTLA DE ESPINOSA, CHIS.",0,3,3,0,0,68,
20-oct-14,MICH.,"HGO., MICH.",3,0,3,2,0,0,
20-oct-14,SON.,"GENERAL PLUTARCO ELIAS CALLES, SON.",1,2,3,0,0,0,
20-oct-14,SON.,"CABORCA, SON.",2,1,3,1,0,70,
21-oct-14,JAL.,"TLAQUEPAQUE, JAL.",2,1,3,0,0,0,
21-oct-14,COAH.,"TORREÓN, COAH.",3,0,3,0,0,0,
21-oct-14,SIN.,"CONCORDIA, SIN.",2,1,3,0,0,0,
21-oct-14,CHIS.,"TONALÁ, CHIS.",2,1,3,1,0,11,
21-oct-14,CHIS.,"SAN CRISTOBAL DE LAS CASAS, CHIS.",0,3,3,0,0,0,
21-oct-14,MOR.,"CUERNAVACA, MOR.",1,2,3,0,0,0,
22-oct-14,MOR.,"CUERNAVACA, MOR.",3,0,3,0,1,43,
22-oct-14,AGS.,"AGS., AGS.",0,3,3,0,0,28,
22-oct-14,CHIS.,"PICHUCALCO, CHIS.",2,1,3,0,0,74,
22-oct-14,CHIS.,"TONALÁ, CHIS.",0,3,3,0,0,95,
23-oct-14,MICH.,"ZAMORA, MICH.",2,1,3,1,0,3992,
23-oct-14,CHIS.,"OCOSINGO, CHIS.",2,1,3,0,0,55,
23-oct-14,CHIS.,"SAN CRISTOBAL DE LAS CASAS, CHIS.",0,3,3,0,0,40,
23-oct-14,CHIS.,"TAPACHULA, CHIS.",3,0,3,0,0,44,
23-oct-14,SON.,"CABORCA, SON.",2,1,3,0,0,0,
23-oct-14,SON.,"SAN LUIS RIO COLORADO, SON.",3,0,3,0,0,0,
23-oct-14,AGS.,"AGS., AGS.",2,1,3,0,0,10,
24-oct-14,CHIS.,"PALENQUE, CHIS.",1,2,3,0,0,0,
24-oct-14,AGS.,"AGS., AGS.",2,1,3,0,0,17,
24-oct-14,CHIS.,"PICHUCALCO, CHIS.",0,3,3,0,0,89,
24-oct-14,SIN.,"CONCORDIA, SIN.",1,2,3,0,3,0,
24-oct-14,B.C.,"TIJUANA, B.C.",1,2,3,0,0,0,
24-oct-14,CHIS.,"TONALÁ, CHIS.",1,2,3,1,0,280,
24-oct-14,CHIS.,"OCOZOCOAUTLA DE ESPINOSA, CHIS.",2,1,3,0,0,68,
25-oct-14,MICH.,"ZAMORA, MICH.",2,1,3,0,0,103,
25-oct-14,CHIS.,"SAN CRISTOBAL DE LAS CASAS, CHIS.",3,0,3,0,0,0,
25-oct-14,TLAX.,"ZACATELCO, TLAX.",2,1,3,1,0,0,
27-oct-14,CHIS.,"SAN CRISTOBAL DE LAS CASAS, CHIS.",2,1,3,0,0,0,
27-oct-14,SON.,"NOGALES, SON.",2,1,3,4,0,45,
28-oct-14,MICH.,"LAZARO CARDENAS, MICH.",3,0,3,3,0,826,
29-oct-14,B.C.,"ENSENADA, B.C.",0,3,3,0,0,0,
30-oct-14,NAY.,"AHUACATLAN, NAY.",1,2,3,0,0,0,
30-oct-14,TAMPS.,"PADILLA, TAMPS.",0,3,3,0,0,2700,
30-oct-14,GRO.,"BENITO JUAREZ, GRO.",0,3,3,0,0,0,
30-oct-14,SON.,"AGUA PRIETA, SON.",3,0,3,1,0,0,
31-oct-14,COAH.,"TORREÓN, COAH.",0,3,3,0,0,0,
31-oct-14,SON.,"HERMOSILLO, SON.",2,1,3,3,0,60,
01-nov-14,SON.,"CANANEA, SON.",1,2,3,0,0,0,
02-nov-14,MOR.,"CUERNAVACA, MOR.",1,2,3,0,0,240,
03-nov-14,AGS.,"AGS., AGS.",3,0,3,3,0,0,
03-nov-14,GRO.,"TELOLOAPAN, GRO.",3,0,3,0,0,0,
04-nov-14,CHIS.,"TAPACHULA, CHIS.",2,1,3,1,0,730,
04-nov-14,CHIS.,"TONALÁ, CHIS.",3,0,3,5,0,1737,
05-nov-14,CHIS.,"TAPACHULA, CHIS.",2,1,3,0,2,711,
05-nov-14,JAL.,"TOMATLAN, JAL.",2,1,3,0,0,0,
05-nov-14,CHIS.,"SAN CRISTOBAL DE LAS CASAS, CHIS.",2,1,3,2,0,0,
05-nov-14,CHIS.,"OCOZOCOAUTLA DE ESPINOSA, CHIS.",2,1,3,0,0,306,
07-nov-14,CHIS.,"PICHUCALCO, CHIS.",3,0,3,3,0,403,
08-nov-14,TLAX.,"CALPULALPAN, TLAX.",2,1,3,0,0,0,
09-nov-14,CHIS.,"TONALÁ, CHIS.",3,0,3,1,0,597,
10-nov-14,CHIS.,"TAPACHULA, CHIS.",3,0,3,0,0,235,
10-nov-14,CHIS.,"PALENQUE, CHIS.",3,0,3,0,0,0,
11-nov-14,CHIS.,"OCOZOCOAUTLA DE ESPINOSA, CHIS.",1,2,3,3,0,80,
11-nov-14,B.C.,"TIJUANA, B.C.",2,1,3,0,0,0,
12-nov-14,CHIS.,"SAN CRISTOBAL DE LAS CASAS, CHIS.",0,3,3,0,0,0,
13-nov-14,QRO.,"AMEALCO DE BONFIL, QRO.",2,1,3,0,0,0,
15-nov-14,TLAX.,"HUAMANTLA, TLAX.",0,3,3,0,0,0,
17-nov-14,GRO.,"TELOLOAPAN, GRO.",0,3,3,0,0,0,
19-nov-14,JAL.,"GUADALAJARA, JAL.",0,3,3,0,0,0,
25-nov-14,PUE.,"ATLIXCO, PUE.",2,1,3,3,0,134,
26-nov-14,HGO.,"HUEJUTLA DE REYES, HGO.",3,0,3,0,0,0,
27-nov-14,GRO.,"TAXCO DE ALARCON, GRO.",2,1,3,2,0,0,
29-nov-14,HGO.,"HUASCA DE OCAMPO, HGO.",2,1,3,0,0,0,
06-dic-14,B.C.S.,"LOS CABOS, B.C.S.",1,2,3,0,0,0,
16-dic-14,N.L.,"MONTERREY, N.L.",3,0,3,82,0,12986,
18-dic-14,DGO.,"DGO., DGO.",2,1,3,1,3,0,
19-dic-14,CHIS.,"BENEMÉRITO DE LAS AMÉRICAS, CHIS.",1,2,3,0,0,0,
19-dic-14,GRO.,"ATOYAC DE ALVAREZ, GRO.",2,1,3,0,0,0,
20-dic-14,N.L.,"SAN NICOLAS DE LOS GARZA, N.L.",3,0,3,8,0,128,
20-dic-14,GRO.,"IGUALA DE LA INDEPENDENCIA, GRO.",2,1,3,0,1,0,
28-dic-14,TAMPS.,"MATAMOROS, TAMPS.",2,1,3,0,0,0,
30-dic-14,CHIS.,"MARQUÉS DE COMILLAS, CHIS.",1,2,3,0,0,0,
02-ene-15,DGO.,"LERDO, DGO.",0,3,3,6,0,0,
04-ene-15,DGO.,"GOMEZ PALACIO, DGO.",2,1,3,1,0,0,
05-ene-15,CHIS.,"BENEMÉRITO DE LAS AMÉRICAS, CHIS.",3,0,3,0,0,0,
15-ene-15,DGO.,"DGO., DGO.",2,1,3,1,0,0,
19-ene-15,DGO.,"DGO., DGO.",2,1,3,1,0,0,
20-ene-15,DGO.,"DGO., DGO.",3,0,3,1,0,0,
22-ene-15,DGO.,"DGO., DGO.",3,0,3,4,5,0,
23-ene-15,COL.,"COL., COL.",2,1,3,0,0,0,
28-ene-15,CHIS.,"BENEMÉRITO DE LAS AMÉRICAS, CHIS.",2,1,3,0,0,0,
28-ene-15,PUE.,"ATLIXCO, PUE.",3,0,3,0,0,0,
29-ene-15,DGO.,"DGO., DGO.",3,0,3,3,2,0,
06-feb-15,B.C.,"MEXICALI, B.C.",0,3,3,0,0,0,
10-feb-15,B.C.,"TIJUANA, B.C.",3,0,3,0,0,0,
19-feb-15,YUC.,"TEMAX, YUC.",1,2,3,0,0,0,
20-feb-15,VER.,"ALAMO, VER.",3,0,3,0,0,0,
24-feb-15,B.C.,"MEXICALI, B.C.",1,2,3,0,0,0,
28-feb-15,VER.,"ALAMO, VER.",2,1,3,0,0,0,
04-mar-15,VER.,"POZA RICA DE HGO., VER.",2,1,3,2,0,125,
05-mar-15,CAMP.,"CAMP., CAMP.",1,2,3,0,0,0,
05-mar-15,B.C.,"TIJUANA, B.C.",1,2,3,0,0,0,
06-mar-15,CAMP.,"CAMP., CAMP.",1,2,3,0,0,0,
09-mar-15,B.C.,"TIJUANA, B.C.",2,1,3,0,0,0,
16-mar-15,DGO.,"GOMEZ PALACIO, DGO.",1,2,3,0,0,0,
18-mar-15,OAX.,"OAX. DE JUAREZ, OAX.",3,0,3,4,0,92,
23-mar-15,OAX.,"MIAHUATLAN DE PORFIRIO DIAZ, OAX.",1,2,3,9,0,0,
24-mar-15,OAX.,"MIAHUATLAN DE PORFIRIO DIAZ, OAX.",1,2,3,0,1,0,
24-mar-15,OAX.,"OAX. DE JUAREZ, OAX.",0,3,3,0,0,0,
24-mar-15,YUC.,"CUZAMA, YUC.",2,1,3,0,0,47,
26-mar-15,GRO.,"BENITO JUAREZ, GRO.",2,1,3,0,0,0,
27-mar-15,OAX.,"MIAHUATLAN DE PORFIRIO DIAZ, OAX.",2,1,3,5,0,0,
28-mar-15,DGO.,"GOMEZ PALACIO, DGO.",3,0,3,12,0,0,
29-mar-15,DGO.,"LERDO, DGO.",2,1,3,0,0,0,
03-ago-15,GRO.,"ACAPULCO DE JUAREZ, GRO.",0,3,3,0,0,0,
03-ago-15,GRO.,"COYUCA DE BENITEZ, GRO.",2,1,3,0,0,63,
04-ago-15,OAX.,"MIAHUATLAN DE PORFIRIO DIAZ, OAX.",3,0,3,1,0,29,
04-ago-15,COAH.,"MÚZQUIZ, COAH.",2,1,3,0,0,0,
05-ago-15,COAH.,"MÚZQUIZ, COAH.",3,0,3,2,0,0,
06-ago-15,GRO.,"PETATLAN, GRO.",1,2,3,0,0,0,
07-ago-15,MEX.,"METEPEC, MEX.",3,0,3,3,0,21,
08-ago-15,MEX.,"HUEHUETOCA, MEX.",2,1,3,0,0,15,
08-ago-15,DGO.,"TLAHUALILO, DGO.",2,1,3,0,0,0,
10-ago-15,MEX.,"TOLUCA, MEX.",3,0,3,1,0,56,
10-ago-15,CHIH.,"HGO. DEL PARRAL, CHIH.",2,1,3,0,0,92,
10-ago-15,TAMPS.,"VICTORIA, TAMPS.",3,0,3,0,0,300,
11-ago-15,HGO.,"APAN, HGO.",3,0,3,0,0,167,
11-ago-15,PUE.,"PUE., PUE.",3,0,3,0,0,54,
11-ago-15,TLAX.,"TLAX., TLAX.",2,1,3,1,0,0,
11-ago-15,TLAX.,"APIZACO, TLAX.",3,0,3,1,0,3,
11-ago-15,GRO.,"LEONARDO BRAVO, GRO.",0,3,3,0,0,0,
11-ago-15,TAMPS.,"NUEVO LAREDO, TAMPS.",2,1,3,0,0,144,
11-ago-15,GRO.,"COCHOAPA EL GRANDE, GRO.",2,1,3,0,0,0,
12-ago-15,GRO.,"COCHOAPA EL GRANDE, GRO.",2,1,3,0,0,0,
12-ago-15,TLAX.,"TLAX., TLAX.",1,2,3,0,0,0,
13-ago-15,COAH.,"SALTILLO, COAH.",2,1,3,0,0,228,
13-ago-15,OAX.,"MIAHUATLAN DE PORFIRIO DIAZ, OAX.",0,3,3,3,0,0,
13-ago-15,TAMPS.,"MIER, TAMPS.",0,3,3,4,0,36,
13-ago-15,TAMPS.,"GUSTAVO DIAZ ORDAZ, TAMPS.",3,0,3,0,0,0,
14-ago-15,OAX.,"MIAHUATLAN DE PORFIRIO DIAZ, OAX.",2,1,3,7,0,5,
14-ago-15,B.C.S.,"LA PAZ, B.C.S.",3,0,3,0,0,0,
14-ago-15,TLAX.,"APIZACO, TLAX.",2,1,3,0,0,0,
15-ago-15,DGO.,"TLAHUALILO, DGO.",1,2,3,0,0,0,
15-ago-15,MEX.,"AMECAMECA, MEX.",1,2,3,0,1,0,
16-ago-15,DGO.,"LERDO, DGO.",0,3,3,0,0,0,
16-ago-15,B.C.,"ENSENADA, B.C.",3,0,3,0,0,0,
17-ago-15,TLAX.,"CALPULALPAN, TLAX.",2,1,3,0,0,0,
17-ago-15,CHIH.,"HGO. DEL PARRAL, CHIH.",1,2,3,0,0,30,
17-ago-15,MEX.,"CUAUTITLAN, MEX.",1,2,3,0,3,0,
17-ago-15,DGO.,"TLAHUALILO, DGO.",2,1,3,1,0,0,
18-ago-15,Q. ROO,"COZUMEL, Q. ROO",1,2,3,0,0,45,
18-ago-15,CHIH.,"HGO. DEL PARRAL, CHIH.",3,0,3,0,0,0,
18-ago-15,CHIH.,"CHIH., CHIH.",2,1,3,2,1,287,
18-ago-15,TLAX.,"CALPULALPAN, TLAX.",1,2,3,0,0,0,
19-ago-15,SON.,"HERMOSILLO, SON.",3,0,3,6,0,0,
19-ago-15,QRO.,"CORREGIDORA, QRO.",2,1,3,0,4,0,
19-ago-15,VER.,"NARANJOS AMATLAN, VER.",2,1,3,1,0,0,
20-ago-15,TLAX.,"CALPULALPAN, TLAX.",1,2,3,0,0,0,
20-ago-15,CHIH.,"CHIH., CHIH.",1,2,3,0,5,832,
20-ago-15,OAX.,"MIAHUATLAN DE PORFIRIO DIAZ, OAX.",0,3,3,0,0,0,
20-ago-15,COAH.,"PIEDRAS NEGRAS, COAH.",0,3,3,0,0,0,
20-ago-15,MEX.,"CUAUTITLAN IZCALLI, MEX.",3,0,3,0,0,40,
21-ago-15,SIN.,"SALVADOR ALVARADO, SIN.",2,1,3,0,0,0,
21-ago-15,GRO.,"TECPAN DE GALEANA, GRO.",2,1,3,0,0,0,
21-ago-15,MEX.,"CUAUTITLAN IZCALLI, MEX.",1,2,3,0,0,0,
22-ago-15,DGO.,"TLAHUALILO, DGO.",3,0,3,0,0,0,
23-ago-15,TLAX.,"CALPULALPAN, TLAX.",1,2,3,0,0,0,
23-ago-15,DGO.,"DGO., DGO.",3,0,3,11,0,0,
24-ago-15,COAH.,"MÚZQUIZ, COAH.",1,2,3,0,0,0,
24-ago-15,GRO.,"COYUCA DE BENITEZ, GRO.",0,3,3,0,0,115,
25-ago-15,OAX.,"MIAHUATLAN DE PORFIRIO DIAZ, OAX.",1,2,3,0,0,0,
25-ago-15,CHIH.,"CHIH., CHIH.",3,0,3,0,0,1296,
25-ago-15,COAH.,"MÚZQUIZ, COAH.",3,0,3,0,0,0,
25-ago-15,COAH.,"ACUÑA, COAH.",1,2,3,0,0,0,
26-ago-15,TLAX.,"CHIAUTEMPAN, TLAX.",2,1,3,0,0,0,
26-ago-15,CHIH.,"CHIH., CHIH.",3,0,3,13,0,0,
26-ago-15,SIN.,"MAZATLAN, SIN.",1,2,3,0,12,0,
26-ago-15,SIN.,"SALVADOR ALVARADO, SIN.",0,3,3,0,0,0,
27-ago-15,SON.,"CAJEME, SON.",3,0,3,1,0,0,
27-ago-15,SIN.,"SALVADOR ALVARADO, SIN.",2,1,3,0,1,0,
28-ago-15,QRO.,"CORREGIDORA, QRO.",1,2,3,0,0,0,
28-ago-15,CHIH.,"HGO. DEL PARRAL, CHIH.",2,1,3,0,0,35,
28-ago-15,B.C.,"ENSENADA, B.C.",1,2,3,0,0,0,
28-ago-15,DGO.,"TLAHUALILO, DGO.",1,2,3,0,0,0,
29-ago-15,MEX.,"SAN MATEO ATENCO, MEX.",3,0,3,2,0,0,
29-ago-15,MEX.,"TULTEPEC, MEX.",2,1,3,0,0,0,
31-ago-15,SIN.,"ROSARIO, SIN.",2,1,3,0,0,0,
31-ago-15,SIN.,"ANGOSTURA, SIN.",2,1,3,0,0,0,
01-sep-15,B.C.,"TIJUANA, B.C.",2,1,3,0,0,0,
02-sep-15,B.C.,"ENSENADA, B.C.",2,1,3,0,0,0,
02-sep-15,COAH.,"MONCLOVA, COAH.",3,0,3,0,0,18,
03-sep-15,SIN.,"ROSARIO, SIN.",2,1,3,0,0,0,
03-sep-15,SIN.,"COSALA, SIN.",0,3,3,1,0,0,
03-sep-15,CHIH.,"CHIH., CHIH.",2,1,3,4,0,1214,
03-sep-15,DGO.,"DGO., DGO.",3,0,3,0,0,0,
04-sep-15,CHIH.,"HGO. DEL PARRAL, CHIH.",2,1,3,0,0,40,
04-sep-15,SIN.,"ANGOSTURA, SIN.",1,2,3,0,0,0,
07-sep-15,COAH.,"SABINAS, COAH.",3,0,3,0,0,84,
08-sep-15,COAH.,"PIEDRAS NEGRAS, COAH.",0,3,3,5,4,40,
08-sep-15,N.L.,"MONTERREY, N.L.",3,0,3,19,0,1349,
10-sep-15,CHIH.,"HGO. DEL PARRAL, CHIH.",3,0,3,0,0,0,
11-sep-15,CHIH.,"HGO. DEL PARRAL, CHIH.",2,1,3,0,0,11,
11-sep-15,COAH.,"TORREÓN, COAH.",2,1,3,1,0,0,
11-sep-15,DGO.,"DGO., DGO.",1,2,3,0,0,0,
11-sep-15,GRO.,"ZIHUATANEJO DE AZUETA, GRO.",1,2,3,0,0,161,
11-sep-15,MEX.,"TONATICO, MEX.",3,0,3,0,0,0,
12-sep-15,B.C.,"TIJUANA, B.C.",3,0,3,0,0,0,
12-sep-15,MEX.,"TULTITLAN, MEX.",2,1,3,1,0,153,
16-sep-15,B.C.,"ENSENADA, B.C.",3,0,3,0,0,0,
18-sep-15,TAMPS.,"TAMPICO, TAMPS.",3,0,3,0,0,430,
18-sep-15,B.C.,"ENSENADA, B.C.",1,2,3,0,0,0,
18-sep-15,COAH.,"MONCLOVA, COAH.",3,0,3,1,1,31,
18-sep-15,COAH.,"SABINAS, COAH.",1,2,3,0,0,0,
21-sep-15,MEX.,"TENANCINGO, MEX.",1,2,3,1,0,0,
22-sep-15,COAH.,"SALTILLO, COAH.",2,1,3,2,3,0,
22-sep-15,COAH.,"SABINAS, COAH.",2,1,3,0,0,0,
22-sep-15,COAH.,"TORREÓN, COAH.",3,0,3,0,0,0,
22-sep-15,B.C.,"ENSENADA, B.C.",1,2,3,0,0,0,
22-sep-15,SIN.,"ANGOSTURA, SIN.",1,2,3,0,0,0,
22-sep-15,SIN.,"SAN IGNACIO, SIN.",1,2,3,1,0,0,
22-sep-15,CHIH.,"HGO. DEL PARRAL, CHIH.",1,2,3,0,0,48,
23-sep-15,COAH.,"TORREÓN, COAH.",2,1,3,0,0,0,
23-sep-15,AGS.,"JESÚS MARÍA, AGS.",3,0,3,3,0,90,
24-sep-15,COAH.,"SABINAS, COAH.",3,0,3,0,0,0,
24-sep-15,COAH.,"MONCLOVA, COAH.",2,1,3,0,0,64,
25-sep-15,MEX.,"TENANGO DEL VALLE, MEX.",3,0,3,2,0,0,
25-sep-15,B.C.,"TIJUANA, B.C.",1,2,3,0,0,0,
25-sep-15,B.C.,"ENSENADA, B.C.",0,3,3,0,0,0,
25-sep-15,MEX.,"TEZOYUCA, MEX.",1,2,3,0,1,0,
26-sep-15,MEX.,"TENANCINGO, MEX.",2,1,3,0,0,0,
26-sep-15,TLAX.,"TLAX., TLAX.",1,2,3,1,0,0,
28-sep-15,MEX.,"TEOLOYUCAN, MEX.",3,0,3,0,0,416,
30-sep-15,SIN.,"ELOTA, SIN.",2,1,3,0,6,0,
30-sep-15,SIN.,"NAVOLATO, SIN.",2,1,3,0,10,26,
30-sep-15,B.C.,"ENSENADA, B.C.",1,2,3,0,0,0,
30-sep-15,MEX.,"OCOYOACAC, MEX.",3,0,3,0,0,11,
01-oct-15,SIN.,"ESCUINAPA, SIN.",1,2,3,0,0,0,
01-oct-15,B.C.,"ENSENADA, B.C.",3,0,3,0,0,0,
02-oct-15,DGO.,"DGO., DGO.",1,2,3,0,0,0,
02-oct-15,GRO.,"FLORENCIO VILLARREAL, GRO.",2,1,3,0,0,0,
03-oct-15,COAH.,"PIEDRAS NEGRAS, COAH.",0,3,3,6,0,220,
04-oct-15,TLAX.,"ZACATELCO, TLAX.",1,2,3,0,0,0,
05-oct-15,DGO.,"TLAHUALILO, DGO.",0,3,3,0,0,0,
05-oct-15,SIN.,"NAVOLATO, SIN.",2,1,3,0,0,0,
05-oct-15,COAH.,"PIEDRAS NEGRAS, COAH.",2,1,3,0,0,13,
05-oct-15,COAH.,"MONCLOVA, COAH.",2,1,3,1,0,8,
06-oct-15,HGO.,"TULANCINGO DE BRAVO, HGO.",0,3,3,0,0,50,
06-oct-15,SIN.,"ESCUINAPA, SIN.",2,1,3,0,0,0,
06-oct-15,COAH.,"MONCLOVA, COAH.",1,2,3,0,0,264,
06-oct-15,MEX.,"ECATEPEC DE MOR., MEX.",3,0,3,0,0,15,
07-oct-15,B.C.,"MEXICALI, B.C.",0,3,3,0,0,0,
08-oct-15,COAH.,"MONCLOVA, COAH.",2,1,3,1,0,0,
09-oct-15,DGO.,"GOMEZ PALACIO, DGO.",3,0,3,0,0,0,
09-oct-15,SIN.,"BADIRAGUATO, SIN.",2,1,3,0,5,0,
10-oct-15,MEX.,"TIANGUISTENCO, MEX.",3,0,3,0,0,0,
11-oct-15,DGO.,"DGO., DGO.",1,2,3,0,0,0,
12-oct-15,COAH.,"SABINAS, COAH.",2,1,3,0,0,0,
12-oct-15,COAH.,"ACUÑA, COAH.",1,2,3,0,0,0,
13-oct-15,SIN.,"BADIRAGUATO, SIN.",1,2,3,0,3,0,
15-oct-15,MEX.,"LA PAZ, MEX.",3,0,3,0,2,0,
15-oct-15,CHIH.,"AHUMADA, CHIH.",3,0,3,0,0,0,
16-oct-15,MEX.,"NEXTLALPAN, MEX., MEX.",2,1,3,0,0,0,
16-oct-15,DGO.,"DGO., DGO.",2,1,3,15,0,0,
16-oct-15,COAH.,"MONCLOVA, COAH.",2,1,3,2,0,0,
18-oct-15,N.L.,"SAN NICOLAS DE LOS GARZA, N.L.",3,0,3,160,0,6000,
19-oct-15,SIN.,"CONCORDIA, SIN.",1,2,3,0,0,0,
19-oct-15,COAH.,"ACUÑA, COAH.",3,0,3,0,0,0,
20-oct-15,HGO.,"IXMIQUILPAN, HGO.",2,1,3,0,0,0,
20-oct-15,MEX.,"ZINACANTEPEC, MEX.",3,0,3,1,0,58,
20-oct-15,MEX.,"XONACATLAN, MEX.",3,0,3,0,0,0,
20-oct-15,COAH.,"TORREÓN, COAH.",3,0,3,2,0,24,
20-oct-15,DGO.,"DGO., DGO.",3,0,3,9,0,0,
21-oct-15,COAH.,"MONCLOVA, COAH.",2,1,3,3,0,48,
21-oct-15,GRO.,"EDUARDO NERI, GRO.",1,2,3,0,0,0,
21-oct-15,DGO.,"LERDO, DGO.",1,2,3,0,0,0,
22-oct-15,MEX.,"XONACATLAN, MEX.",2,1,3,1,0,0,
23-oct-15,MEX.,"TEOTIHUACAN, MEX.",2,1,3,2,2,229,
24-oct-15,B.C.,"TIJUANA, B.C.",1,2,3,0,0,0,
24-oct-15,MEX.,"ZINACANTEPEC, MEX.",3,0,3,1,0,0,
24-oct-15,TAMPS.,"MATAMOROS, TAMPS.",2,1,3,1,0,30,
26-oct-15,COAH.,"PIEDRAS NEGRAS, COAH.",2,1,3,0,0,0,
27-oct-15,D.F.,"ALVARO OBREGON, D.F.",2,1,3,0,1,0,
28-oct-15,COAH.,"SALTILLO, COAH.",3,0,3,9,1,829,
28-oct-15,B.C.,"TIJUANA, B.C.",3,0,3,0,0,0,
29-oct-15,MEX.,"COCOTITLAN, MEX.",1,2,3,0,0,0,
29-oct-15,COAH.,"MONCLOVA, COAH.",2,1,3,1,0,8,
29-oct-15,COAH.,"SABINAS, COAH.",1,2,3,0,0,0,
30-oct-15,YUC.,"HUNUCMA, YUC.",3,0,3,0,0,0,
01-nov-15,B.C.,"MEXICALI, B.C.",3,0,3,0,0,0,
02-nov-15,DGO.,"GOMEZ PALACIO, DGO.",1,2,3,0,0,0,
04-nov-15,MEX.,"PAPALOTLA, MEX.",3,0,3,0,0,0,
04-nov-15,MEX.,"VALLE DE CHALCO SOLIDARIDAD, MEX.",3,0,3,0,0,0,
05-nov-15,B.C.,"MEXICALI, B.C.",0,3,3,0,0,0,
05-nov-15,COAH.,"TORREÓN, COAH.",2,1,3,0,0,0,
05-nov-15,COAH.,"SAN PEDRO, COAH.",3,0,3,0,0,0,
06-nov-15,COAH.,"MATAMOROS, COAH.",3,0,3,0,0,5,
06-nov-15,COAH.,"SALTILLO, COAH.",2,1,3,0,2,0,
06-nov-15,COAH.,"MONCLOVA, COAH.",2,1,3,1,1,11,
06-nov-15,N.L.,"GRAL. ESCOBEDO, N.L.",3,0,3,0,0,0,
06-nov-15,MEX.,"PAPALOTLA, MEX.",1,2,3,1,0,0,
09-nov-15,MEX.,"MALINALCO, MEX.",2,1,3,2,0,0,
09-nov-15,N.L.,"GRAL. ESCOBEDO, N.L.",2,1,3,1,0,0,
10-nov-15,MEX.,"ISIDRO FABELA, MEX.",2,1,3,1,0,0,
10-nov-15,MEX.,"CHIAUTLA, MEX.",3,0,3,0,0,0,
11-nov-15,MEX.,"CHIAUTLA, MEX.",2,1,3,0,0,0,
12-nov-15,B.C.,"MEXICALI, B.C.",3,0,3,0,0,0,
13-nov-15,TAB.,"BALANCAN, TAB.",2,1,3,0,0,0,
13-nov-15,MEX.,"CHIAUTLA, MEX.",2,1,3,0,2,0,
14-nov-15,B.C.,"TIJUANA, B.C.",2,1,3,0,0,0,
14-nov-15,MEX.,"CHIAUTLA, MEX.",3,0,3,0,0,0,
16-nov-15,GRO.,"AJUCHITLAN DEL PROGRESO, GRO.",1,2,3,2,0,0,
17-nov-15,COAH.,"SALTILLO, COAH.",1,2,3,4,2,410,
17-nov-15,COAH.,"FRONTERA, COAH.",2,1,3,2,0,0,
17-nov-15,N.L.,"GRAL. ESCOBEDO, N.L.",3,0,3,2,0,3000,
18-nov-15,COAH.,"SALTILLO, COAH.",2,1,3,0,4,1436,
18-nov-15,TAMPS.,"CIUDAD MADERO, TAMPS.",1,2,3,2,0,11,
19-nov-15,COAH.,"TORREÓN, COAH.",2,1,3,4,0,0,
20-nov-15,MEX.,"XALATLACO, MEX.",3,0,3,0,0,0,
22-nov-15,DGO.,"DGO., DGO.",2,1,3,0,0,0,
23-nov-15,YUC.,"TIXKOKOB, YUC.",1,2,3,0,0,101,
23-nov-15,COAH.,"SAN PEDRO, COAH.",2,1,3,1,0,5,
23-nov-15,AGS.,"AGS., AGS.",2,1,3,0,0,0,
23-nov-15,AGS.,"AGS., AGS.",2,1,3,0,0,25,
24-nov-15,MEX.,"ALMOLOYA DE JUAREZ, MEX.",1,2,3,0,0,0,
24-nov-15,DGO.,"DGO., DGO.",2,1,3,0,0,0,
24-nov-15,SON.,"SAN LUIS RIO COLORADO, SON.",3,0,3,0,0,0,
25-nov-15,AGS.,"AGS., AGS.",2,1,3,4,0,2101,
25-nov-15,PUE.,"PUE., PUE.",3,0,3,0,0,12,
26-nov-15,PUE.,"PUE., PUE.",2,1,3,1,0,0,
26-nov-15,DGO.,"DGO., DGO.",3,0,3,2,0,0,
26-nov-15,SON.,"HUATABAMPO, SON.",3,0,3,1,0,0,
26-nov-15,COAH.,"TORREÓN, COAH.",3,0,3,6,0,0,
26-nov-15,COAH.,"SALTILLO, COAH.",3,0,3,0,0,1245,
26-nov-15,MEX.,"AXAPUSCO, MEX.",3,0,3,0,0,131,
26-nov-15,SON.,"AGUA PRIETA, SON.",1,2,3,1,0,75,
27-nov-15,MEX.,"ALMOLOYA DE JUAREZ, MEX.",2,1,3,1,0,0,
28-nov-15,MEX.,"TEMASCALAPA, MEX.",0,3,3,0,0,0,
01-dic-15,SON.,"NOGALES, SON.",3,0,3,11,2,0,
01-dic-15,SON.,"CANANEA, SON.",1,2,3,0,0,0,
01-dic-15,GRO.,"TAXCO DE ALARCON, GRO.",1,2,3,0,0,0,
02-dic-15,S.L.P.,"SAN LUIS POTOSI, S.L.P.",3,0,3,0,0,32,
02-dic-15,SON.,"PITIQUITO, SON.",0,3,3,0,0,0,
02-dic-15,SON.,"GENERAL PLUTARCO ELIAS CALLES, SON.",0,3,3,0,0,0,
02-dic-15,SON.,"NAVOJOA, SON.",2,1,3,1,0,0,
02-dic-15,DGO.,"DGO., DGO.",3,0,3,0,1,0,
02-dic-15,COAH.,"PIEDRAS NEGRAS, COAH.",1,2,3,1,0,0,
02-dic-15,TAMPS.,"MATAMOROS, TAMPS.",1,2,3,2,0,11,
02-dic-15,B.C.,"MEXICALI, B.C.",1,2,3,0,0,0,
03-dic-15,SON.,"GENERAL PLUTARCO ELIAS CALLES, SON.",1,2,3,1,0,0,
03-dic-15,PUE.,"PUE., PUE.",3,0,3,0,0,22,
04-dic-15,SON.,"ALAMOS, SON.",1,2,3,1,0,184,
04-dic-15,SON.,"ETCHOJOA, SON.",0,3,3,0,0,0,
05-dic-15,S.L.P.,"CIUDAD VALLES, S.L.P.",3,0,3,0,0,0,
06-dic-15,B.C.,"MEXICALI, B.C.",1,2,3,0,0,0,
06-dic-15,COAH.,"TORREÓN, COAH.",3,0,3,11,0,0,
06-dic-15,COAH.,"TORREÓN, COAH.",3,0,3,11,0,0,
07-dic-15,SON.,"HERMOSILLO, SON.",2,1,3,20,0,0,
07-dic-15,SON.,"ALAMOS, SON.",2,1,3,0,0,0,
09-dic-15,S.L.P.,"CIUDAD VALLES, S.L.P.",1,2,3,0,1,270,
09-dic-15,S.L.P.,"RIOVERDE, S.L.P.",2,1,3,0,0,0,
11-dic-15,N.L.,"SAN NICOLAS DE LOS GARZA, N.L.",2,1,3,0,0,65,
12-dic-15,S.L.P.,"SAN LUIS POTOSI, S.L.P.",2,1,3,0,0,0,
12-dic-15,SON.,"SAN LUIS RIO COLORADO, SON.",3,0,3,0,0,50,
12-dic-15,N.L.,"SAN NICOLAS DE LOS GARZA, N.L.",3,0,3,221,0,50,
13-dic-15,S.L.P.,"SAN LUIS POTOSI, S.L.P.",2,1,3,0,0,0,
18-dic-15,CHIH.,"HGO. DEL PARRAL, CHIH.",1,2,3,33,0,1204,
18-dic-15,B.C.,"MEXICALI, B.C.",3,0,3,0,0,0,
21-dic-15,TAMPS.,"MATAMOROS, TAMPS.",2,1,3,0,0,910,
22-dic-15,B.C.,"MEXICALI, B.C.",0,3,3,0,0,0,
23-dic-15,B.C.,"ENSENADA, B.C.",1,2,3,0,0,0,
30-dic-15,GRO.,"FLORENCIO VILLARREAL, GRO.",1,2,3,0,0,0,
13-ene-16,CAMP.,"CAMP., CAMP.",0,3,3,1,0,0,
14-ene-16,COAH.,"TORREÓN, COAH.",1,2,3,0,0,0,
14-ene-16,CAMP.,"CAMP., CAMP.",0,3,3,1,0,0,
15-ene-16,B.C.,"MEXICALI, B.C.",2,1,3,0,0,0,
16-ene-16,CAMP.,"CAMP., CAMP.",0,3,3,1,0,0,
16-ene-16,COAH.,"MATAMOROS, COAH.",3,0,3,0,0,0,
17-ene-16,CAMP.,"CAMP., CAMP.",0,3,3,1,0,0,
17-ene-16,TAMPS.,"MATAMOROS, TAMPS.",1,2,3,1,0,0,
20-ene-16,COAH.,"SALTILLO, COAH.",1,2,3,0,0,0,
20-ene-16,B.C.,"MEXICALI, B.C.",1,2,3,0,0,0,
21-ene-16,COAH.,"TORREÓN, COAH.",2,1,3,0,0,582,
22-ene-16,OAX.,"CIUDAD IXTEPEC, OAX.",3,0,3,5,7,204,
22-ene-16,DGO.,"DGO., DGO.",3,0,3,3,0,0,
22-ene-16,COAH.,"SALTILLO, COAH.",0,3,3,0,0,0,
26-ene-16,OAX.,"MIAHUATLAN DE PORFIRIO DIAZ, OAX.",0,3,3,39,0,0,
30-ene-16,TAMPS.,"MATAMOROS, TAMPS.",0,3,3,1,0,0,
31-ene-16,COAH.,"PIEDRAS NEGRAS, COAH.",2,1,3,0,0,58,
31-ene-16,COAH.,"SALTILLO, COAH.",2,1,3,0,0,0,
31-ene-16,COAH.,"SALTILLO, COAH.",3,0,3,0,0,0,
01-feb-16,TAMPS.,"MATAMOROS, TAMPS.",2,1,3,0,0,0,
02-feb-16,COAH.,"MONCLOVA, COAH.",3,0,3,0,3,91,
02-feb-16,COAH.,"TORREÓN, COAH.",3,0,3,0,0,0,
02-feb-16,COAH.,"MONCLOVA, COAH.",3,0,3,2,0,91,
02-feb-16,COAH.,"TORREÓN, COAH.",3,0,3,0,0,132,
04-feb-16,OAX.,"OAX. DE JUAREZ, OAX.",0,3,3,0,0,0,
05-feb-16,OAX.,"CIUDAD IXTEPEC, OAX.",2,1,3,0,0,0,
06-feb-16,COAH.,"ACUÑA, COAH.",1,2,3,0,0,25,
08-feb-16,COAH.,"PIEDRAS NEGRAS, COAH.",2,1,3,0,0,0,
09-feb-16,COAH.,"MONCLOVA, COAH.",2,1,3,2,0,15,
09-feb-16,COAH.,"SALTILLO, COAH.",3,0,3,0,0,110,
12-feb-16,COAH.,"SABINAS, COAH.",0,3,3,0,0,0,
17-feb-16,HGO.,"TULANCINGO DE BRAVO, HGO.",3,0,3,1,0,11,
17-feb-16,COAH.,"MÚZQUIZ, COAH.",2,1,3,0,0,0,
23-feb-16,COAH.,"SALTILLO, COAH.",2,1,3,0,0,0,
23-feb-16,COAH.,"SABINAS, COAH.",1,2,3,0,0,0,
23-feb-16,CHIH.,"AHUMADA, CHIH.",2,1,3,0,0,0,
23-feb-16,HGO.,"PACHUCA DE SOTO, HGO.",1,2,3,0,0,0,
24-feb-16,COAH.,"SABINAS, COAH.",2,1,3,0,0,0,
25-feb-16,COAH.,"PIEDRAS NEGRAS, COAH.",0,3,3,0,0,0,
29-feb-16,COAH.,"MONCLOVA, COAH.",3,0,3,0,0,3,
29-feb-16,COAH.,"SABINAS, COAH.",1,2,3,0,0,0,
01-mar-16,COAH.,"TORREÓN, COAH.",3,0,3,3,0,0,
03-mar-16,COAH.,"TORREÓN, COAH.",2,1,3,0,0,40,
03-mar-16,COAH.,"SABINAS, COAH.",3,0,3,0,0,0,
08-mar-16,COAH.,"TORREÓN, COAH.",3,0,3,0,0,0,
09-mar-16,HGO.,"PACHUCA DE SOTO, HGO.",2,1,3,0,0,0,
09-mar-16,COAH.,"MONCLOVA, COAH.",1,2,3,4,0,26,
10-mar-16,COAH.,"SALTILLO, COAH.",1,2,3,0,0,317,
16-mar-16,COAH.,"TORREÓN, COAH.",3,0,3,0,0,0,
17-mar-16,COAH.,"SALTILLO, COAH.",1,2,3,19,0,7,
18-mar-16,COAH.,"SAN PEDRO, COAH.",0,3,3,0,0,0,
18-mar-16,COAH.,"PIEDRAS NEGRAS, COAH.",1,2,3,0,0,0,
22-mar-16,COAH.,"SAN PEDRO, COAH.",2,1,3,0,0,34,
22-mar-16,COAH.,"SALTILLO, COAH.",2,1,3,0,0,312,
29-mar-16,COAH.,"SALTILLO, COAH.",2,1,3,0,1,0,
30-mar-16,COAH.,"TORREÓN, COAH.",2,1,3,0,0,0,
31-mar-16,COAH.,"MONCLOVA, COAH.",2,1,3,1,0,0,
31-mar-16,OAX.,"CIUDAD IXTEPEC, OAX.",0,3,3,0,0,79,
02-abr-16,COAH.,"TORREÓN, COAH.",1,2,3,0,0,0,
06-abr-16,S.L.P.,"SAN LUIS POTOSI, S.L.P.",3,0,3,0,0,0,
06-abr-16,S.L.P.,"SAN LUIS POTOSI, S.L.P.",3,0,3,0,0,0,
06-abr-16,COAH.,"FRANCISCO I. MADERO, COAH.",3,0,3,0,0,0,
07-abr-16,S.L.P.,"CIUDAD VALLES, S.L.P.",3,0,3,0,0,0,
07-abr-16,S.L.P.,"SOLEDAD DE GRACIANO SANCHEZ, S.L.P.",2,1,3,0,0,0,
08-abr-16,GTO.,"SALAMANCA, GTO.",1,2,3,0,0,0,
12-abr-16,COAH.,"SAN PEDRO, COAH.",2,1,3,0,0,0,
13-abr-16,S.L.P.,"EBANO, S.L.P.",3,0,3,0,0,0,
13-abr-16,COAH.,"TORREÓN, COAH.",1,2,3,0,0,45,
14-abr-16,COAH.,"PIEDRAS NEGRAS, COAH.",2,1,3,0,0,4,
16-abr-16,COAH.,"ALLENDE, COAH.",1,2,3,2,0,14,
17-abr-16,S.L.P.,"CIUDAD VALLES, S.L.P.",1,2,3,0,0,0,
18-abr-16,COAH.,"TORREÓN, COAH.",1,2,3,1,0,0,
18-abr-16,COAH.,"MONCLOVA, COAH.",1,2,3,0,0,25,
18-abr-16,COAH.,"TORREÓN, COAH.",1,2,3,1,0,0,
18-abr-16,TAMPS.,"MATAMOROS, TAMPS.",1,2,3,10,1,380,
19-abr-16,COAH.,"TORREÓN, COAH.",3,0,3,0,1,0,
19-abr-16,COAH.,"FRANCISCO I. MADERO, COAH.",3,0,3,0,0,0,
20-abr-16,COAH.,"FRANCISCO I. MADERO, COAH.",3,0,3,0,0,0,
20-abr-16,COAH.,"SALTILLO, COAH.",0,3,3,0,0,23,
29-abr-16,DGO.,"DGO., DGO.",3,0,3,1,0,0,
03-may-16,GTO.,"MANUEL DOBLADO, GTO.",0,3,3,0,0,0,
08-may-16,GTO.,"ROMITA, GTO.",3,0,3,0,0,115,
09-may-16,COAH.,"TORREÓN, COAH.",2,1,3,0,0,32,
25-may-16,N.L.,"GUADALUPE, N.L.",2,1,3,0,0,150,
01-jun-16,COAH.,"PIEDRAS NEGRAS, COAH.",3,0,3,0,0,0,
04-jun-16,COAH.,"MÚZQUIZ, COAH.",1,2,3,0,0,0,
04-jun-16,N.L.,"APODACA, N.L.",2,1,3,4,0,80,
08-jun-16,COAH.,"TORREÓN, COAH.",1,2,3,0,0,0,
13-jun-16,N.L.,"SAN NICOLAS DE LOS GARZA, N.L.",2,1,3,0,0,4090,
15-jun-16,N.L.,"SAN NICOLAS DE LOS GARZA, N.L.",3,0,3,0,0,3435,
24-jun-16,CHIH.,"HGO. DEL PARRAL, CHIH.",1,2,3,0,0,0,
01-jul-16,COAH.,"SALTILLO, COAH.",2,1,3,0,0,0,
05-jul-16,COAH.,"SALTILLO, COAH.",2,1,3,0,0,0,
06-jul-16,HGO.,"PACHUCA DE SOTO, HGO.",1,2,3,0,0,1000,
06-jul-16,SIN.,"SAN IGNACIO, SIN.",3,0,3,0,0,0,
07-jul-16,SIN.,"SAN IGNACIO, SIN.",0,3,3,0,0,0,
15-jul-16,B.C.,"TIJUANA, B.C.",1,2,3,0,1,0,
17-jul-16,N.L.,"GUADALUPE, N.L.",3,0,3,0,0,0,
21-jul-16,B.C.,"MEXICALI, B.C.",1,2,3,0,0,0,
22-jul-16,COAH.,"PIEDRAS NEGRAS, COAH.",1,2,3,0,0,0,
22-jul-16,B.C.,"MEXICALI, B.C.",1,2,3,0,0,0,
24-jul-16,B.C.,"MEXICALI, B.C.",1,2,3,0,0,0,
25-jul-16,TLAX.,"CUAPIAXTLA, TLAX.",2,1,3,0,0,0,
28-jul-16,N.L.,"GUADALUPE, N.L.",2,1,3,2,0,0,
28-jul-16,COAH.,"MÚZQUIZ, COAH.",1,2,3,0,0,0,
29-jul-16,COAH.,"SAN PEDRO, COAH.",3,0,3,0,0,0,
30-jul-16,COAH.,"FRANCISCO I. MADERO, COAH.",3,0,3,0,0,0,
01-ago-16,COAH.,"PIEDRAS NEGRAS, COAH.",1,2,3,0,0,0,
04-ago-16,B.C.,"TIJUANA, B.C.",0,3,3,0,0,0,
04-ago-16,COAH.,"FRANCISCO I. MADERO, COAH.",0,3,3,0,0,0,
05-ago-16,SON.,"GUAYMAS, SON.",1,2,3,0,0,0,
05-ago-16,TLAX.,"SAN PABLO DEL MONTE, TLAX.",1,2,3,0,0,0,
06-ago-16,TLAX.,"APIZACO, TLAX.",3,0,3,0,0,0,
08-ago-16,B.C.,"TIJUANA, B.C.",2,1,3,0,0,0,
10-ago-16,SIN.,"NAVOLATO, SIN.",3,0,3,0,5,0,
10-ago-16,MEX.,"LERMA, MEX.",0,3,3,1,0,13,
10-ago-16,S.L.P.,"CIUDAD VALLES, S.L.P.",3,0,3,1,1,0,
11-ago-16,MEX.,"METEPEC, MEX.",3,0,3,4,0,50,
12-ago-16,S.L.P.,"CIUDAD VALLES, S.L.P.",3,0,3,0,1,0,
13-ago-16,CHIS.,"BENEMÉRITO DE LAS AMÉRICAS, CHIS.",1,2,3,0,0,0,
14-ago-16,SON.,"CAJEME, SON.",2,1,3,0,0,0,
14-ago-16,S.L.P.,"CIUDAD VALLES, S.L.P.",2,1,3,0,1,0,
14-ago-16,S.L.P.,"CIUDAD VALLES, S.L.P.",3,0,3,0,0,38,
16-ago-16,MEX.,"TOLUCA, MEX.",3,0,3,0,0,0,
17-ago-16,SIN.,"BADIRAGUATO, SIN.",1,2,3,0,0,0,
18-ago-16,COAH.,"SALTILLO, COAH.",3,0,3,0,1,134,
18-ago-16,MEX.,"ZUMPANGO, MEX.",2,1,3,1,0,26,
20-ago-16,TLAX.,"CALPULALPAN, TLAX.",3,0,3,0,0,0,
20-ago-16,COAH.,"ARTEAGA, COAH.",2,1,3,0,0,100,
22-ago-16,MEX.,"CUAUTITLAN, MEX.",2,1,3,1,0,39,
23-ago-16,N.L.,"SAN NICOLAS DE LOS GARZA, N.L.",1,2,3,0,0,33,
23-ago-16,CHIH.,"HGO. DEL PARRAL, CHIH.",2,1,3,0,0,0,
25-ago-16,MEX.,"EL ORO, MEX.",1,2,3,0,0,4,
25-ago-16,SON.,"HERMOSILLO, SON.",1,2,3,1,0,0,
25-ago-16,SON.,"CAJEME, SON.",0,3,3,0,0,0,
25-ago-16,MEX.,"CUAUTITLAN, MEX.",3,0,3,1,0,59,
27-ago-16,MEX.,"EL ORO, MEX.",3,0,3,1,0,119,
27-ago-16,TAMPS.,"MATAMOROS, TAMPS.",2,1,3,2,0,50,
29-ago-16,GRO.,"IGUALA DE LA INDEPENDENCIA, GRO.",1,2,3,0,0,0,
30-ago-16,SON.,"CAJEME, SON.",3,0,3,0,0,0,
30-ago-16,MEX.,"TULTEPEC, MEX.",3,0,3,0,0,0,
31-ago-16,CHIS.,"PUEBLO NUEVO SOLISTAHUACÁN, CHIS.",1,2,3,0,0,20,
31-ago-16,GRO.,"IGUALA DE LA INDEPENDENCIA, GRO.",2,1,3,0,0,0,
01-sep-16,CHIH.,"HGO. DEL PARRAL, CHIH.",3,0,3,0,0,0,
01-sep-16,COAH.,"PIEDRAS NEGRAS, COAH.",2,1,3,0,0,200,
02-sep-16,SON.,"HERMOSILLO, SON.",2,1,3,0,1,20,
05-sep-16,MEX.,"SAN MARTIN DE LAS PIRAMIDES, MEX.",2,1,3,0,0,2,
08-sep-16,CHIS.,"PUEBLO NUEVO SOLISTAHUACÁN, CHIS.",2,1,3,0,0,3,
08-sep-16,N.L.,"SAN PEDRO GARZA GARCIA, N.L.",3,0,3,6,0,2200,
10-sep-16,MEX.,"VILLA GRO., MEX.",3,0,3,0,0,0,
19-sep-16,SON.,"HERMOSILLO, SON.",3,0,3,18,0,75,
20-sep-16,COAH.,"SALTILLO, COAH.",3,0,3,0,1,21,
20-sep-16,SIN.,"CONCORDIA, SIN.",3,0,3,0,2,0,
23-sep-16,MEX.,"TULTITLAN, MEX.",2,1,3,0,0,9,
23-sep-16,SIN.,"CONCORDIA, SIN.",1,2,3,0,8,0,
24-sep-16,SON.,"CAJEME, SON.",3,0,3,0,0,0,
26-sep-16,COAH.,"TORREÓN, COAH.",1,2,3,0,0,0,
27-sep-16,SIN.,"CONCORDIA, SIN.",0,3,3,0,0,0,
27-sep-16,CHIS.,"VILLAFLORES, CHIS.",2,1,3,0,0,195,
29-sep-16,OAX.,"OAX. DE JUAREZ, OAX.",3,0,3,0,0,391,
01-oct-16,B.C.,"TIJUANA, B.C.",1,2,3,0,0,0,
01-oct-16,SON.,"HERMOSILLO, SON.",3,0,3,0,0,31,
02-oct-16,B.C.,"TIJUANA, B.C.",1,2,3,0,0,0,
03-oct-16,CHIS.,"VILLAFLORES, CHIS.",1,2,3,0,0,806,
03-oct-16,MEX.,"OCOYOACAC, MEX.",3,0,3,0,0,0,
04-oct-16,SON.,"CAJEME, SON.",3,0,3,0,0,0,
05-oct-16,MOR.,"XOCHITEPEC, MOR.",1,2,3,6,9,225,
06-oct-16,MEX.,"TEOLOYUCAN, MEX.",2,1,3,0,0,0,
07-oct-16,SON.,"CAJEME, SON.",2,1,3,0,1,0,
07-oct-16,MOR.,"XOCHITEPEC, MOR.",1,2,3,0,2,390,
08-oct-16,MEX.,"TEPOTZOTLAN, MEX.",2,1,3,0,0,1,
08-oct-16,B.C.,"MEXICALI, B.C.",0,3,3,0,0,0,
08-oct-16,SON.,"CAJEME, SON.",2,1,3,0,0,0,
08-oct-16,COAH.,"NAVA, COAH.",1,2,3,2,0,500,
08-oct-16,MOR.,"XOCHITEPEC, MOR.",1,2,3,0,2,390,
09-oct-16,B.C.,"MEXICALI, B.C.",2,1,3,0,0,0,
10-oct-16,CHIS.,"TAPACHULA, CHIS.",3,0,3,0,0,0,
10-oct-16,SIN.,"ROSARIO, SIN.",3,0,3,0,4,0,
12-oct-16,SIN.,"CHOIX, SIN.",1,2,3,0,4,0,
14-oct-16,CHIS.,"TAPACHULA, CHIS.",2,1,3,0,1,100,
15-oct-16,SON.,"CAJEME, SON.",1,2,3,0,0,0,
17-oct-16,COAH.,"MONCLOVA, COAH.",2,1,3,0,0,0,
17-oct-16,SIN.,"ESCUINAPA, SIN.",3,0,3,0,0,0,
19-oct-16,SIN.,"ESCUINAPA, SIN.",1,2,3,0,4,0,
19-oct-16,SON.,"CAJEME, SON.",3,0,3,0,0,0,
20-oct-16,SON.,"CAJEME, SON.",3,0,3,0,0,0,
22-oct-16,B.C.,"MEXICALI, B.C.",2,1,3,0,0,0,
26-oct-16,MEX.,"TEOTIHUACAN, MEX.",2,1,3,0,0,3,
27-oct-16,MEX.,"TEOTIHUACAN, MEX.",3,0,3,0,2,0,
28-oct-16,VER.,"CORDOBA, VER.",3,0,3,0,0,0,
28-oct-16,MEX.,"ZINACANTEPEC, MEX.",2,1,3,0,0,0,
29-oct-16,N.L.,"GARCIA, N.L.",3,0,3,0,0,1000,
02-nov-16,B.C.,"TIJUANA, B.C.",2,1,3,0,0,0,
03-nov-16,MEX.,"CALIMAYA, MEX.",3,0,3,1,0,0,
04-nov-16,MEX.,"MELCHOR OCAMPO, MEX.",1,2,3,0,1,9,
08-nov-16,SON.,"NOGALES, SON.",0,3,3,3,0,168,
08-nov-16,SON.,"GENERAL PLUTARCO ELIAS CALLES, SON.",1,2,3,9,0,0,
09-nov-16,SON.,"HERMOSILLO, SON.",3,0,3,0,0,0,
09-nov-16,SON.,"NAVOJOA, SON.",3,0,3,0,0,0,
09-nov-16,COAH.,"ACUÑA, COAH.",0,3,3,0,0,0,
09-nov-16,SON.,"SAN LUIS RIO COLORADO, SON.",2,1,3,0,0,0,
10-nov-16,COAH.,"TORREÓN, COAH.",2,1,3,0,0,0,
10-nov-16,SON.,"HUATABAMPO, SON.",3,0,3,0,0,0,
10-nov-16,SON.,"SAN LUIS RIO COLORADO, SON.",1,2,3,0,0,0,
11-nov-16,SON.,"SAN LUIS RIO COLORADO, SON.",1,2,3,23,0,148,
11-nov-16,SON.,"HERMOSILLO, SON.",1,2,3,0,0,0,
11-nov-16,SON.,"CAJEME, SON.",3,0,3,0,0,0,
11-nov-16,MEX.,"LUVIANOS, MEX.",3,0,3,2,0,0,
14-nov-16,SON.,"SAN LUIS RIO COLORADO, SON.",1,2,3,0,0,0,
15-nov-16,B.C.,"MEXICALI, B.C.",1,2,3,0,0,0,
15-nov-16,SON.,"SAN LUIS RIO COLORADO, SON.",0,3,3,0,0,0,
16-nov-16,SON.,"HERMOSILLO, SON.",2,1,3,0,0,0,
17-nov-16,MEX.,"MALINALCO, MEX.",2,1,3,1,0,0,
18-nov-16,VER.,"CORDOBA, VER.",2,1,3,0,0,117,
22-nov-16,COAH.,"TORREÓN, COAH.",2,1,3,1,0,0,
24-nov-16,MEX.,"NOPALTEPEC, MEX.",2,1,3,0,0,0,
28-nov-16,MEX.,"ACAMBAY, MEX.",2,1,3,0,0,0,
28-nov-16,SON.,"CAJEME, SON.",1,2,3,2,0,0,
29-nov-16,SON.,"PUERTO PEÑASCO, SON.",0,3,3,0,0,9,
01-dic-16,S.L.P.,"SAN LUIS POTOSI, S.L.P.",3,0,3,0,0,0,
01-dic-16,MEX.,"ACAMBAY, MEX.",2,1,3,1,0,54,
01-dic-16,N.L.,"SAN PEDRO GARZA GARCIA, N.L.",3,0,3,4,0,408,
03-dic-16,MEX.,"AXAPUSCO, MEX.",2,1,3,0,0,0,
06-dic-16,N.L.,"SAN PEDRO GARZA GARCIA, N.L.",3,0,3,16,0,1600,
08-dic-16,B.C.,"MEXICALI, B.C.",1,2,3,0,0,0,
08-dic-16,S.L.P.,"SAN LUIS POTOSI, S.L.P.",3,0,3,0,1,83,
10-dic-16,B.C.,"MEXICALI, B.C.",0,3,3,0,0,0,
10-dic-16,S.L.P.,"CIUDAD VALLES, S.L.P.",2,1,3,1,0,60,
14-dic-16,D.F.,"MIGUEL HGO., D.F.",2,1,3,0,0,0,
19-dic-16,N.L.,"GRAL. ESCOBEDO, N.L.",3,0,3,0,0,0,
20-dic-16,D.F.,"CUAUHTEMOC, D.F.",3,0,3,0,0,0,
22-dic-16,B.C.,"TIJUANA, B.C.",2,1,3,0,0,0,
31-dic-16,B.C.,"TIJUANA, B.C.",2,1,3,0,0,0,
11-ene-17,DGO.,"GOMEZ PALACIO, DGO.",2,1,3,0,0,0,
13-ene-17,D.F.,"CUAUHTEMOC, D.F.",3,0,3,0,0,72,
25-ene-17,DGO.,"GOMEZ PALACIO, DGO.",2,1,3,0,0,0,
30-ene-17,D.F.,"COYOACAN, D.F.",1,2,3,0,1,18,
30-ene-17,MICH.,"MORELIA, MICH.",1,2,3,0,6,3280,
31-ene-17,COAH.,"TORREÓN, COAH.",2,1,3,0,0,52,
31-ene-17,DGO.,"DGO., DGO.",2,1,3,0,8,4,
01-feb-17,TAMPS.,"TAMPICO, TAMPS.",2,1,3,0,0,317,
03-feb-17,DGO.,"DGO., DGO.",3,0,3,0,1,155,
04-feb-17,TAMPS.,"MATAMOROS, TAMPS.",2,1,3,8,0,260,
06-feb-17,DGO.,"DGO., DGO.",2,1,3,3,0,0,
08-feb-17,SIN.,"MAZATLAN, SIN.",3,0,3,0,5,0,
08-feb-17,DGO.,"DGO., DGO.",3,0,3,1,0,0,
10-feb-17,SIN.,"MAZATLAN, SIN.",3,0,3,0,10,0,
13-feb-17,SIN.,"MAZATLAN, SIN.",2,1,3,0,4,0,
15-feb-17,GRO.,"ACAPULCO DE JUAREZ, GRO.",1,2,3,0,6,0,
16-feb-17,CHIH.,"NUEVO CASAS GRANDES, CHIH.",3,0,3,1,0,239,
16-feb-17,MICH.,"TACAMBARO, MICH.",1,2,3,0,0,73,
17-feb-17,D.F.,"TLAHUAC, D.F.",2,1,3,0,0,71,
23-feb-17,VER.,"SAN ANDRES TUXTLA, VER.",1,2,3,0,0,0,
24-feb-17,SIN.,"CULIACAN, SIN.",3,0,3,0,0,0,
24-feb-17,SIN.,"MAZATLAN, SIN.",2,1,3,0,0,0,
28-feb-17,ZAC.,"CAÑITAS DE FELIPE PESCADOR, ZAC.",3,0,3,1,0,0,
28-feb-17,TAMPS.,"NUEVO LAREDO, TAMPS.",2,1,3,0,0,10,
01-mar-17,COAH.,"TORREÓN, COAH.",2,1,3,0,0,0,
01-mar-17,COAH.,"TORREÓN, COAH.",2,1,3,0,0,0,
03-mar-17,PUE.,"IZUCAR DE MATAMOROS, PUE.",3,0,3,0,0,0,
06-mar-17,TAMPS.,"NUEVO LAREDO, TAMPS.",1,2,3,1,0,406,
08-mar-17,MEX.,"VALLE DE CHALCO SOLIDARIDAD, MEX.",3,0,3,0,0,0,
09-mar-17,MEX.,"VALLE DE CHALCO SOLIDARIDAD, MEX.",3,0,3,0,0,0,
10-mar-17,OAX.,"MIAHUATLAN DE PORFIRIO DIAZ, OAX.",0,3,3,0,0,0,
11-mar-17,TAMPS.,"MATAMOROS, TAMPS.",2,1,3,5,0,50,
12-mar-17,MEX.,"TOLUCA, MEX.",3,0,3,2,0,12,
12-mar-17,MEX.,"TLALNEPANTLA DE BAZ, MEX.",0,3,3,0,0,0,
12-mar-17,QRO.,"QUERETARO, QRO.",3,0,3,0,0,0,
13-mar-17,TAMPS.,"NUEVO LAREDO, TAMPS.",1,2,3,2,0,427,
16-mar-17,DGO.,"CANATLAN, DGO.",2,1,3,0,0,0,
16-mar-17,D.F.,"IZTAPALAPA, D.F.",1,2,3,0,0,0,
16-mar-17,CHIH.,"HGO. DEL PARRAL, CHIH.",2,1,3,0,0,19,
17-mar-17,DGO.,"DGO., DGO.",1,2,3,0,0,0,
17-mar-17,D.F.,"IZTAPALAPA, D.F.",3,0,3,0,0,49,
17-mar-17,D.F.,"IZTAPALAPA, D.F.",3,0,3,49,0,0,
19-mar-17,MEX.,"IXTLAHUACA, MEX.",1,2,3,0,0,0,
21-mar-17,ZAC.,"ZAC., ZAC.",3,0,3,1,0,0,
23-mar-17,ZAC.,"ZAC., ZAC.",2,1,3,0,0,583,
31-mar-17,OAX.,"MIAHUATLAN DE PORFIRIO DIAZ, OAX.",0,3,3,8,0,0,
31-mar-17,D.F.,"TLALPAN, D.F.",2,1,3,0,0,0,
02-abr-17,QRO.,"QUERETARO, QRO.",2,1,3,0,0,0,
06-abr-17,MICH.,"VISTA HERMOSA, MICH.",1,2,3,0,0,7,
06-abr-17,MICH.,"VISTA HERMOSA, MICH.",1,2,3,0,0,7,
07-abr-17,N.L.,"MONTERREY, N.L.",0,3,3,5,0,70,
07-abr-17,TAMPS.,"NUEVO LAREDO, TAMPS.",3,0,3,0,0,244,
07-abr-17,MICH.,"VISTA HERMOSA, MICH.",0,3,3,0,0,0,
12-abr-17,D.F.,"TLALPAN, D.F.",3,0,3,0,0,28,
17-abr-17,S.L.P.,"SAN LUIS POTOSI, S.L.P.",3,0,3,34,0,0,
19-abr-17,SIN.,"MAZATLAN, SIN.",3,0,3,0,6,0,
20-abr-17,SIN.,"MAZATLAN, SIN.",3,0,3,0,0,0,
22-abr-17,S.L.P.,"SAN LUIS POTOSI, S.L.P.",3,0,3,0,1,33,
23-abr-17,D.F.,"TLALPAN, D.F.",2,1,3,0,2,13,
24-abr-17,JAL.,"TLAQUEPAQUE, JAL.",2,1,3,0,0,0,
24-abr-17,MICH.,"LAZARO CARDENAS, MICH.",0,3,3,0,0,0,
25-abr-17,MICH.,"LAZARO CARDENAS, MICH.",3,0,3,0,0,290,
25-abr-17,JAL.,"TLAJOMULCO DE ZUÑIGA, JAL.",1,2,3,0,0,0,
27-abr-17,JAL.,"ZAPOPAN, JAL.",3,0,3,0,0,0,
27-abr-17,N.L.,"GUADALUPE, N.L.",3,0,3,1,0,700,
27-abr-17,SIN.,"ELOTA, SIN.",3,0,3,0,8,0,
28-abr-17,DGO.,"DGO., DGO.",3,0,3,0,0,0,
28-abr-17,TAMPS.,"MATAMOROS, TAMPS.",0,3,3,2,0,233,
30-abr-17,JAL.,"TLAJOMULCO DE ZUÑIGA, JAL.",2,1,3,0,0,0,
01-may-17,JAL.,"TLAJOMULCO DE ZUÑIGA, JAL.",2,1,3,0,0,14,
02-may-17,JAL.,"TLAJOMULCO DE ZUÑIGA, JAL.",2,1,3,0,0,0,
02-may-17,D.F.,"GUSTAVO A. MADERO, D.F.",3,0,3,0,0,0,
03-may-17,N.L.,"GUADALUPE, N.L.",3,0,3,6,0,250,
03-may-17,JAL.,"ZAPOPAN, JAL.",3,0,3,0,0,0,
04-may-17,D.F.,"XOCHIMILCO, D.F.",2,1,3,0,0,7061,
04-may-17,PUE.,"TEHUACAN, PUE.",2,1,3,0,0,2,
05-may-17,D.F.,"XOCHIMILCO, D.F.",3,0,3,0,1,405,
09-may-17,SIN.,"SAN IGNACIO, SIN.",1,2,3,0,0,0,
09-may-17,N.L.,"HGO., N.L.",3,0,3,4,0,0,
10-may-17,COL.,"COL., COL.",3,0,3,0,0,0,
10-may-17,JAL.,"TONALA, JAL.",0,3,3,0,0,0,
10-may-17,Q. ROO,"OTHON P. BLANCO, Q. ROO",2,1,3,0,4,64,
12-may-17,JAL.,"TONALA, JAL.",2,1,3,0,0,0,
12-may-17,D.F.,"AZCAPOTZALCO, D.F.",0,3,3,0,53,0,
12-may-17,GRO.,"ATOYAC DE ALVAREZ, GRO.",3,0,3,0,0,5,
14-may-17,JAL.,"ZAPOPAN, JAL.",3,0,3,0,0,0,
15-may-17,JAL.,"TLAQUEPAQUE, JAL.",3,0,3,0,0,0,
15-may-17,D.F.,"AZCAPOTZALCO, D.F.",0,3,3,0,0,0,
16-may-17,JAL.,"GUADALAJARA, JAL.",1,2,3,0,0,0,
19-may-17,TAMPS.,"MATAMOROS, TAMPS.",2,1,3,8,0,56,
19-may-17,N.L.,"MONTERREY, N.L.",2,1,3,0,0,0,
23-may-17,SIN.,"SIN., SIN.",1,2,3,0,0,0,
24-may-17,JAL.,"TLAJOMULCO DE ZUÑIGA, JAL.",3,0,3,0,0,0,
24-may-17,SIN.,"CONCORDIA, SIN.",2,1,3,0,0,0,
25-may-17,JAL.,"ZAPOPAN, JAL.",3,0,3,0,1,0,
26-may-17,PUE.,"TEHUACAN, PUE.",3,0,3,2,0,0,
27-may-17,TAMPS.,"MATAMOROS, TAMPS.",3,0,3,1,0,0,
28-may-17,TAB.,"CENTRO, TAB.",2,1,3,1,0,22,
29-may-17,JAL.,"ZAPOPAN, JAL.",3,0,3,0,1,0,
30-may-17,TAMPS.,"NUEVO LAREDO, TAMPS.",3,0,3,1,0,49,
01-jun-17,JAL.,"TLAJOMULCO DE ZUÑIGA, JAL.",3,0,3,0,0,38,
01-jun-17,DGO.,"DGO., DGO.",1,2,3,2,3,0,
02-jun-17,D.F.,"CUAUHTEMOC, D.F.",0,3,3,0,0,163,
03-jun-17,GRO.,"ATOYAC DE ALVAREZ, GRO.",1,2,3,3,0,0,
03-jun-17,TAMPS.,"MATAMOROS, TAMPS.",2,1,3,0,0,0,
03-jun-17,QRO.,"COLON, QRO.",3,0,3,0,0,0,
04-jun-17,JAL.,"TLAQUEPAQUE, JAL.",0,3,3,0,0,0,
05-jun-17,MOR.,"CUERNAVACA, MOR.",3,0,3,3,1,519,
06-jun-17,CHIS.,"COMITAN DE DOMÍNGUEZ, CHIS.",1,2,3,2,0,120,
07-jun-17,D.F.,"GUSTAVO A. MADERO, D.F.",3,0,3,0,0,35,
07-jun-17,QRO.,"COLON, QRO.",1,2,3,0,0,0,
08-jun-17,YUC.,"KANASIN, YUC.",3,0,3,0,0,0,
09-jun-17,CHIS.,"COMITAN DE DOMÍNGUEZ, CHIS.",1,2,3,16,0,932,
10-jun-17,CHIS.,"TAPACHULA, CHIS.",2,1,3,40,2,2905,
10-jun-17,JAL.,"TONALA, JAL.",0,3,3,0,0,0,
10-jun-17,JAL.,"TLAJOMULCO DE ZUÑIGA, JAL.",3,0,3,0,0,0,
12-jun-17,ZAC.,"VILLA DE COS, ZAC.",1,2,3,0,0,0,
12-jun-17,ZAC.,"GENERAL FRANCISCO R. MURGUIA, ZAC.",1,2,3,0,0,0,
13-jun-17,GTO.,"PURISIMA DEL RINCON, GTO.",3,0,3,0,0,0,
14-jun-17,SIN.,"SALVADOR ALVARADO, SIN.",2,1,3,0,6,0,
14-jun-17,COAH.,"SALTILLO, COAH.",2,1,3,0,2,27,
14-jun-17,GTO.,"PURISIMA DEL RINCON, GTO.",1,2,3,0,0,0,
14-jun-17,MEX.,"CUAUTITLAN IZCALLI, MEX.",3,0,3,1,0,0,
14-jun-17,TLAX.,"SAN PABLO DEL MONTE, TLAX.",1,2,3,0,0,0,
17-jun-17,TAMPS.,"MATAMOROS, TAMPS.",2,1,3,2,0,203,
19-jun-17,JAL.,"ZAPOPAN, JAL.",3,0,3,0,0,295,
19-jun-17,COAH.,"SALTILLO, COAH.",3,0,3,0,0,24,
20-jun-17,DGO.,"DGO., DGO.",3,0,3,2,0,0,
21-jun-17,COAH.,"TORREÓN, COAH.",1,2,3,0,0,0,
21-jun-17,MOR.,"TEPOZTLAN, MOR.",3,0,3,0,0,287,
21-jun-17,SIN.,"CHOIX, SIN.",2,1,3,0,0,0,
22-jun-17,COAH.,"TORREÓN, COAH.",1,2,3,0,0,0,
23-jun-17,B.C.,"TIJUANA, B.C.",0,3,3,0,0,0,
23-jun-17,D.F.,"GUSTAVO A. MADERO, D.F.",3,0,3,0,0,0,
23-jun-17,YUC.,"PROGRESO, YUC.",2,1,3,0,0,0,
23-jun-17,TAMPS.,"MATAMOROS, TAMPS.",2,1,3,5,0,0,
24-jun-17,B.C.,"TIJUANA, B.C.",0,3,3,0,0,0,
24-jun-17,JAL.,"ZAPOPAN, JAL.",1,2,3,0,0,1700,
26-jun-17,B.C.,"TIJUANA, B.C.",0,3,3,0,0,0,
26-jun-17,SIN.,"CHOIX, SIN.",2,1,3,0,0,0,
29-jun-17,COAH.,"SAN PEDRO, COAH.",1,2,3,0,0,0,
30-jun-17,COAH.,"TORREÓN, COAH.",2,1,3,0,0,0,
30-jun-17,COAH.,"SALTILLO, COAH.",3,0,3,0,0,0,
30-jun-17,JAL.,"ZAPOTLANEJO, JAL.",1,2,3,0,0,98,
30-jun-17,MICH.,"BUENAVISTA, MICH.",3,0,3,0,0,0,
01-jul-17,TLAX.,"ZACATELCO, TLAX.",1,2,3,0,0,0,
01-jul-17,JAL.,"EL SALTO, JAL.",0,3,3,8,0,39,
01-jul-17,TAMPS.,"MATAMOROS, TAMPS.",0,3,3,0,0,0,
02-jul-17,N.L.,"MARIN, N.L.",0,3,3,0,0,385,
03-jul-17,D.F.,"IZTAPALAPA, D.F.",2,1,3,0,0,47,
03-jul-17,MICH.,"BUENAVISTA, MICH.",3,0,3,0,0,0,
03-jul-17,B.C.,"TIJUANA, B.C.",1,2,3,0,0,0,
03-jul-17,TAMPS.,"REYNOSA, TAMPS.",0,3,3,0,0,0,
04-jul-17,TAMPS.,"TAMPICO, TAMPS.",3,0,3,0,0,76,
05-jul-17,TLAX.,"NATIVITAS, TLAX.",0,3,3,0,0,0,
05-jul-17,D.F.,"IZTAPALAPA, D.F.",2,1,3,0,0,98,
05-jul-17,JAL.,"EL SALTO, JAL.",3,0,3,0,0,0,
06-jul-17,AGS.,"EL LLANO, AGS.",3,0,3,0,0,0,
07-jul-17,COAH.,"MONCLOVA, COAH.",3,0,3,3,0,33,
09-jul-17,MEX.,"NOPALTEPEC, MEX.",2,1,3,0,0,0,
09-jul-17,JAL.,"ZAPOTLANEJO, JAL.",3,0,3,0,0,47,
10-jul-17,TLAX.,"SANTA ANA NOPALUCAN, TLAX.",0,3,3,0,0,0,
11-jul-17,TAMPS.,"TAMPICO, TAMPS.",1,2,3,6,0,139,
12-jul-17,CHIS.,"CHIAPA DE CORZO, CHIS.",2,1,3,0,0,120,
12-jul-17,MEX.,"ATLACOMULCO, MEX.",2,1,3,0,0,26,
12-jul-17,B.C.,"TIJUANA, B.C.",0,3,3,0,0,0,
12-jul-17,TLAX.,"TLAX., TLAX.",2,1,3,1,0,2,
13-jul-17,COAH.,"TORREÓN, COAH.",2,1,3,0,0,50,
15-jul-17,TAMPS.,"MATAMOROS, TAMPS.",0,3,3,6,0,150,
16-jul-17,MEX.,"ATLACOMULCO, MEX.",3,0,3,0,0,0,
18-jul-17,TLAX.,"TLAX., TLAX.",1,2,3,0,0,0,
19-jul-17,B.C.,"TIJUANA, B.C.",1,2,3,0,2,0,
19-jul-17,MEX.,"TENANGO DEL AIRE, MEX.",3,0,3,0,0,65,
20-jul-17,COAH.,"NUEVA ROSITA, COAH.",1,2,3,0,0,0,
20-jul-17,MOR.,"TEPOZTLAN, MOR.",2,1,3,7,2,0,
21-jul-17,TLAX.,"SANTA ANA NOPALUCAN, TLAX.",0,3,3,0,0,0,
23-jul-17,MEX.,"ATENCO, MEX.",2,1,3,0,0,0,
24-jul-17,COAH.,"MÚZQUIZ, COAH.",2,1,3,0,0,0,
24-jul-17,GRO.,"JUAN R. ESCUDERO, GRO.",1,2,3,0,0,0,
26-jul-17,MICH.,"BUENAVISTA, MICH.",2,1,3,0,0,0,
28-jul-17,D.F.,"AZCAPOTZALCO, D.F.",2,1,3,0,0,0,
28-jul-17,MEX.,"VILLA DEL CARBON, MEX.",2,1,3,0,0,51,
30-jul-17,TAMPS.,"MATAMOROS, TAMPS.",0,3,3,165,0,0,
31-jul-17,D.F.,"MIGUEL HGO., D.F.",2,1,3,0,0,0,
31-jul-17,AGS.,"AGS., AGS.",3,0,3,4,0,0,
31-jul-17,D.F.,"MIGUEL HGO., D.F.",2,1,3,0,0,0,
01-ago-17,COAH.,"SALTILLO, COAH.",3,0,3,0,0,0,
02-ago-17,MEX.,"SOYANIQUILPAN DE JUAREZ, MEX.",2,1,3,0,0,0,
03-ago-17,CHIS.,"TAPACHULA, CHIS.",2,1,3,2,0,20,
03-ago-17,AGS.,"AGS., AGS.",3,0,3,9,0,0,
04-ago-17,COAH.,"SABINAS, COAH.",0,3,3,0,0,0,
04-ago-17,COAH.,"SALTILLO, COAH.",3,0,3,0,0,84,
04-ago-17,CHIS.,"TAPACHULA, CHIS.",1,2,3,0,0,145,
04-ago-17,D.F.,"MIGUEL HGO., D.F.",2,1,3,0,0,0,
06-ago-17,MEX.,"TLALMANALCO, MEX.",2,1,3,1,0,429,
07-ago-17,QRO.,"EL MARQUES, QRO.",1,2,3,0,0,29,
07-ago-17,MOR.,"EMILIANO ZAPATA, MOR.",0,3,3,0,0,0,
07-ago-17,S.L.P.,"SAN LUIS POTOSI, S.L.P.",3,0,3,2,0,0,
08-ago-17,B.C.,"TIJUANA, B.C.",0,3,3,0,0,0,
09-ago-17,CHIS.,"TUXTLA GUTIÉRREZ, CHIS.",1,2,3,1,0,211,
10-ago-17,COAH.,"SALTILLO, COAH.",3,0,3,1,0,0,
11-ago-17,SIN.,"EL FUERTE, SIN.",3,0,3,0,0,0,
11-ago-17,D.F.,"MIGUEL HGO., D.F.",3,0,3,0,0,0,
11-ago-17,S.L.P.,"SAN LUIS POTOSI, S.L.P.",3,0,3,0,0,0,
13-ago-17,MEX.,"AMECAMECA, MEX.",2,1,3,0,0,6,
14-ago-17,B.C.,"MEXICALI, B.C.",2,1,3,0,0,0,
14-ago-17,GRO.,"ATOYAC DE ALVAREZ, GRO.",3,0,3,0,0,0,
14-ago-17,S.L.P.,"SAN LUIS POTOSI, S.L.P.",3,0,3,0,0,0,
16-ago-17,COAH.,"SALTILLO, COAH.",2,1,3,4,0,0,
16-ago-17,MEX.,"CHICONCUAC, MEX.",0,3,3,0,0,0,
17-ago-17,S.L.P.,"SAN LUIS POTOSI, S.L.P.",3,0,3,3,0,46,
17-ago-17,MEX.,"CHICONCUAC, MEX.",2,1,3,0,0,11,
17-ago-17,CHIS.,"TUXTLA GUTIÉRREZ, CHIS.",1,2,3,0,0,10,
22-ago-17,SIN.,"COSALA, SIN.",2,1,3,0,0,0,
23-ago-17,B.C.,"TIJUANA, B.C.",1,2,3,0,0,0,
23-ago-17,D.F.,"VENUSTIANO CARRANZA, D.F.",3,0,3,0,0,514,
25-ago-17,SIN.,"ANGOSTURA, SIN.",1,2,3,0,0,0,
25-ago-17,MEX.,"IXTAPALUCA, MEX.",3,0,3,0,0,0,
25-ago-17,N.L.,"MONTERREY, N.L.",1,2,3,7,0,79,
26-ago-17,S.L.P.,"SAN LUIS POTOSI, S.L.P.",3,0,3,8,0,180,
27-ago-17,COAH.,"SALTILLO, COAH.",3,0,3,0,0,30,
28-ago-17,S.L.P.,"SAN LUIS POTOSI, S.L.P.",2,1,3,2,0,0,
28-ago-17,GRO.,"ATOYAC DE ALVAREZ, GRO.",3,0,3,5,0,63,
29-ago-17,DGO.,"DGO., DGO.",3,0,3,2,0,0,
30-ago-17,N.L.,"MONTERREY, N.L.",0,3,3,0,0,77,
01-sep-17,MEX.,"XALATLACO, MEX.",0,3,3,0,0,0,
03-sep-17,MEX.,"TULTITLAN, MEX.",3,0,3,0,0,0,
06-sep-17,COAH.,"TORREÓN, COAH.",3,0,3,0,0,316,
09-sep-17,B.C.,"ENSENADA, B.C.",1,2,3,0,0,0,
10-sep-17,MEX.,"HUIXQUILUCAN, MEX.",2,1,3,1,0,1000,
10-sep-17,QRO.,"PINAL DE AMOLES, QRO.",2,1,3,0,0,0,
11-sep-17,ZAC.,"TRANCOSO, ZAC.",3,0,3,0,0,830,
11-sep-17,GTO.,"GTO., GTO.",3,0,3,0,0,0,
12-sep-17,COAH.,"RAMOS ARIZPE, COAH.",3,0,3,0,4,0,
12-sep-17,JAL.,"PUERTO VALLARTA, JAL.",1,2,3,0,0,0,
13-sep-17,CHIH.,"GUADALUPE, CHIH.",0,3,3,1,0,63,
14-sep-17,COAH.,"RAMOS ARIZPE, COAH.",3,0,3,0,0,0,
15-sep-17,N.L.,"MONTERREY, N.L.",3,0,3,0,0,0,
15-sep-17,N.L.,"LINARES, N.L.",2,1,3,0,1,35,
18-sep-17,DGO.,"DGO., DGO.",2,1,3,3,0,0,
18-sep-17,ZAC.,"GUADALUPE, ZAC.",2,1,3,0,0,220,
18-sep-17,ZAC.,"FRESNILLO, ZAC.",3,0,3,1,0,301,
18-sep-17,ZAC.,"TLALTENANGO DE SANCHEZ ROMAN, ZAC.",3,0,3,0,0,5,
18-sep-17,N.L.,"LINARES, N.L.",3,0,3,0,0,0,
19-sep-17,N.L.,"MONTERREY, N.L.",2,1,3,0,0,0,
22-sep-17,COAH.,"RAMOS ARIZPE, COAH.",3,0,3,2,2,0,
22-sep-17,TAMPS.,"MATAMOROS, TAMPS.",1,2,3,2,0,176,
22-sep-17,AGS.,"AGS., AGS.",3,0,3,0,0,0,
24-sep-17,MEX.,"TEPOTZOTLAN, MEX.",1,2,3,3,0,69,
24-sep-17,DGO.,"DGO., DGO.",2,1,3,0,0,0,
25-sep-17,SIN.,"MOCORITO, SIN.",2,1,3,0,0,0,
25-sep-17,N.L.,"MONTERREY, N.L.",3,0,3,1,0,42,
25-sep-17,N.L.,"LINARES, N.L.",2,1,3,0,0,0,
27-sep-17,JAL.,"PUERTO VALLARTA, JAL.",1,2,3,0,0,0,
27-sep-17,ZAC.,"ZAC., ZAC.",2,1,3,0,0,8,
27-sep-17,SON.,"HERMOSILLO, SON.",2,1,3,4,0,48,
28-sep-17,SON.,"HERMOSILLO, SON.",2,1,3,4,0,36,
02-oct-17,N.L.,"MONTERREY, N.L.",3,0,3,1,0,0,
03-oct-17,ZAC.,"GUADALUPE, ZAC.",3,0,3,0,0,0,
05-oct-17,ZAC.,"JEREZ, ZAC.",2,1,3,1,0,5,
06-oct-17,TAMPS.,"MATAMOROS, TAMPS.",1,2,3,6,0,268,
09-oct-17,SON.,"HERMOSILLO, SON.",2,1,3,0,0,41,
10-oct-17,B.C.,"MEXICALI, B.C.",3,0,3,0,0,0,
10-oct-17,B.C.,"TIJUANA, B.C.",3,0,3,0,0,0,
10-oct-17,SIN.,"CULIACAN, SIN.",3,0,3,0,0,0,
10-oct-17,SON.,"HERMOSILLO, SON.",2,1,3,1,0,125,
11-oct-17,SIN.,"CULIACAN, SIN.",3,0,3,0,0,0,
11-oct-17,ZAC.,"GUADALUPE, ZAC.",3,0,3,0,0,0,
11-oct-17,ZAC.,"GUADALUPE, ZAC.",3,0,3,0,0,364,
13-oct-17,B.C.,"TIJUANA, B.C.",0,3,3,0,0,0,
16-oct-17,ZAC.,"GUADALUPE, ZAC.",3,0,3,0,0,0,
18-oct-17,D.F.,"LA MAGDALENA CONTRERAS, D.F.",3,0,3,0,0,0,
19-oct-17,D.F.,"LA MAGDALENA CONTRERAS, D.F.",1,2,3,0,0,0,
20-oct-17,SIN.,"CULIACAN, SIN.",3,0,3,0,0,0,
20-oct-17,AGS.,"AGS., AGS.",3,0,3,0,0,0,
24-oct-17,B.C.,"MEXICALI, B.C.",3,0,3,0,0,0,
26-oct-17,SIN.,"GUASAVE, SIN.",3,0,3,0,0,0,
27-oct-17,D.F.,"LA MAGDALENA CONTRERAS, D.F.",2,1,3,0,4,0,
31-oct-17,D.F.,"ALVARO OBREGON, D.F.",3,0,3,0,4,0,
31-oct-17,AGS.,"AGS., AGS.",3,0,3,2,0,0,
03-nov-17,D.F.,"ALVARO OBREGON, D.F.",2,1,3,0,1,279,
05-nov-17,S.L.P.,"SAN LUIS POTOSI, S.L.P.",3,0,3,0,0,0,
05-nov-17,ZAC.,"GUADALUPE, ZAC.",2,1,3,0,0,110,
06-nov-17,S.L.P.,"SAN LUIS POTOSI, S.L.P.",3,0,3,0,0,0,
08-nov-17,ZAC.,"FRESNILLO, ZAC.",3,0,3,6,0,106,
09-nov-17,B.C.,"TIJUANA, B.C.",3,0,3,0,0,0,
09-nov-17,D.F.,"ALVARO OBREGON, D.F.",1,2,3,0,0,116,
15-nov-17,SIN.,"MAZATLAN, SIN.",1,2,3,0,0,0,
17-nov-17,COAH.,"ACUÑA, COAH.",3,0,3,0,0,0,
17-nov-17,ZAC.,"FRESNILLO, ZAC.",1,2,3,3,0,0,
17-nov-17,SIN.,"MAZATLAN, SIN.",3,0,3,0,0,0,
23-nov-17,GTO.,"CELAYA, GTO.",1,2,3,0,0,0,
24-nov-17,B.C.,"MEXICALI, B.C.",0,3,3,0,0,0,
01-dic-17,ZAC.,"GUADALUPE, ZAC.",1,2,3,51,0,0,
02-dic-17,ZAC.,"GUADALUPE, ZAC.",1,2,3,51,0,0,
06-dic-17,D.F.,"IZTACALCO, D.F.",1,2,3,0,4,9,
09-dic-17,TAMPS.,"MATAMOROS, TAMPS.",0,3,3,3,0,400,
14-dic-17,DGO.,"DGO., DGO.",2,1,3,25,0,0,
20-dic-17,HGO.,"HUEJUTLA DE REYES, HGO.",2,1,3,0,0,0,
21-dic-17,DGO.,"DGO., DGO.",2,1,3,0,1,0,
22-dic-17,B.C.,"MEXICALI, B.C.",1,2,3,0,0,0,
28-dic-17,B.C.,"MEXICALI, B.C.",0,3,3,0,0,0,
29-dic-17,B.C.,"TIJUANA, B.C.",3,0,3,0,0,0,
03-ene-18,DGO.,"DGO., DGO.",0,3,3,0,1,0,
09-ene-18,COAH.,"MONCLOVA, COAH.",3,0,3,1,0,78,
10-ene-18,COAH.,"SALTILLO, COAH.",2,1,3,1,0,270,
11-ene-18,COAH.,"PIEDRAS NEGRAS, COAH.",0,3,3,0,0,20,
19-ene-18,B.C.,"TIJUANA, B.C.",3,0,3,0,0,0,
22-ene-18,B.C.,"TIJUANA, B.C.",3,0,3,0,0,0,
23-ene-18,COAH.,"SALTILLO, COAH.",3,0,3,1,0,58,
24-ene-18,GTO.,"IRAPUATO, GTO.",1,2,3,0,2,10,
24-ene-18,COAH.,"SALTILLO, COAH.",3,0,3,0,0,31,
24-ene-18,COAH.,"MONCLOVA, COAH.",2,1,3,1,0,64,
25-ene-18,GTO.,"IRAPUATO, GTO.",1,2,3,0,1,50,
25-ene-18,COAH.,"MÚZQUIZ, COAH.",1,2,3,2,0,0,
29-ene-18,ZAC.,"ZAC., ZAC.",3,0,3,29,0,33,
29-ene-18,DGO.,"GOMEZ PALACIO, DGO.",3,0,3,0,0,0,
29-ene-18,COAH.,"TORREÓN, COAH.",2,1,3,0,0,0,
29-ene-18,COAH.,"PIEDRAS NEGRAS, COAH.",0,3,3,0,0,0,
30-ene-18,COAH.,"PIEDRAS NEGRAS, COAH.",1,2,3,0,0,0,
31-ene-18,COAH.,"SALTILLO, COAH.",3,0,3,2,0,74,
31-ene-18,COAH.,"PIEDRAS NEGRAS, COAH.",1,2,3,0,0,0,
31-ene-18,ZAC.,"ZAC., ZAC.",2,1,3,29,0,0,
02-feb-18,COAH.,"MÚZQUIZ, COAH.",2,1,3,1,0,0,
02-feb-18,COAH.,"ACUÑA, COAH.",2,1,3,0,0,0,
02-feb-18,DGO.,"GOMEZ PALACIO, DGO.",3,0,3,0,0,0,
06-feb-18,ZAC.,"ZAC., ZAC.",3,0,3,0,0,0,
08-feb-18,D.F.,"TLAHUAC, D.F.",2,1,3,0,0,0,
08-feb-18,COAH.,"MONCLOVA, COAH.",2,1,3,5,0,200,
10-feb-18,COAH.,"SABINAS, COAH.",1,2,3,0,0,0,
12-feb-18,COAH.,"SALTILLO, COAH.",2,1,3,0,0,2155,
13-feb-18,COAH.,"SALTILLO, COAH.",2,1,3,0,0,45,
13-feb-18,COAH.,"PIEDRAS NEGRAS, COAH.",2,1,3,0,0,81,
13-feb-18,COAH.,"SABINAS, COAH.",1,2,3,0,0,0,
14-feb-18,ZAC.,"ZAC., ZAC.",2,1,3,15,0,0,
14-feb-18,COAH.,"TORREÓN, COAH.",3,0,3,0,0,0,
15-feb-18,DGO.,"GOMEZ PALACIO, DGO.",3,0,3,0,0,0,
15-feb-18,GRO.,"ACAPULCO DE JUAREZ, GRO.",2,1,3,0,12,1028,
17-feb-18,COAH.,"MÚZQUIZ, COAH.",2,1,3,5,0,0,
20-feb-18,D.F.,"IZTAPALAPA, D.F.",3,0,3,0,0,0,
20-feb-18,COAH.,"PIEDRAS NEGRAS, COAH.",0,3,3,2,0,135,
20-feb-18,TAMPS.,"NUEVO LAREDO, TAMPS.",2,1,3,1,0,0,
23-feb-18,COAH.,"MONCLOVA, COAH.",2,1,3,0,1,52,
23-feb-18,COAH.,"PIEDRAS NEGRAS, COAH.",2,1,3,0,0,145,
26-feb-18,S.L.P.,"CIUDAD VALLES, S.L.P.",2,1,3,3,0,0,
26-feb-18,D.F.,"IZTAPALAPA, D.F.",3,0,3,0,0,0,
28-feb-18,COAH.,"RAMOS ARIZPE, COAH.",3,0,3,11,2,481,
28-feb-18,COAH.,"MONCLOVA, COAH.",2,1,3,0,0,0,
07-mar-18,COAH.,"PIEDRAS NEGRAS, COAH.",3,0,3,2,0,149,
08-mar-18,COAH.,"TORREÓN, COAH.",2,1,3,20,0,338,
08-mar-18,S.L.P.,"SAN LUIS POTOSI, S.L.P.",3,0,3,0,0,0,
08-mar-18,COAH.,"FRANCISCO I. MADERO, COAH.",1,2,3,0,0,338,
08-mar-18,DGO.,"LERDO, DGO.",1,2,3,0,0,0,
09-mar-18,COAH.,"MONCLOVA, COAH.",2,1,3,1,0,158,
09-mar-18,DGO.,"LERDO, DGO.",3,0,3,0,0,0,
09-mar-18,S.L.P.,"SAN LUIS POTOSI, S.L.P.",3,0,3,0,0,0,
10-mar-18,S.L.P.,"SAN LUIS POTOSI, S.L.P.",1,2,3,3,0,0,
12-mar-18,COAH.,"TORREÓN, COAH.",1,2,3,0,0,0,
13-mar-18,S.L.P.,"SAN LUIS POTOSI, S.L.P.",2,1,3,0,0,0,
14-mar-18,COAH.,"PIEDRAS NEGRAS, COAH.",3,0,3,1,0,0,
16-mar-18,SIN.,"ELOTA, SIN.",2,1,3,0,0,0,
19-mar-18,SIN.,"MAZATLAN, SIN.",1,2,3,0,0,0,
21-mar-18,S.L.P.,"SAN LUIS POTOSI, S.L.P.",1,2,3,0,0,0,
22-mar-18,COAH.,"TORREÓN, COAH.",2,1,3,6,0,0,
22-mar-18,COAH.,"SALTILLO, COAH.",3,0,3,0,0,0,
23-mar-18,QRO.,"QUERETARO, QRO.",2,1,3,0,0,0,
24-mar-18,QRO.,"QUERETARO, QRO.",2,1,3,1,0,0,
25-mar-18,QRO.,"QUERETARO, QRO.",1,2,3,0,0,26,
10-jul-18,B.C.,"TIJUANA, B.C.",3,0,3,0,0,0,
11-jul-18,B.C.,"TIJUANA, B.C.",3,0,3,0,0,0,
13-jul-18,N.L.,"SALINAS VICTORIA, N.L.",0,3,3,3,0,0,
20-jul-18,TAMPS.,"NUEVO LAREDO, TAMPS.",0,3,3,1,0,236,
20-jul-18,GTO.,"IRAPUATO, GTO.",3,0,3,2,0,32,
22-jul-18,TAMPS.,"MATAMOROS, TAMPS.",1,2,3,0,0,333,
23-jul-18,GTO.,"IRAPUATO, GTO.",3,0,3,0,0,22,
25-jul-18,B.C.,"TIJUANA, B.C.",3,0,3,0,0,0,
26-jul-18,TLAX.,"PANOTLA, TLAX.",0,3,3,0,0,0,
27-jul-18,N.L.,"MONTERREY, N.L.",2,1,3,1,0,0,
27-jul-18,TLAX.,"CHIAUTEMPAN, TLAX.",3,0,3,1,0,0,
28-jul-18,B.C.,"TIJUANA, B.C.",3,0,3,0,0,0,
29-jul-18,TAMPS.,"MATAMOROS, TAMPS.",2,1,3,0,0,0,
31-jul-18,GTO.,"IRAPUATO, GTO.",1,2,3,0,4,7,
31-jul-18,GTO.,"CELAYA, GTO.",2,1,3,0,0,0,
02-ago-18,GTO.,"CELAYA, GTO.",2,1,3,0,0,0,
02-ago-18,N.L.,"APODACA, N.L.",2,1,3,20,12,1152,
04-ago-18,TAMPS.,"MATAMOROS, TAMPS.",3,0,3,0,0,146,
06-ago-18,CHIS.,"TAPACHULA, CHIS.",2,1,3,0,0,167,
06-ago-18,TAMPS.,"NUEVO LAREDO, TAMPS.",1,2,3,0,0,28,
07-ago-18,MEX.,"CHALCO, MEX.",2,1,3,0,0,678,
07-ago-18,QRO.,"QUERETARO, QRO.",2,1,3,0,0,0,
08-ago-18,CHIH.,"HGO. DEL PARRAL, CHIH.",3,0,3,0,0,1366,
09-ago-18,N.L.,"MONTERREY, N.L.",1,2,3,2,0,26,
09-ago-18,COAH.,"SABINAS, COAH.",0,3,3,0,0,0,
09-ago-18,MEX.,"ZUMPANGO, MEX.",2,1,3,0,1,72,
10-ago-18,MEX.,"ZUMPANGO, MEX.",3,0,3,0,0,124,
11-ago-18,MEX.,"ATIZAPAN, MEX.",2,1,3,0,0,252,
11-ago-18,MEX.,"ATLACOMULCO, MEX.",3,0,3,0,0,346,
11-ago-18,TLAX.,"EL CARMEN TEQUEXQUITLA, TLAX.",3,0,3,1,0,0,
11-ago-18,CHIS.,"TAPACHULA, CHIS.",1,2,3,2,0,509,
11-ago-18,TAB.,"TENOSIQUE, TAB.",3,0,3,0,0,0,
13-ago-18,TLAX.,"IXTACUIXTLA DE MARIANO MATAMOROS, TLAX.",0,3,3,0,0,0,
14-ago-18,MEX.,"ATIZAPAN, MEX.",3,0,3,1,0,256,
15-ago-18,B.C.,"TIJUANA, B.C.",3,0,3,0,0,0,
15-ago-18,COAH.,"MATAMOROS, COAH.",3,0,3,0,0,0,
15-ago-18,COAH.,"SALTILLO, COAH.",3,0,3,0,1,0,
15-ago-18,COAH.,"PIEDRAS NEGRAS, COAH.",0,3,3,3,0,80,
15-ago-18,GTO.,"CELAYA, GTO.",1,2,3,0,0,137,
16-ago-18,COAH.,"SAN PEDRO, COAH.",3,0,3,0,0,0,
16-ago-18,COAH.,"TORREÓN, COAH.",3,0,3,0,0,0,
16-ago-18,TAMPS.,"MATAMOROS, TAMPS.",2,1,3,0,0,1,
16-ago-18,MEX.,"CHALCO, MEX.",2,1,3,0,0,123,
16-ago-18,MEX.,"CUAUTITLAN IZCALLI, MEX.",2,1,3,0,0,109,
16-ago-18,TAMPS.,"REYNOSA, TAMPS.",2,1,3,3,0,364,
17-ago-18,B.C.,"TIJUANA, B.C.",1,2,3,0,0,0,
17-ago-18,COAH.,"TORREÓN, COAH.",3,0,3,0,0,0,
17-ago-18,TAMPS.,"CIUDAD MADERO, TAMPS.",2,1,3,0,0,559,
17-ago-18,MEX.,"CHALCO, MEX.",2,1,3,0,1,83,
18-ago-18,CHIS.,"TUXTLA GUTIÉRREZ, CHIS.",1,2,3,0,0,0,
18-ago-18,TAMPS.,"REYNOSA, TAMPS.",2,1,3,2,0,80,
20-ago-18,SIN.,"CHOIX, SIN.",2,1,3,0,0,0,
20-ago-18,TAMPS.,"VICTORIA, TAMPS.",2,1,3,2,0,35,
21-ago-18,CHIH.,"HGO. DEL PARRAL, CHIH.",3,0,3,0,0,30,
21-ago-18,MEX.,"ZACUALPAN, MEX.",1,2,3,1,0,0,
22-ago-18,COAH.,"MÚZQUIZ, COAH.",1,2,3,4,0,0,
23-ago-18,ZAC.,"FRESNILLO, ZAC.",2,1,3,0,0,31,
23-ago-18,COAH.,"TORREÓN, COAH.",3,0,3,0,0,36,
23-ago-18,ZAC.,"ZAC., ZAC.",3,0,3,1,0,56,
25-ago-18,TLAX.,"PANOTLA, TLAX.",1,2,3,0,0,0,
27-ago-18,COAH.,"SALTILLO, COAH.",2,1,3,1,2,480,
27-ago-18,MEX.,"IXTAPAN DE LA SAL, MEX.",1,2,3,1,0,0,
27-ago-18,MEX.,"TLALNEPANTLA DE BAZ, MEX.",1,2,3,0,0,34,
27-ago-18,MEX.,"CHIMALHUACAN, MEX.",2,1,3,0,0,0,
28-ago-18,MEX.,"CHICOLOAPAN, MEX.",1,2,3,0,0,0,
29-ago-18,B.C.,"TIJUANA, B.C.",3,0,3,0,2,0,
31-ago-18,AGS.,"AGS., AGS.",2,1,3,0,0,0,
31-ago-18,MEX.,"CHICOLOAPAN, MEX.",2,1,3,0,0,546,
31-ago-18,N.L.,"APODACA, N.L.",1,2,3,45,0,0,
03-sep-18,D.F.,"AZCAPOTZALCO, D.F.",3,0,3,0,0,3828,
04-sep-18,B.C.,"TIJUANA, B.C.",2,1,3,0,0,0,
05-sep-18,B.C.,"TIJUANA, B.C.",0,3,3,0,0,0,
05-sep-18,D.F.,"AZCAPOTZALCO, D.F.",3,0,3,0,0,83,
07-sep-18,AGS.,"AGS., AGS.",1,2,3,2,0,10,
08-sep-18,TAMPS.,"REYNOSA, TAMPS.",3,0,3,3,0,0,
08-sep-18,B.C.,"MEXICALI, B.C.",0,3,3,0,0,0,
10-sep-18,B.C.,"TIJUANA, B.C.",0,3,3,0,0,0,
10-sep-18,ZAC.,"FRESNILLO, ZAC.",2,1,3,0,0,2,
10-sep-18,AGS.,"AGS., AGS.",3,0,3,4,0,11,
18-sep-18,ZAC.,"GUADALUPE, ZAC.",2,1,3,0,0,0,
18-sep-18,ZAC.,"FRESNILLO, ZAC.",3,0,3,0,0,20,
18-sep-18,AGS.,"AGS., AGS.",3,0,3,3,0,0,
18-sep-18,PUE.,"CHIAUTZINGO, PUE.",1,2,3,0,0,0,
19-sep-18,MEX.,"NEZAHUALCOYOTL, MEX.",3,0,3,0,0,200,
20-sep-18,COAH.,"TORREÓN, COAH.",1,2,3,0,0,16,
21-sep-18,COAH.,"TORREÓN, COAH.",3,0,3,0,0,84,
21-sep-18,AGS.,"AGS., AGS.",3,0,3,4,0,10,
22-sep-18,MEX.,"NEZAHUALCOYOTL, MEX.",3,0,3,2,0,901,
24-sep-18,MEX.,"CHAPA DE MOTA, MEX.",2,1,3,0,0,0,
24-sep-18,COAH.,"ACUÑA, COAH.",3,0,3,0,0,122,
26-sep-18,MEX.,"ECATEPEC DE MOR., MEX.",3,0,3,0,0,11,
27-sep-18,MEX.,"ECATEPEC DE MOR., MEX.",3,0,3,0,0,8,
28-sep-18,MEX.,"ECATEPEC DE MOR., MEX.",2,1,3,0,0,0,
29-sep-18,MEX.,"IXTAPALUCA, MEX.",2,1,3,0,0,50,
01-oct-18,COAH.,"TORREÓN, COAH.",3,0,3,0,0,0,
04-oct-18,ZAC.,"FRESNILLO, ZAC.",3,0,3,0,0,0,
04-oct-18,GTO.,"LEON, GTO.",2,1,3,0,2,0,
06-oct-18,TAB.,"TENOSIQUE, TAB.",2,1,3,0,0,71,
08-oct-18,MEX.,"COACALCO DE BERRIOZABAL, MEX.",3,0,3,0,0,296,
09-oct-18,ZAC.,"GUADALUPE, ZAC.",3,0,3,6,0,41,
09-oct-18,AGS.,"AGS., AGS.",3,0,3,0,0,0,
10-oct-18,D.F.,"MIGUEL HGO., D.F.",2,1,3,0,0,2261,
10-oct-18,MEX.,"NAUCALPAN DE JUAREZ, MEX.",1,2,3,1,0,0,
10-oct-18,N.L.,"MELCHOR OCAMPO, N.L.",2,1,3,0,0,20,
11-oct-18,AGS.,"AGS., AGS.",2,1,3,1,0,0,
17-oct-18,MEX.,"HUEHUETOCA, MEX.",2,1,3,0,0,37,
18-oct-18,MEX.,"ATIZAPAN, MEX.",2,1,3,0,0,91,
19-oct-18,MEX.,"NAUCALPAN DE JUAREZ, MEX.",3,0,3,1,0,67,
19-oct-18,COAH.,"ACUÑA, COAH.",3,0,3,0,0,0,
19-oct-18,D.F.,"VENUSTIANO CARRANZA, D.F.",2,1,3,0,0,3591,
22-oct-18,MEX.,"TECAMAC, MEX.",2,1,3,0,0,0,
23-oct-18,GTO.,"LEON, GTO.",3,0,3,0,1,0,
23-oct-18,MEX.,"ALMOLOYA DE JUAREZ, MEX.",3,0,3,0,0,98,
23-oct-18,MEX.,"TECAMAC, MEX.",3,0,3,3,0,723,
24-oct-18,COAH.,"MÚZQUIZ, COAH.",2,1,3,1,0,0,
24-oct-18,S.L.P.,"SAN LUIS POTOSI, S.L.P.",2,1,3,0,0,0,
24-oct-18,MOR.,"CUERNAVACA, MOR.",2,1,3,0,0,0,
26-oct-18,MEX.,"TECAMAC, MEX.",3,0,3,1,5,5508,
27-oct-18,S.L.P.,"SAN LUIS POTOSI, S.L.P.",3,0,3,0,0,0,
28-oct-18,S.L.P.,"SAN LUIS POTOSI, S.L.P.",1,2,3,3,0,0,
03-nov-18,N.L.,"MONTERREY, N.L.",3,0,3,0,0,0,
05-nov-18,N.L.,"MONTERREY, N.L.",3,0,3,0,0,0,
05-nov-18,MEX.,"CUAUTITLAN IZCALLI, MEX.",2,1,3,2,0,288,
06-nov-18,MEX.,"VALLE DE CHALCO SOLIDARIDAD, MEX.",3,0,3,2,1,597,
07-nov-18,MEX.,"METEPEC, MEX.",2,1,3,1,0,4807,
07-nov-18,COAH.,"TORREÓN, COAH.",3,0,3,0,0,0,
07-nov-18,D.F.,"COYOACAN, D.F.",3,0,3,0,0,5120,
10-nov-18,MEX.,"VALLE DE CHALCO SOLIDARIDAD, MEX.",3,0,3,0,0,0,
13-nov-18,N.L.,"MONTERREY, N.L.",1,2,3,1,0,0,
16-nov-18,MEX.,"EL ORO, MEX.",1,2,3,0,4,0,
17-nov-18,MEX.,"EL ORO, MEX.",3,0,3,0,0,0,
21-nov-18,COAH.,"TORREÓN, COAH.",0,3,3,3,0,0,
22-nov-18,ZAC.,"FRESNILLO, ZAC.",3,0,3,14,0,30,
22-nov-18,MEX.,"SAN MARTIN DE LAS PIRAMIDES, MEX.",2,1,3,0,0,9650,
28-nov-18,SIN.,"MAZATLAN, SIN.",3,0,3,0,0,0,
28-nov-18,D.F.,"IZTACALCO, D.F.",3,0,3,0,0,40500,
29-nov-18,B.C.,"ENSENADA, B.C.",1,2,3,0,0,0,
10-dic-18,SIN.,"BADIRAGUATO, SIN.",2,1,3,0,0,0,
17-dic-18,SIN.,"GUASAVE, SIN.",2,1,3,0,3,0,
19-dic-18,SIN.,"GUASAVE, SIN.",3,0,3,0,0,0,
31-ene-19,GRO.,"COYUCA DE CATALAN, GRO.",1,2,3,0,0,0,
01-feb-19,GRO.,"COYUCA DE CATALAN, GRO.",1,2,3,0,0,0,
04-feb-19,CD. MÉX.,"IZTAPALAPA, CD. MÉX.",2,1,3,0,0,141,
12-feb-19,COAH.,"SALTILLO, COAH.",2,1,3,0,0,160,
18-feb-19,ZAC.,"GUADALUPE, ZAC.",2,1,3,0,0,0,
20-feb-19,ZAC.,"GUADALUPE, ZAC.",2,1,3,0,1,213,
21-feb-19,ZAC.,"ZAC., ZAC.",1,2,3,5,1,0,
25-feb-19,GTO.,"ACAMBARO, GTO.",3,0,3,0,0,0,
25-feb-19,ZAC.,"ZAC., ZAC.",1,2,3,6,1,100,
25-feb-19,ZAC.,"FRESNILLO, ZAC.",2,1,3,1,0,15,
26-feb-19,ZAC.,"GUADALUPE, ZAC.",3,0,3,0,0,50,
27-feb-19,GTO.,"ACAMBARO, GTO.",1,2,3,0,0,0,
04-mar-19,VER.,"POZA RICA DE HGO., VER.",1,2,3,0,0,0,
05-mar-19,CHIS.,"TAPACHULA, CHIS.",2,1,3,1,0,1251,
06-mar-19,CHIS.,"SAN CRISTOBAL DE LAS CASAS, CHIS.",2,1,3,0,0,342,
06-mar-19,GTO.,"SAN LUIS DE LA PAZ, GTO.",2,1,3,0,0,22,
08-mar-19,CHIS.,"SAN CRISTOBAL DE LAS CASAS, CHIS.",1,2,3,3,0,584,
12-mar-19,ZAC.,"FRESNILLO, ZAC.",3,0,3,8,0,3250,
14-mar-19,CHIH.,"ALDAMA, CHIH.",1,2,3,0,0,0,
22-mar-19,S.L.P.,"SAN LUIS POTOSI, S.L.P.",1,2,3,0,0,0,
30-mar-19,COAH.,"ACUÑA, COAH.",1,2,3,0,0,0,
08-abr-19,CD. MÉX.,"XOCHIMILCO, CD. MÉX.",2,1,3,0,0,44,
09-abr-19,CD. MÉX.,"IZTAPALAPA, CD. MÉX.",3,0,3,0,15,26,
10-abr-19,CD. MÉX.,"IZTAPALAPA, CD. MÉX.",3,0,3,0,15,21,
12-abr-19,ZAC.,"FRESNILLO, ZAC.",3,0,3,0,0,0,
16-abr-19,CD. MÉX.,"VENUSTIANO CARRANZA, CD. MÉX.",3,0,3,0,0,61,
22-abr-19,CD. MÉX.,"IZTAPALAPA, CD. MÉX.",1,2,3,0,0,0,
29-abr-19,CD. MÉX.,"IZTAPALAPA, CD. MÉX.",3,0,3,0,0,97,
09-may-19,CD. MÉX.,"IZTAPALAPA, CD. MÉX.",3,0,3,0,0,69,
13-may-19,COAH.,"FRANCISCO I. MADERO, COAH.",3,0,3,0,0,0,
13-may-19,COAH.,"PIEDRAS NEGRAS, COAH.",3,0,3,1,0,62,
15-may-19,CD. MÉX.,"TLALPAN, CD. MÉX.",2,1,3,0,0,667,
17-may-19,CD. MÉX.,"IZTAPALAPA, CD. MÉX.",3,0,3,0,3,5,
23-may-19,CD. MÉX.,"MILPA ALTA, CD. MÉX.",3,0,3,0,0,59,
24-may-19,ZAC.,"FRESNILLO, ZAC.",3,0,3,0,0,0,
30-may-19,QRO.,"CORREGIDORA, QRO.",2,1,3,0,0,0,
30-may-19,ZAC.,"FRESNILLO, ZAC.",1,2,3,0,0,0,
31-may-19,CD. MÉX.,"AZCAPOTZALCO, CD. MÉX.",3,0,3,0,0,135,
31-may-19,QRO.,"CORREGIDORA, QRO.",2,1,3,0,0,0,
02-jun-19,MÉX.,"ECATEPEC DE MOR., MEX.",3,0,3,0,0,0,
03-jun-19,CD. MÉX.,"AZCAPOTZALCO, CD. MÉX.",3,0,3,0,0,0,
04-jun-19,CD. MÉX.,"LA MAGDALENA CONTRERAS, CD. MÉX.",1,2,3,0,0,0,
05-jun-19,CD. MÉX.,"IZTAPALAPA, CD. MÉX.",3,0,3,0,0,46,
05-jun-19,ZAC.,"FRESNILLO, ZAC.",3,0,3,1,0,7,
09-jun-19,QRO.,"SAN JUAN DEL RIO, QRO.",2,1,3,0,0,0,
11-jun-19,CD. MÉX.,"IZTAPALAPA, CD. MÉX.",3,0,3,0,0,84,
12-jun-19,CD. MÉX.,"LA MAGDALENA CONTRERAS, CD. MÉX.",2,1,3,0,0,0,
13-jun-19,QRO.,"CORREGIDORA, QRO.",3,0,3,0,2,0,
13-jun-19,CD. MÉX.,"IZTACALCO, CD. MÉX.",2,1,3,0,1,0,
13-jun-19,CD. MÉX.,"IZTAPALAPA, CD. MÉX.",0,3,3,0,0,225,
13-jun-19,CD. MÉX.,"LA MAGDALENA CONTRERAS, CD. MÉX.",3,0,3,0,16,7,
17-jun-19,CD. MÉX.,"IZTACALCO, CD. MÉX.",3,0,3,0,1,0,
18-jun-19,CD. MÉX.,"IZTAPALAPA, CD. MÉX.",2,1,3,0,0,6,
20-jun-19,CD. MÉX.,"IZTAPALAPA, CD. MÉX.",2,1,3,0,0,3,
21-jun-19,CD. MÉX.,"IZTACALCO, CD. MÉX.",3,0,3,0,0,193,
21-jun-19,CD. MÉX.,"IZTAPALAPA, CD. MÉX.",3,0,3,0,0,24,
21-jun-19,VER.,"MINATITLAN, VER.",3,0,3,2,0,25,
25-jun-19,CD. MÉX.,"TLAHUAC, CD. MÉX.",0,3,3,0,0,1,
26-jun-19,COAH.,"ACUÑA, COAH.",3,0,3,1,0,0,
27-jun-19,CD. MÉX.,"TLAHUAC, CD. MÉX.",2,1,3,0,0,259,
28-jun-19,COAH.,"ACUÑA, COAH.",0,3,3,0,0,0,
28-jun-19,CD. MÉX.,"XOCHIMILCO, CD. MÉX.",3,0,3,0,0,447,
28-jun-19,CD. MÉX.,"TLAHUAC, CD. MÉX.",3,0,3,0,0,53,
01-jul-19,CD. MÉX.,"TLAHUAC, CD. MÉX.",3,0,3,0,0,0,
02-jul-19,AGS.,"AGS., AGS.",1,2,3,5,0,166,
03-jul-19,COAH.,"ACUÑA, COAH.",0,3,3,0,0,0,
04-jul-19,CD. MÉX.,"IZTAPALAPA, CD. MÉX.",3,0,3,0,0,22,
09-jul-19,CD. MÉX.,"MILPA ALTA, CD. MÉX.",0,3,3,0,0,204,
12-jul-19,AGS.,"AGS., AGS.",2,1,3,0,0,234,
17-jul-19,CD. MÉX.,"CUAJIMALPA DE MOR., CD. MÉX.",3,0,3,0,0,5160,
24-jul-19,VER.,"VER., VER.",2,1,3,0,0,0,
25-jul-19,CHIH.,"DELICIAS, CHIH.",2,1,3,0,0,108,
26-jul-19,CD. MÉX.,"BENITO JUAREZ, CD. MÉX.",2,1,3,0,0,47,
29-jul-19,NAY.,"TECUALA, NAY.",3,0,3,0,0,0,
29-jul-19,CHIH.,"NUEVO CASAS GRANDES, CHIH.",3,0,3,0,0,580,
30-jul-19,CD. MÉX.,"BENITO JUAREZ, CD. MÉX.",3,0,3,0,0,95,
30-jul-19,JAL.,"SAYULA, JAL.",3,0,3,0,0,0,
01-ago-19,CD. MÉX.,"IZTAPALAPA, CD. MÉX.",1,2,3,0,0,32,
01-ago-19,NAY.,"TECUALA, NAY.",2,1,3,0,0,0,
02-ago-19,CD. MÉX.,"BENITO JUAREZ, CD. MÉX.",2,1,3,0,0,192,
02-ago-19,CD. MÉX.,"IZTAPALAPA, CD. MÉX.",3,0,3,0,0,236,
02-ago-19,QRO.,"QUERETARO, QRO.",2,1,3,0,0,0,
03-ago-19,AGS.,"EL LLANO, AGS.",1,2,3,22,0,50,
05-ago-19,CD. MÉX.,"CUAUHTEMOC, CD. MÉX.",3,0,3,0,0,257,
05-ago-19,QRO.,"QUERETARO, QRO.",3,0,3,0,1,0,
06-ago-19,CD. MÉX.,"IZTAPALAPA, CD. MÉX.",2,1,3,0,1,352,
09-ago-19,JAL.,"LA HUERTA, JAL.",0,3,3,0,0,0,
09-ago-19,CD. MÉX.,"ALVARO OBREGON, CD. MÉX.",2,1,3,0,0,273,
09-ago-19,CD. MÉX.,"IZTAPALAPA, CD. MÉX.",3,0,3,0,0,22,
12-ago-19,MÉX.,"COACALCO DE BERRIOZABAL, MEX.",3,0,3,0,0,13,
12-ago-19,MÉX.,"AMECAMECA, MEX.",2,1,3,1,0,0,
12-ago-19,CD. MÉX.,"ALVARO OBREGON, CD. MÉX.",2,1,3,0,1,0,
12-ago-19,CD. MÉX.,"IZTAPALAPA, CD. MÉX.",3,0,3,0,0,439,
12-ago-19,QRO.,"QUERETARO, QRO.",2,1,3,0,0,0,
13-ago-19,CD. MÉX.,"IZTAPALAPA, CD. MÉX.",3,0,3,0,0,124,
13-ago-19,MOR.,"CUERNAVACA, MOR.",2,1,3,12,0,0,
14-ago-19,NAY.,"TEPIC, NAY.",2,1,3,0,0,0,
14-ago-19,QRO.,"QUERETARO, QRO.",2,1,3,0,0,0,
14-ago-19,MÉX.,"COACALCO DE BERRIOZABAL, MEX.",2,1,3,0,0,3553,
14-ago-19,CD. MÉX.,"IZTAPALAPA, CD. MÉX.",2,1,3,0,0,118,
15-ago-19,CD. MÉX.,"GUSTAVO A. MADERO, CD. MÉX.",3,0,3,0,10,101,
15-ago-19,QRO.,"QUERETARO, QRO.",3,0,3,0,0,0,
16-ago-19,MÉX.,"AMECAMECA, MEX.",3,0,3,0,1,0,
17-ago-19,MÉX.,"COACALCO DE BERRIOZABAL, MEX.",1,2,3,0,0,27,
19-ago-19,S.L.P.,"SOLEDAD DE GRACIANO SANCHEZ, S.L.P.",2,1,3,0,2,0,
19-ago-19,QRO.,"QUERETARO, QRO.",2,1,3,0,0,0,
19-ago-19,MÉX.,"TECAMAC, MEX.",3,0,3,3,11,290,
19-ago-19,CD. MÉX.,"ALVARO OBREGON, CD. MÉX.",2,1,3,0,0,108,
20-ago-19,NAY.,"TEPIC, NAY.",3,0,3,0,0,0,
20-ago-19,QRO.,"EZEQUIEL MONTES, QRO.",1,2,3,0,0,0,
21-ago-19,CD. MÉX.,"ALVARO OBREGON, CD. MÉX.",3,0,3,0,0,237,
21-ago-19,MÉX.,"TECAMAC, MEX.",3,0,3,2,3,48,
22-ago-19,JAL.,"SAYULA, JAL.",3,0,3,0,0,4,
22-ago-19,CD. MÉX.,"GUSTAVO A. MADERO, CD. MÉX.",2,1,3,0,0,801,
23-ago-19,AGS.,"PABELLÓN DE ARTEAGA, AGS.",3,0,3,5,0,0,
23-ago-19,QRO.,"QUERETARO, QRO.",2,1,3,0,0,0,
24-ago-19,MÉX.,"TECAMAC, MEX.",2,1,3,0,0,0,
24-ago-19,TAMPS.,"REYNOSA, TAMPS.",3,0,3,1,0,448,
24-ago-19,JAL.,"SAYULA, JAL.",3,0,3,0,0,0,
24-ago-19,TLAX.,"CHIAUTEMPAN, TLAX.",1,2,3,0,0,0,
26-ago-19,MÉX.,"JUCHITEPEC, MEX.",1,2,3,0,0,0,
26-ago-19,MOR.,"CUERNAVACA, MOR.",1,2,3,3,0,323,
26-ago-19,MÉX.,"ATLACOMULCO, MEX.",1,2,3,0,0,0,
27-ago-19,TLAX.,"APIZACO, TLAX.",2,1,3,0,0,0,
27-ago-19,MÉX.,"JUCHITEPEC, MEX.",2,1,3,0,0,0,
28-ago-19,NAY.,"COMPOSTELA, NAY.",3,0,3,1,0,0,
28-ago-19,TAMPS.,"TAMPICO, TAMPS.",3,0,3,0,0,0,
29-ago-19,MÉX.,"TLALNEPANTLA DE BAZ, MEX.",2,1,3,2,0,45,
29-ago-19,S.L.P.,"SOLEDAD DE GRACIANO SANCHEZ, S.L.P.",2,1,3,0,0,0,
29-ago-19,CD. MÉX.,"IZTAPALAPA, CD. MÉX.",2,1,3,0,0,0,
30-ago-19,CD. MÉX.,"IZTAPALAPA, CD. MÉX.",3,0,3,0,0,21,
30-ago-19,MÉX.,"TECAMAC, MEX.",1,2,3,0,0,0,
31-ago-19,MÉX.,"TECAMAC, MEX.",1,2,3,0,0,0,
31-ago-19,MÉX.,"TECAMAC, MEX.",2,1,3,0,1,54,
31-ago-19,AGS.,"SAN FRANCISCO DE LOS ROMO, AGS.",3,0,3,3,0,350,
02-sep-19,TAMPS.,"MATAMOROS, TAMPS.",1,2,3,1,0,56,
02-sep-19,MÉX.,"TEMAMATLA, MEX.",2,1,3,2,0,92,
03-sep-19,MÉX.,"NEZAHUALCOYOTL, MEX.",3,0,3,3,0,458,
03-sep-19,CD. MÉX.,"IZTAPALAPA, CD. MÉX.",3,0,3,0,0,250,
04-sep-19,CD. MÉX.,"MIGUEL HGO., CD. MÉX.",3,0,3,0,0,594,
04-sep-19,TAMPS.,"REYNOSA, TAMPS.",2,1,3,0,0,0,
04-sep-19,MOR.,"CUERNAVACA, MOR.",3,0,3,10,0,400,
05-sep-19,MÉX.,"NEZAHUALCOYOTL, MEX.",1,2,3,1,2,247,
05-sep-19,NAY.,"IXTLAN DEL RIO, NAY.",3,0,3,0,0,0,
06-sep-19,CD. MÉX.,"TLALPAN, CD. MÉX.",3,0,3,0,0,206,
06-sep-19,AGS.,"RINCÓN DE ROMOS, AGS.",3,0,3,13,0,50,
07-sep-19,MÉX.,"NEZAHUALCOYOTL, MEX.",3,0,3,2,0,11,
07-sep-19,TLAX.,"IXTACUIXTLA DE MARIANO MATAMOROS, TLAX.",0,3,3,0,0,0,
09-sep-19,MÉX.,"CUAUTITLAN IZCALLI, MEX.",3,0,3,0,0,999,
09-sep-19,GTO.,"IRAPUATO, GTO.",1,2,3,0,0,0,
10-sep-19,MÉX.,"NEZAHUALCOYOTL, MEX.",2,1,3,2,0,146,
10-sep-19,MÉX.,"CUAUTITLAN IZCALLI, MEX.",3,0,3,0,0,20,
10-sep-19,S.L.P.,"VILLA DE REYES, S.L.P.",0,3,3,2,1,0,
11-sep-19,CD. MÉX.,"COYOACAN, CD. MÉX.",3,0,3,0,0,122,
11-sep-19,MÉX.,"NEZAHUALCOYOTL, MEX.",3,0,3,3,0,454,
12-sep-19,TLAX.,"SAN PABLO DEL MONTE, TLAX.",3,0,3,0,0,0,
12-sep-19,MÉX.,"CUAUTITLAN IZCALLI, MEX.",2,1,3,0,0,1375,
18-sep-19,TAMPS.,"REYNOSA, TAMPS.",3,0,3,0,0,0,
19-sep-19,MÉX.,"TIANGUISTENCO, MEX.",3,0,3,1,0,0,
21-sep-19,MÉX.,"AMATEPEC, MEX.",2,1,3,1,0,0,
23-sep-19,CD. MÉX.,"TLALPAN, CD. MÉX.",2,1,3,0,0,6,
25-sep-19,CD. MÉX.,"TLALPAN, CD. MÉX.",2,1,3,0,0,34,
26-sep-19,MÉX.,"TENANGO DEL VALLE, MEX.",2,1,3,1,0,0,
26-sep-19,CD. MÉX.,"TLALPAN, CD. MÉX.",2,1,3,0,0,0,
26-sep-19,CD. MÉX.,"LA MAGDALENA CONTRERAS, CD. MÉX.",2,1,3,0,0,0,
26-sep-19,TAMPS.,"TAMPICO, TAMPS.",3,0,3,0,1,0,
26-sep-19,COL.,"COL., COL.",2,1,3,0,0,35,
28-sep-19,COL.,"COL., COL.",1,2,3,0,0,0,
28-sep-19,CHIS.,"TAPACHULA, CHIS.",3,0,3,1,0,355,
30-sep-19,TAMPS.,"TAMPICO, TAMPS.",3,0,3,0,0,0,
02-oct-19,CD. MÉX.,"TLALPAN, CD. MÉX.",3,0,3,0,0,0,
02-oct-19,CD. MÉX.,"LA MAGDALENA CONTRERAS, CD. MÉX.",0,3,3,0,0,0,
02-oct-19,MÉX.,"ZUMPANGO, MEX.",1,2,3,0,26,435,
03-oct-19,MÉX.,"METEPEC, MEX.",2,1,3,1,0,19,
03-oct-19,MÉX.,"TENANCINGO, MEX.",3,0,3,0,14,0,
03-oct-19,TAMPS.,"TAMPICO, TAMPS.",3,0,3,0,0,0,
04-oct-19,CD. MÉX.,"IZTACALCO, CD. MÉX.",2,1,3,0,0,38,
07-oct-19,CD. MÉX.,"IZTAPALAPA, CD. MÉX.",2,1,3,0,0,0,
07-oct-19,MÉX.,"OTUMBA, MEX.",2,1,3,0,3,327,
08-oct-19,CD. MÉX.,"IZTAPALAPA, CD. MÉX.",3,0,3,0,0,0,
10-oct-19,MÉX.,"HUIXQUILUCAN, MEX.",2,1,3,1,3,27,
15-oct-19,CD. MÉX.,"CUAJIMALPA DE MOR., CD. MÉX.",3,0,3,0,0,28,
16-oct-19,MÉX.,"IXTAPALUCA, MEX.",3,0,3,0,0,92,
17-oct-19,CHIS.,"EMILIANO ZAPATA, CHIS.",0,3,3,0,0,20,
17-oct-19,CD. MÉX.,"IZTAPALAPA, CD. MÉX.",0,3,3,0,0,244,
22-oct-19,CD. MÉX.,"IZTAPALAPA, CD. MÉX.",3,0,3,0,0,400,
26-oct-19,MÉX.,"CHALCO, MEX.",3,0,3,0,0,0,
29-oct-19,VER.,"COSOLEACAQUE, VER.",3,0,3,0,0,339,
29-oct-19,CD. MÉX.,"AZCAPOTZALCO, CD. MÉX.",2,1,3,0,0,0,
31-oct-19,CD. MÉX.,"AZCAPOTZALCO, CD. MÉX.",3,0,3,0,0,0,
01-nov-19,MÉX.,"OTZOLOTEPEC, MEX.",0,3,3,1,1,82,
01-nov-19,CD. MÉX.,"IZTAPALAPA, CD. MÉX.",2,1,3,0,0,896,
05-nov-19,CD. MÉX.,"AZCAPOTZALCO, CD. MÉX.",1,2,3,0,0,0,
07-nov-19,MÉX.,"SAN MATEO ATENCO, MEX.",3,0,3,0,0,0,
07-nov-19,MÉX.,"SAN MATEO ATENCO, MEX.",3,0,3,0,0,0,
07-nov-19,MÉX.,"LA PAZ, MEX.",2,1,3,0,1,156,
08-nov-19,ZAC.,"ZAC., ZAC.",1,2,3,1,0,0,
12-nov-19,CD. MÉX.,"CUAUHTEMOC, CD. MÉX.",3,0,3,0,0,38,
12-nov-19,CHIS.,"CHILÓN, CHIS.",3,0,3,0,0,48,
13-nov-19,MÉX.,"TEPETLAOXTOC, MEX.",2,1,3,0,0,43,
14-nov-19,TLAX.,"TEOLOCHOLCO, TLAX.",3,0,3,0,0,0,
15-nov-19,MÉX.,"TEPETLAOXTOC, MEX.",1,2,3,0,0,0,
16-nov-19,CHIS.,"PALENQUE, CHIS.",3,0,3,0,0,46,
19-nov-19,MÉX.,"ALMOLOYA DE JUAREZ, MEX.",3,0,3,0,0,118,
20-nov-19,MÉX.,"ALMOLOYA DE JUAREZ, MEX.",1,2,3,0,0,27,
23-nov-19,MÉX.,"ALMOLOYA DE JUAREZ, MEX.",3,0,3,0,0,6,
25-nov-19,GTO.,"LEON, GTO.",1,2,3,0,0,0,
26-nov-19,GTO.,"LEON, GTO.",2,1,3,0,0,0,
26-nov-19,S.L.P.,"CIUDAD VALLES, S.L.P.",1,2,3,1,0,0,
27-nov-19,CD. MÉX.,"COYOACAN, CD. MÉX.",1,2,3,0,0,0,
28-nov-19,CD. MÉX.,"XOCHIMILCO, CD. MÉX.",3,0,3,5,0,0,
04-dic-19,CD. MÉX.,"XOCHIMILCO, CD. MÉX.",2,1,3,0,0,16,
05-dic-19,GTO.,"LEON, GTO.",1,2,3,0,0,0,
06-dic-19,ZAC.,"GUADALUPE, ZAC.",3,0,3,1,0,50,
06-dic-19,CD. MÉX.,"MIGUEL HGO., CD. MÉX.",3,0,3,0,0,37,
09-dic-19,CD. MÉX.,"MIGUEL HGO., CD. MÉX.",1,2,3,0,16,1165,
10-dic-19,N.L.,"GUADALUPE, N.L.",3,0,3,4,0,13,
10-dic-19,CD. MÉX.,"MIGUEL HGO., CD. MÉX.",2,1,3,0,0,113,
11-dic-19,ZAC.,"GUADALUPE, ZAC.",3,0,3,1,0,6,
13-dic-19,CD. MÉX.,"MIGUEL HGO., CD. MÉX.",3,0,3,0,16,1494,
16-dic-19,S.L.P.,"SOLEDAD DE GRACIANO SANCHEZ, S.L.P.",3,0,3,0,0,0,
16-dic-19,CD. MÉX.,"IZTACALCO, CD. MÉX.",0,3,3,0,0,735,
18-dic-19,S.L.P.,"SAN LUIS POTOSI, S.L.P.",1,2,3,12,0,0,
18-dic-19,S.L.P.,"SOLEDAD DE GRACIANO SANCHEZ, S.L.P.",3,0,3,2,0,0,
19-dic-19,S.L.P.,"CIUDAD VALLES, S.L.P.",2,1,3,0,0,0,
21-ene-20,CHIS.,"COPAINALÁ, CHIS.",1,2,3,0,0,0,
27-ene-20,CD. MÉX.,"MILPA ALTA, CD. MÉX.",1,2,3,0,0,32,
27-ene-20,CD. MÉX.,"IZTAPALAPA, CD. MÉX.",2,1,3,0,0,174,
29-ene-20,VER.,"MINATITLAN, VER.",3,0,3,2,0,24,
30-ene-20,CHIS.,"TAPACHULA, CHIS.",1,2,3,3,0,0,
31-ene-20,VER.,"MINATITLAN, VER.",3,0,3,2,0,12,
31-ene-20,CD. MÉX.,"MILPA ALTA, CD. MÉX.",2,1,3,0,0,5,
07-feb-20,CD. MÉX.,"CUAUHTEMOC, CD. MÉX.",1,2,3,0,0,7,
12-feb-20,SIN.,"CULIACAN, SIN.",2,1,3,0,1,1,
12-feb-20,SIN.,"NAVOLATO, SIN.",3,0,3,0,0,0,
13-feb-20,SIN.,"NAVOLATO, SIN.",3,0,3,0,0,0,
13-feb-20,CD. MÉX.,"CUAUHTEMOC, CD. MÉX.",1,2,3,0,0,0,
14-feb-20,SIN.,"GUASAVE, SIN.",3,0,3,0,0,0,
14-feb-20,CD. MÉX.,"TLALPAN, CD. MÉX.",2,1,3,0,1,0,
17-feb-20,SIN.,"CULIACAN, SIN.",3,0,3,0,0,0,
17-feb-20,SIN.,"NAVOLATO, SIN.",3,0,3,0,0,0,
19-feb-20,CD. MÉX.,"CUAUHTEMOC, CD. MÉX.",3,0,3,0,0,33,
19-feb-20,SIN.,"CULIACAN, SIN.",1,2,3,0,0,0,
20-feb-20,CD. MÉX.,"IZTAPALAPA, CD. MÉX.",1,2,3,0,0,2383,
20-feb-20,SIN.,"ELOTA, SIN.",0,3,3,0,0,0,
20-feb-20,NAY.,"TEPIC, NAY.",3,0,3,1,0,84,
20-feb-20,ZAC.,"RIO GRANDE, ZAC.",3,0,3,3,0,0,
21-feb-20,CD. MÉX.,"TLALPAN, CD. MÉX.",2,1,3,0,0,39,
21-feb-20,COAH.,"PIEDRAS NEGRAS, COAH.",1,2,3,0,0,0,
22-feb-20,COAH.,"FRANCISCO I. MADERO, COAH.",1,2,3,0,0,0,
25-feb-20,COAH.,"PIEDRAS NEGRAS, COAH.",1,2,3,0,0,83,
26-feb-20,CD. MÉX.,"IZTAPALAPA, CD. MÉX.",1,2,3,0,12,0,
26-feb-20,COAH.,"SALTILLO, COAH.",3,0,3,0,0,225,
28-feb-20,CHIS.,"SAN CRISTOBAL DE LAS CASAS, CHIS.",2,1,3,0,0,646,
02-mar-20,CD. MÉX.,"IZTAPALAPA, CD. MÉX.",3,0,3,0,0,0,
04-mar-20,CHIH.,"CHIH., CHIH.",3,0,3,0,0,95,
05-mar-20,SIN.,"SAN IGNACIO, SIN.",1,2,3,0,0,0,
06-mar-20,SIN.,"ANGOSTURA, SIN.",1,2,3,0,0,0,
07-mar-20,VER.,"COATZACOALCOS, VER.",3,0,3,0,0,84,
07-mar-20,VER.,"VER., VER.",2,1,3,62,1,1899,
10-mar-20,VER.,"XALAPA, VER.",1,2,3,16,0,519,
11-mar-20,COAH.,"FRANCISCO I. MADERO, COAH.",2,1,3,0,0,0,
12-mar-20,COAH.,"TORREÓN, COAH.",1,2,3,0,0,0,
12-mar-20,NAY.,"XALISCO, NAY.",3,0,3,0,4,0,
12-mar-20,CHIH.,"NUEVO CASAS GRANDES, CHIH.",3,0,3,5,2,907,
13-mar-20,CD. MÉX.,"MIGUEL HGO., CD. MÉX.",2,1,3,0,0,0,
13-mar-20,CD. MÉX.,"IZTAPALAPA, CD. MÉX.",0,3,3,0,0,4830,
17-mar-20,COAH.,"TORREÓN, COAH.",0,3,3,0,0,0,
17-mar-20,COAH.,"SALTILLO, COAH.",3,0,3,0,0,54,
17-mar-20,VER.,"XALAPA, VER.",3,0,3,6,0,0,
21-mar-20,S.L.P.,"SAN LUIS POTOSI, S.L.P.",3,0,3,0,0,0,
25-mar-20,COAH.,"SALTILLO, COAH.",3,0,3,0,0,52,
07-jul-20,CD. MÉX.,"GUSTAVO A. MADERO, CD. MÉX.",3,0,3,0,0,298,
09-jul-20,CD. MÉX.,"GUSTAVO A. MADERO, CD. MÉX.",3,0,3,0,0,0,
14-jul-20,CD. MÉX.,"CUAUHTEMOC, CD. MÉX.",0,3,3,0,0,0,
16-jul-20,CD. MÉX.,"GUSTAVO A. MADERO, CD. MÉX.",3,0,3,0,0,71,
28-jul-20,CD. MÉX.,"CUAUHTEMOC, CD. MÉX.",1,2,3,0,0,4,
30-jul-20,CD. MÉX.,"CUAUHTEMOC, CD. MÉX.",3,0,3,0,2,43,
06-ago-20,CD. MÉX.,"CUAUHTEMOC, CD. MÉX.",3,0,3,0,0,0,
07-ago-20,CD. MÉX.,"CUAUHTEMOC, CD. MÉX.",0,3,3,0,0,0,
10-ago-20,CD. MÉX.,"CUAUHTEMOC, CD. MÉX.",2,1,3,0,0,675,
20-ago-20,CD. MÉX.,"CUAUHTEMOC, CD. MÉX.",3,0,3,0,0,0,
21-ago-20,CD. MÉX.,"CUAUHTEMOC, CD. MÉX.",2,1,3,0,0,22,
24-ago-20,CD. MÉX.,"CUAUHTEMOC, CD. MÉX.",3,0,3,0,0,50,
07-sep-20,CD. MÉX.,"CUAUHTEMOC, CD. MÉX.",3,0,3,0,0,0,
22-sep-20,CD. MÉX.,"GUSTAVO A. MADERO, CD. MÉX.",2,1,3,0,0,2,
22-sep-20,VER.,"CORDOBA, VER.",3,0,3,4,0,200,
25-sep-20,CD. MÉX.,"GUSTAVO A. MADERO, CD. MÉX.",2,1,3,0,0,26,
02-oct-20,VER.,"MARTINEZ DE LA TORRE, VER.",3,0,3,7,1,161,
09-nov-20,CD. MÉX.,"MIGUEL HGO., CD. MÉX.",1,2,3,0,0,434,
11-nov-20,CD. MÉX.,"VENUSTIANO CARRANZA, CD. MÉX.",0,3,3,0,0,0,
18-nov-20,CD. MÉX.,"MIGUEL HGO., CD. MÉX.",3,0,3,0,0,0,
18-nov-20,CD. MÉX.,"CUAUHTEMOC, CD. MÉX.",1,2,3,0,0,0,
18-nov-20,CD. MÉX.,"GUSTAVO A. MADERO, CD. MÉX.",3,0,3,0,0,252,
19-nov-20,CD. MÉX.,"GUSTAVO A. MADERO, CD. MÉX.",1,2,3,0,0,100,
26-nov-20,CD. MÉX.,"GUSTAVO A. MADERO, CD. MÉX.",0,3,3,0,0,0,
08-dic-20,CD. MÉX.,"GUSTAVO A. MADERO, CD. MÉX.",3,0,3,0,0,0,
08-dic-20,CD. MÉX.,"VENUSTIANO CARRANZA, CD. MÉX.",1,2,3,0,0,477,
18-dic-20,CD. MÉX.,"GUSTAVO A. MADERO, CD. MÉX.",0,3,3,0,0,0,
09-jul-21,VER.,"MARTINEZ DE LA TORRE, VER.",2,1,3,1,0,10056,
09-jul-21,VER.,"MINATITLAN, VER.",3,0,3,0,0,8,
14-jul-21,VER.,"POZA RICA DE HGO., VER.",2,1,3,2,0,62,
14-jul-21,VER.,"MARTINEZ DE LA TORRE, VER.",1,2,3,3,0,353,
15-jul-21,VER.,"MINATITLAN, VER.",2,1,3,1,0,1900,
15-jul-21,VER.,"POZA RICA DE HGO., VER.",2,1,3,2,0,289,
19-jul-21,VER.,"POZA RICA DE HGO., VER.",2,1,3,0,0,933,
21-jul-21,COAH.,"MONCLOVA, COAH.",2,1,3,0,0,467,
23-jul-21,VER.,"POZA RICA DE HGO., VER.",1,2,3,1,1,872,
21-sep-21,B.C.,"MEXICALI, B.C.",3,0,3,0,0,0,
19-oct-21,CD. MÉX.,"TLALPAN, CD. MÉX.",3,0,3,0,0,246,
22-oct-21,CD. MÉX.,"IZTACALCO, CD. MÉX.",3,0,3,0,0,0,
04-nov-21,CD. MÉX.,"COYOACAN, CD. MÉX.",2,1,3,0,0,790,
04-nov-21,CD. MÉX.,"COYOACAN, CD. MÉX.",2,1,3,0,0,790,
05-nov-21,CD. MÉX.,"XOCHIMILCO, CD. MÉX.",3,0,3,0,0,235,
08-nov-21,TLAX.,"TLAX., TLAX.",1,2,3,0,0,50,
08-nov-21,TLAX.,"ZACATELCO, TLAX.",2,1,3,0,0,0,
10-nov-21,TLAX.,"TLAX., TLAX.",2,1,3,0,0,0,
12-nov-21,CD. MÉX.,"COYOACAN, CD. MÉX.",2,1,3,0,0,53,
16-nov-21,VER.,"ALAMO, VER.",2,1,3,0,0,0,
17-nov-21,VER.,"NOGALES, VER.",3,0,3,4,0,35,
18-nov-21,CD. MÉX.,"MIGUEL HGO., CD. MÉX.",2,1,3,0,0,600,
23-nov-21,TLAX.,"ALTZAYANCA, TLAX.",2,1,3,0,0,0,
26-nov-21,TLAX.,"ZITLALTEPEC DE TRINIDAD SANCHEZ SANTOS, TLAX.",0,3,3,0,0,0,
27-nov-21,TLAX.,"ZITLALTEPEC DE TRINIDAD SANCHEZ SANTOS, TLAX.",1,2,3,0,0,0,
29-nov-21,TLAX.,"TETLA DE LA SOLIDARIDAD, TLAX.",2,1,3,0,0,0,
30-nov-21,CHIS.,"TUXTLA GUTIÉRREZ, CHIS.",3,0,3,0,0,441,
01-dic-21,CHIS.,"TUXTLA GUTIÉRREZ, CHIS.",2,1,3,0,7,126,
01-dic-21,CHIS.,"BERRIOZÁBAL, CHIS.",2,1,3,0,4,1416,
02-dic-21,TLAX.,"TETLA DE LA SOLIDARIDAD, TLAX.",2,1,3,0,0,0,
04-dic-21,CHIS.,"TUXTLA GUTIÉRREZ, CHIS.",2,1,3,2,0,1531,
04-dic-21,OAX.,"OAX. DE JUAREZ, OAX.",2,1,3,0,0,50,
06-dic-21,CD. MÉX.,"ALVARO OBREGON, CD. MÉX.",3,0,3,0,0,0,
07-dic-21,CHIS.,"REFORMA, CHIS.",2,1,3,0,0,0,
08-dic-21,TLAX.,"PAPALOTLA DE XICOHTENCATL, TLAX.",1,2,3,0,0,0,
12-dic-21,CHIS.,"PUEBLO NUEVO SOLISTAHUACÁN, CHIS.",3,0,3,0,0,0,
13-dic-21,CHIS.,"CHENALHÓ, CHIS.",0,3,3,0,0,0,
15-dic-21,SON.,"HERMOSILLO, SON.",1,2,3,1,0,120,
15-dic-21,CD. MÉX.,"IZTACALCO, CD. MÉX.",3,0,3,0,0,6,
17-dic-21,CHIS.,"BOCHIL, CHIS.",1,2,3,0,0,0,
20-dic-21,CHIS.,"MEZCALAPA, CHIS.",2,1,3,0,0,0,
21-dic-21,CHIS.,"TECPATÁN, CHIS.",2,1,3,0,0,0,
21-ene-22,CD. MÉX.,"CUAUHTEMOC, CD. MÉX.",2,1,3,0,0,77,
31-ene-22,CD. MÉX.,"IZTAPALAPA, CD. MÉX.",2,1,3,0,0,0,
02-feb-22,CD. MÉX.,"IZTAPALAPA, CD. MÉX.",2,1,3,0,0,47,
04-feb-22,CD. MÉX.,"IZTACALCO, CD. MÉX.",3,0,3,0,0,12,
08-feb-22,CD. MÉX.,"IZTAPALAPA, CD. MÉX.",2,1,3,0,1,193,
09-feb-22,CD. MÉX.,"BENITO JUAREZ, CD. MÉX.",2,1,3,0,0,0,
18-abr-22,CD. MÉX.,"CUAUHTEMOC, CD. MÉX.",3,0,3,0,0,542,
21-abr-22,CD. MÉX.,"CUAUHTEMOC, CD. MÉX.",0,3,3,0,0,23,
26-abr-22,S.L.P.,"SOLEDAD DE GRACIANO SANCHEZ, S.L.P.",3,0,3,0,0,0,
28-abr-22,S.L.P.,"SAN LUIS POTOSI, S.L.P.",2,1,3,0,0,0,
29-abr-22,CD. MÉX.,"CUAUHTEMOC, CD. MÉX.",2,1,3,0,0,37,
01-may-22,S.L.P.,"CIUDAD VALLES, S.L.P.",1,2,3,0,0,0,
03-may-22,CD. MÉX.,"CUAUHTEMOC, CD. MÉX.",2,1,3,0,0,42,
04-may-22,S.L.P.,"SOLEDAD DE GRACIANO SANCHEZ, S.L.P.",0,3,3,0,0,0,
11-may-22,SIN.,"EL FUERTE, SIN.",1,2,3,0,0,0,
12-may-22,SIN.,"SIN., SIN.",2,1,3,0,0,0,
12-may-22,CD. MÉX.,"CUAUHTEMOC, CD. MÉX.",1,2,3,0,0,6,
15-may-22,SIN.,"CHOIX, SIN.",3,0,3,0,3,0,
15-may-22,SIN.,"EL FUERTE, SIN.",0,3,3,0,0,0,
16-may-22,CD. MÉX.,"CUAUHTEMOC, CD. MÉX.",3,0,3,0,0,55,
18-may-22,SIN.,"EL FUERTE, SIN.",1,2,3,0,0,0,
19-may-22,CD. MÉX.,"VENUSTIANO CARRANZA, CD. MÉX.",3,0,3,0,0,691,
21-may-22,SIN.,"EL FUERTE, SIN.",3,0,3,0,0,0,
23-may-22,VER.,"COATZACOALCOS, VER.",3,0,3,6,1,714,
26-may-22,S.L.P.,"SAN LUIS POTOSI, S.L.P.",1,2,3,0,1,0,
28-may-22,S.L.P.,"SAN LUIS POTOSI, S.L.P.",1,2,3,0,12,0,
29-may-22,VER.,"COATZACOALCOS, VER.",2,1,3,28,0,305,
30-may-22,VER.,"COATZACOALCOS, VER.",2,1,3,9,0,494,
31-may-22,CD. MÉX.,"MIGUEL HGO., CD. MÉX.",3,0,3,0,0,38,
07-jun-22,SIN.,"GUASAVE, SIN.",3,0,3,0,0,0,
07-jun-22,SIN.,"ANGOSTURA, SIN.",3,0,3,0,0,12,
08-jun-22,SIN.,"GUASAVE, SIN.",3,0,3,0,0,0,
10-jun-22,SIN.,"ANGOSTURA, SIN.",3,0,3,0,0,0,
15-jun-22,CD. MÉX.,"CUAUHTEMOC, CD. MÉX.",1,2,3,0,0,0,
17-jun-22,CD. MÉX.,"ALVARO OBREGON, CD. MÉX.",1,2,3,0,0,0,
17-jun-22,CHIH.,"JUÁREZ, CHIH.",2,1,3,0,0,0,
21-jun-22,CD. MÉX.,"BENITO JUAREZ, CD. MÉX.",3,0,3,0,0,4,
21-jun-22,CD. MÉX.,"TLALPAN, CD. MÉX.",3,0,3,0,0,0,
21-jun-22,JAL.,"SAYULA, JAL.",0,3,3,0,0,0,
22-jun-22,TLAX.,"SANTA CRUZ TLAX., TLAX.",2,1,3,0,0,16,
22-jun-22,CD. MÉX.,"BENITO JUAREZ, CD. MÉX.",0,3,3,0,0,47,
22-jun-22,CD. MÉX.,"TLALPAN, CD. MÉX.",3,0,3,0,0,24,
27-jun-22,CHIH.,"JUÁREZ, CHIH.",3,0,3,10,0,284,
27-jun-22,JAL.,"OCOTLAN, JAL.",3,0,3,2,0,0,
28-jun-22,TLAX.,"SAN PABLO DEL MONTE, TLAX.",2,1,3,0,0,0,
28-jun-22,CD. MÉX.,"CUAJIMALPA DE MOR., CD. MÉX.",2,1,3,0,0,0,
29-jun-22,S.L.P.,"SAN LUIS POTOSI, S.L.P.",3,0,3,0,0,0,
30-jun-22,JAL.,"ZAPOPAN, JAL.",3,0,3,1,0,40,
30-jun-22,CHIH.,"JUÁREZ, CHIH.",1,2,3,0,0,15,
01-jul-22,CD. MÉX.,"ALVARO OBREGON, CD. MÉX.",2,1,3,0,0,405,
01-jul-22,CHIH.,"JUÁREZ, CHIH.",2,1,3,0,0,308,
04-jul-22,SIN.,"SALVADOR ALVARADO, SIN.",3,0,3,0,0,0,
04-jul-22,SIN.,"MOCORITO, SIN.",2,1,3,0,0,0,
05-jul-22,TAMPS.,"CIUDAD MADERO, TAMPS.",3,0,3,0,0,18,
06-jul-22,CHIH.,"JUÁREZ, CHIH.",1,2,3,0,0,31,
06-jul-22,MICH.,"MORELIA, MICH.",3,0,3,0,0,0,
07-jul-22,CD. MÉX.,"COYOACAN, CD. MÉX.",3,0,3,0,0,510,
08-jul-22,MICH.,"MORELIA, MICH.",0,3,3,0,0,0,
08-jul-22,TAMPS.,"CIUDAD MADERO, TAMPS.",3,0,3,0,0,115,
09-jul-22,SIN.,"MOCORITO, SIN.",2,1,3,0,0,0,
11-jul-22,CD. MÉX.,"COYOACAN, CD. MÉX.",3,0,3,0,0,0,
11-jul-22,CHIH.,"JUÁREZ, CHIH.",3,0,3,11,0,139,
11-jul-22,TAMPS.,"VICTORIA, TAMPS.",3,0,3,0,0,0,
12-jul-22,TAMPS.,"CIUDAD MADERO, TAMPS.",2,1,3,0,0,38,
13-jul-22,CHIH.,"JUÁREZ, CHIH.",2,1,3,31,0,432,
13-jul-22,TAMPS.,"CIUDAD MADERO, TAMPS.",3,0,3,0,1,29,
14-jul-22,CD. MÉX.,"BENITO JUAREZ, CD. MÉX.",3,0,3,0,0,11,
14-jul-22,TAMPS.,"CIUDAD MADERO, TAMPS.",3,0,3,1,0,14,
15-jul-22,JAL.,"TLAQUEPAQUE, JAL.",1,2,3,4,2,367,
17-jul-22,VER.,"VER., VER.",3,0,3,0,0,164,
23-jul-22,VER.,"VER., VER.",3,0,3,0,0,176,
27-jul-22,CD. MÉX.,"BENITO JUAREZ, CD. MÉX.",1,2,3,0,30,0,
28-jul-22,PUE.,"ATLIXCO, PUE.",2,1,3,0,1,0,
29-jul-22,CD. MÉX.,"BENITO JUAREZ, CD. MÉX.",2,1,3,0,28,141,
01-ago-22,CD. MÉX.,"BENITO JUAREZ, CD. MÉX.",2,1,3,0,0,639,
04-ago-22,COAH.,"MONCLOVA, COAH.",1,2,3,0,0,0,
06-ago-22,CHIS.,"TAPACHULA, CHIS.",2,1,3,0,0,797,
07-ago-22,QRO.,"QUERETARO, QRO.",0,3,3,0,2,0,
08-ago-22,CD. MÉX.,"ALVARO OBREGON, CD. MÉX.",3,0,3,0,0,143,
08-ago-22,COAH.,"FRONTERA, COAH.",2,1,3,0,0,0,
09-ago-22,CD. MÉX.,"GUSTAVO A. MADERO, CD. MÉX.",3,0,3,0,1,213,
10-ago-22,CD. MÉX.,"GUSTAVO A. MADERO, CD. MÉX.",1,2,3,0,12,421,
11-ago-22,CHIS.,"PALENQUE, CHIS.",3,0,3,0,0,0,
16-ago-22,TAMPS.,"REYNOSA, TAMPS.",0,3,3,0,0,155,
17-ago-22,SIN.,"SIN., SIN.",3,0,3,0,0,0,
18-ago-22,CD. MÉX.,"CUAUHTEMOC, CD. MÉX.",2,1,3,0,0,0,
18-ago-22,CHIS.,"BERRIOZÁBAL, CHIS.",2,1,3,0,0,185,
22-ago-22,CD. MÉX.,"GUSTAVO A. MADERO, CD. MÉX.",2,1,3,0,0,2356,
23-ago-22,CD. MÉX.,"IZTACALCO, CD. MÉX.",3,0,3,0,0,392,
23-ago-22,COAH.,"FRONTERA, COAH.",3,0,3,0,0,0,
23-ago-22,COAH.,"SALTILLO, COAH.",2,1,3,1,0,51,
23-ago-22,MÉX.,"AMECAMECA, MEX.",2,1,3,0,0,184,
23-ago-22,COAH.,"PIEDRAS NEGRAS, COAH.",1,2,3,6,0,646,
24-ago-22,COAH.,"PIEDRAS NEGRAS, COAH.",1,2,3,4,0,646,
25-ago-22,COAH.,"ACUÑA, COAH.",1,2,3,0,0,150,
27-ago-22,MÉX.,"HUIXQUILUCAN, MEX.",1,2,3,0,0,0,
29-ago-22,COAH.,"TORREÓN, COAH.",3,0,3,0,0,0,
31-ago-22,MÉX.,"HUIXQUILUCAN, MEX.",0,3,3,0,0,0,
31-ago-22,MOR.,"TEMIXCO, MOR.",3,0,3,36,13,8,
31-ago-22,TAMPS.,"REYNOSA, TAMPS.",1,2,3,0,0,3,
02-sep-22,MÉX.,"TEPETLAOXTOC, MEX.",2,1,3,0,0,0,
02-sep-22,N.L.,"APODACA, N.L.",2,1,3,3,0,8,
03-sep-22,ZAC.,"GUADALUPE, ZAC.",1,2,3,23,0,145,
07-sep-22,PUE.,"TEHUACAN, PUE.",2,1,3,0,0,54,
07-sep-22,COAH.,"ACUÑA, COAH.",3,0,3,0,0,0,
07-sep-22,CD. MÉX.,"TLAHUAC, CD. MÉX.",2,1,3,0,0,86,
07-sep-22,MÉX.,"NAUCALPAN DE JUAREZ, MEX.",3,0,3,0,0,105,
08-sep-22,CD. MÉX.,"COYOACAN, CD. MÉX.",2,1,3,0,0,0,
08-sep-22,CD. MÉX.,"TLAHUAC, CD. MÉX.",2,1,3,0,0,5,
08-sep-22,MOR.,"CUERNAVACA, MOR.",2,1,3,0,1,0,
09-sep-22,MOR.,"CUERNAVACA, MOR.",1,2,3,7,0,0,
10-sep-22,MÉX.,"TOLUCA, MEX.",3,0,3,0,0,245,
11-sep-22,ZAC.,"JEREZ, ZAC.",1,2,3,0,0,0,
12-sep-22,MÉX.,"TOLUCA, MEX.",3,0,3,0,0,6,
12-sep-22,MOR.,"CUERNAVACA, MOR.",2,1,3,0,1,0,
13-sep-22,CD. MÉX.,"COYOACAN, CD. MÉX.",2,1,3,0,0,131,
14-sep-22,MÉX.,"CUAUTITLAN IZCALLI, MEX.",3,0,3,0,0,11,
14-sep-22,ZAC.,"JEREZ, ZAC.",2,1,3,21,0,32,
14-sep-22,CD. MÉX.,"AZCAPOTZALCO, CD. MÉX.",3,0,3,0,0,144,
19-sep-22,CD. MÉX.,"COYOACAN, CD. MÉX.",3,0,3,0,0,132,
19-sep-22,MOR.,"CUERNAVACA, MOR.",1,2,3,0,0,0,
20-sep-22,VER.,"POZA RICA DE HGO., VER.",2,1,3,0,0,122,
20-sep-22,S.L.P.,"SAN LUIS POTOSI, S.L.P.",1,2,3,0,0,0,
22-sep-22,MÉX.,"TLALNEPANTLA DE BAZ, MEX.",3,0,3,0,0,711,
22-sep-22,S.L.P.,"SAN LUIS POTOSI, S.L.P.",1,2,3,0,0,0,
23-sep-22,MÉX.,"NEZAHUALCOYOTL, MEX.",3,0,3,0,1,984,
26-sep-22,MÉX.,"TECAMAC, MEX.",2,1,3,0,10,664,
26-sep-22,COAH.,"SABINAS, COAH.",2,1,3,0,0,0,
26-sep-22,MOR.,"CUERNAVACA, MOR.",1,2,3,0,0,386,
28-sep-22,MÉX.,"NEZAHUALCOYOTL, MEX.",3,0,3,0,0,0,
29-sep-22,CD. MÉX.,"LA MAGDALENA CONTRERAS, CD. MÉX.",2,1,3,0,0,121,
30-sep-22,CD. MÉX.,"VENUSTIANO CARRANZA, CD. MÉX.",3,0,3,0,0,18,
01-oct-22,MÉX.,"TECAMAC, MEX.",2,1,3,0,0,0,
03-oct-22,CD. MÉX.,"TLALPAN, CD. MÉX.",2,1,3,0,0,58,
04-oct-22,TLAX.,"TLAX., TLAX.",2,1,3,0,0,0,
04-oct-22,TLAX.,"HUAMANTLA, TLAX.",3,0,3,0,0,0,
04-oct-22,MÉX.,"TULTEPEC, MEX.",3,0,3,0,0,71,
05-oct-22,TLAX.,"TLAX., TLAX.",3,0,3,0,0,0,
05-oct-22,MÉX.,"TULTITLAN, MEX.",3,0,3,0,0,26,
05-oct-22,CD. MÉX.,"TLALPAN, CD. MÉX.",2,1,3,0,10,92,
06-oct-22,MÉX.,"CHALCO, MEX.",1,2,3,0,0,42,
07-oct-22,MÉX.,"XALATLACO, MEX.",3,0,3,0,0,0,
07-oct-22,TLAX.,"TLAX., TLAX.",1,2,3,0,0,0,
07-oct-22,MÉX.,"TULTITLAN, MEX.",2,1,3,1,0,28,
07-oct-22,MÉX.,"TULTITLAN, MEX.",3,0,3,0,0,25,
10-oct-22,CHIH.,"JUÁREZ, CHIH.",3,0,3,7,0,386,
10-oct-22,MÉX.,"TENANGO DEL VALLE, MEX.",2,1,3,0,0,0,
11-oct-22,DGO.,"DGO., DGO.",1,2,3,2,0,595,
11-oct-22,MÉX.,"VALLE DE CHALCO SOLIDARIDAD, MEX.",3,0,3,0,98,26,
12-oct-22,TLAX.,"APIZACO, TLAX.",0,3,3,0,0,0,
12-oct-22,MÉX.,"TENANGO DEL VALLE, MEX.",1,2,3,0,0,0,
13-oct-22,CHIH.,"JUÁREZ, CHIH.",3,0,3,6,0,0,
13-oct-22,DGO.,"DGO., DGO.",2,1,3,10,0,124,
13-oct-22,TLAX.,"APIZACO, TLAX.",3,0,3,0,0,0,
13-oct-22,COAH.,"PIEDRAS NEGRAS, COAH.",0,3,3,0,0,0,
17-oct-22,SIN.,"MAZATLAN, SIN.",2,1,3,0,2,75,
17-oct-22,CHIH.,"JUÁREZ, CHIH.",3,0,3,3,0,0,
18-oct-22,CD. MÉX.,"CUAUHTEMOC, CD. MÉX.",2,1,3,0,0,94,
19-oct-22,MÉX.,"HUEHUETOCA, MEX.",2,1,3,0,0,12,
20-oct-22,COAH.,"PIEDRAS NEGRAS, COAH.",1,2,3,0,0,206,
24-oct-22,N.L.,"APODACA, N.L.",3,0,3,1,0,328,
24-oct-22,N.L.,"GRAL. ESCOBEDO, N.L.",3,0,3,1,0,328,
25-oct-22,CD. MÉX.,"TLALPAN, CD. MÉX.",1,2,3,0,0,820,
26-oct-22,SIN.,"MAZATLAN, SIN.",2,1,3,0,0,304,
27-oct-22,TLAX.,"CONTLA DE JUAN CUAMATZI, TLAX.",2,1,3,0,0,0,
28-oct-22,MÉX.,"LERMA, MEX.",1,2,3,0,2,0,
28-oct-22,TLAX.,"CONTLA DE JUAN CUAMATZI, TLAX.",2,1,3,0,0,0,
28-oct-22,MOR.,"CUAUTLA, MOR.",3,0,3,1,0,162,
29-oct-22,TLAX.,"SANTA ANA NOPALUCAN, TLAX.",3,0,3,0,0,0,
31-oct-22,CD. MÉX.,"GUSTAVO A. MADERO, CD. MÉX.",3,0,3,0,0,130,
31-oct-22,MÉX.,"ZINACANTEPEC, MEX.",1,2,3,0,0,0,
01-nov-22,MÉX.,"CHICOLOAPAN, MEX.",2,1,3,0,0,9,
02-nov-22,SIN.,"ELOTA, SIN.",2,1,3,0,1,0,
04-nov-22,SIN.,"ELOTA, SIN.",2,1,3,0,0,0,
04-nov-22,SIN.,"COSALA, SIN.",2,1,3,0,0,0,
04-nov-22,VER.,"ACAYUCAN, VER.",3,0,3,0,0,8,
05-nov-22,VER.,"POZA RICA DE HGO., VER.",3,0,3,1,0,238,
07-nov-22,CD. MÉX.,"TLALPAN, CD. MÉX.",2,1,3,0,0,150,
07-nov-22,MÉX.,"ZUMPANGO, MEX.",3,0,3,0,0,46,
08-nov-22,CHIS.,"BERRIOZÁBAL, CHIS.",2,1,3,0,0,420,
08-nov-22,CHIS.,"SAN CRISTOBAL DE LAS CASAS, CHIS.",2,1,3,0,0,0,
08-nov-22,GRO.,"ACAPULCO DE JUAREZ, GRO.",3,0,3,2,4,250,
09-nov-22,VER.,"PAPANTLA, VER.",2,1,3,3,0,127,
09-nov-22,OAX.,"SANTIAGO PINOTEPA NACIONAL, OAX.",1,2,3,5,0,41,
16-nov-22,CD. MÉX.,"MILPA ALTA, CD. MÉX.",2,1,3,0,0,32,
17-nov-22,CD. MÉX.,"MILPA ALTA, CD. MÉX.",3,0,3,0,0,0,
17-nov-22,CD. MÉX.,"COYOACAN, CD. MÉX.",2,1,3,0,0,11,
21-nov-22,CHIS.,"OCOSINGO, CHIS.",3,0,3,2,0,125,
22-nov-22,CHIS.,"COAPILLA, CHIS.",3,0,3,0,0,8,
23-nov-22,CD. MÉX.,"TLAHUAC, CD. MÉX.",1,2,3,0,2,7,
24-nov-22,Q. ROO.,"BENITO JUAREZ, Q. ROO",2,1,3,4,0,2236,
25-nov-22,TAB.,"CENTRO, TAB.",2,1,3,0,0,0,
25-nov-22,N.L.,"MONTERREY, N.L.",0,3,3,1,0,10,
26-nov-22,JAL.,"PUERTO VALLARTA, JAL.",2,1,3,0,0,0,
28-nov-22,SIN.,"NAVOLATO, SIN.",3,0,3,0,1,50,
29-nov-22,N.L.,"LINARES, N.L.",3,0,3,0,0,0,
01-dic-22,SIN.,"CULIACAN, SIN.",3,0,3,0,0,0,
02-dic-22,CHIH.,"JUÁREZ, CHIH.",3,0,3,12,0,24,
03-dic-22,CD. MÉX.,"ALVARO OBREGON, CD. MÉX.",3,0,3,0,0,0,
07-dic-22,CD. MÉX.,"GUSTAVO A. MADERO, CD. MÉX.",3,0,3,0,0,1,
07-dic-22,SON.,"HERMOSILLO, SON.",2,1,3,0,0,0,
08-dic-22,SON.,"HERMOSILLO, SON.",1,2,3,3,0,0,
10-dic-22,CHIH.,"NUEVO CASAS GRANDES, CHIH.",3,0,3,4,1,11,
14-dic-22,CHIH.,"JUÁREZ, CHIH.",2,1,3,11,0,126,
14-dic-22,CD. MÉX.,"COYOACAN, CD. MÉX.",3,0,3,0,0,53,
15-dic-22,MICH.,"ZAMORA, MICH.",1,2,3,0,0,17,
15-dic-22,CHIH.,"JUÁREZ, CHIH.",3,0,3,6,0,0,
25-ene-23,Jalisco,"AUTLAN DE NAVARRO, JAL.",0,3,3,0,0,0,
09-feb-23,Cd. de México,"TLAHUAC, CD. MÉX.",3,0,3,0,11,114,
09-feb-23,Cd. de México,"ALVARO OBREGON, CD. MÉX.",2,1,3,0,0,206,
17-feb-23,Cd. de México,"COYOACAN, CD. MÉX.",3,0,3,0,0,9,
21-feb-23,Cd. de México,"BENITO JUAREZ, CD. MÉX.",1,2,3,0,0,73,
24-feb-23,Cd. de México,"BENITO JUAREZ, CD. MÉX.",3,0,3,0,3,305,
07-mar-23,México,"ATIZAPAN, MEX.",3,0,3,0,0,51,
07-mar-23,México,"NEZAHUALCOYOTL, MEX.",2,1,3,0,0,82,
08-mar-23,Cd. de México,"CUAUHTEMOC, CD. MÉX.",3,0,3,0,0,18,
10-mar-23,México,"ECATEPEC DE MORELOS, MEX.",3,0,3,0,2,5,
13-mar-23,Chihuahua,"CHIHUAHUA, CHIH.",3,0,3,11,0,0,
14-mar-23,Chihuahua,"CHIHUAHUA, CHIH.",3,0,3,27,0,369,
15-mar-23,Veracruz,"JALTIPAN, VER.",3,0,3,16,0,"17,047",
15-mar-23,Chihuahua,"CHIHUAHUA, CHIH.",3,0,3,12,0,492,
17-mar-23,Veracruz,"JALTIPAN, VER.",3,0,3,24,0,"6,358",
17-mar-23,Cd. de México,"CUAUHTEMOC, CD. MÉX.",2,1,3,0,0,105,
21-mar-23,Coahuila,"ACUÑA, COAH.",0,3,3,2,0,57,
22-mar-23,Cd. de México,"LA MAGDALENA CONTRERAS, CD. MÉX.",3,0,3,0,0,0,
27-mar-23,México,"TOLUCA, MEX.",2,1,3,2,0,107,
28-mar-23,Cd. de México,"TLAHUAC, CD. MÉX.",1,2,3,0,0,95,
30-mar-23,Cd. de México,"ALVARO OBREGON, CD. MÉX.",2,1,3,0,0,0,
31-mar-23,Cd. de México,"AZCAPOTZALCO, CD. MÉX.",2,1,3,0,0,247,
31-mar-23,México,"TLALNEPANTLA DE BAZ, MEX.",3,0,3,0,0,50,
12-abr-23,Cd. de México,"ALVARO OBREGON, CD. MÉX.",3,0,3,0,0,3,
20-abr-23,Cd. de México,"BENITO JUAREZ, CD. MÉX.",3,0,3,0,0,48,
26-abr-23,Cd. de México,"IZTACALCO, CD. MÉX.",3,0,3,0,0,49,
27-abr-23,Cd. de México,"IZTACALCO, CD. MÉX.",0,3,3,0,0,13,
03-may-23,Michoacán,"MORELIA, MICH.",2,1,3,61,0,53,
11-may-23,Querétaro,"CORREGIDORA, QRO.",3,0,3,0,0,0,
15-may-23,Michoacán,"TARIMBARO, MICH.",1,2,3,18,0,0,
16-may-23,Cd. de México,"TLALPAN, CD. MÉX.",3,0,3,0,0,295,
16-may-23,Cd. de México,"CUAUHTEMOC, CD. MÉX.",3,0,3,0,0,85,
17-may-23,Sinaloa,"NAVOLATO, SIN.",2,1,3,0,0,0,
17-may-23,Cd. de México,"CUAUHTEMOC, CD. MÉX.",3,0,3,0,0,188,
19-may-23,Cd. de México,"CUAUHTEMOC, CD. MÉX.",1,2,3,0,0,65,
30-may-23,Sinaloa,"EL FUERTE, SIN.",2,1,3,0,0,0,
01-jun-23,Michoacán,"HIDALGO, MICH.",3,0,3,88,0,308,
04-jun-23,Aguascalientes,"RINCÓN DE ROMOS, AGS.",3,0,3,1,0,8,
05-jun-23,Sinaloa,"SINALOA, SIN.",2,1,3,0,0,28,
06-jun-23,Sinaloa,"SINALOA, SIN.",1,2,3,0,0,0,
06-jun-23,Cd. de México,"CUAUHTEMOC, CD. MÉX.",2,1,3,0,0,150,
13-jun-23,México,"NEXTLALPAN, MEX., MEX.",2,1,3,0,0,179,
14-jun-23,Cd. de México,"CUAUHTEMOC, CD. MÉX.",3,0,3,0,0,97,
14-jun-23,Cd. de México,"VENUSTIANO CARRANZA, CD. MÉX.",3,0,3,0,0,447,
17-jun-23,México,"JILOTEPEC, MEX.",2,1,3,0,0,0,
19-jun-23,México,"NICOLAS ROMERO, MEX.",2,1,3,1,0,6,
20-jun-23,Tlaxcala,"CONTLA DE JUAN CUAMATZI, TLAX.",2,1,3,0,0,0,
20-jun-23,Cd. de México,"VENUSTIANO CARRANZA, CD. MÉX.",3,0,3,0,0,0,
22-jun-23,Tlaxcala,"APIZACO, TLAX.",3,0,3,0,0,0,
23-jun-23,Guanajuato,"VALLE DE SANTIAGO, GTO.",2,1,3,0,0,103,
26-jun-23,Michoacán,"ZAMORA, MICH.",2,1,3,43,0,256,
26-jun-23,Sinaloa,"AHOME, SIN.",3,0,3,0,0,0,
26-jun-23,México,"METEPEC, MEX.",3,0,3,0,0,0,
27-jun-23,Guanajuato,"APASEO EL GRANDE, GTO.",1,2,3,0,0,19,
27-jun-23,Querétaro,"QUERETARO, QRO.",3,0,3,0,0,0,
27-jun-23,Sinaloa,"GUASAVE, SIN.",3,0,3,0,0,50,
28-jun-23,Tlaxcala,"PANOTLA, TLAX.",3,0,3,0,0,0,
29-jun-23,Cd. de México,"BENITO JUAREZ, CD. MÉX.",3,0,3,0,0,0,
29-jun-23,México,"METEPEC, MEX.",2,1,3,0,0,6,
29-jun-23,Veracruz,"TIHUATLAN, VER.",2,1,3,0,0,92,
29-jun-23,Querétaro,"QUERETARO, QRO.",3,0,3,0,0,0,
29-jun-23,Sinaloa,"GUASAVE, SIN.",2,1,3,0,0,0,
29-jun-23,Cd. de México,"CUAUHTEMOC, CD. MÉX.",3,0,3,0,0,71,
30-jun-23,Tlaxcala,"IXTACUIXTLA DE MARIANO MATAMOROS, TLAX.",1,2,3,0,0,0,
30-jun-23,Veracruz,"MISANTLA, VER.",3,0,3,17,0,291,
30-jun-23,Veracruz,"TIHUATLAN, VER.",2,1,3,0,0,137,
01-jul-23,México,"VALLE DE CHALCO SOLIDARIDAD, MEX.",3,0,3,0,1,856,
01-jul-23,México,"HUEHUETOCA, MEX.",2,1,3,0,0,4,
01-jul-23,México,"VILLA VICTORIA, MEX.",1,2,3,0,0,0,
02-jul-23,Veracruz,"MISANTLA, VER.",1,2,3,0,0,"3,523",
03-jul-23,México,"OTZOLOTEPEC, MEX.",2,1,3,0,0,211,
05-jul-23,Tlaxcala,"TLAXCALA, TLAX.",2,1,3,0,0,0,
05-jul-23,Querétaro,"CORREGIDORA, QRO.",0,3,3,0,0,0,
08-jul-23,México,"XALATLACO, MEX.",0,3,3,0,0,0,
11-jul-23,Chihuahua,"NUEVO CASAS GRANDES, CHIH.",1,2,3,18,0,0,
11-jul-23,México,"IXTAPAN DE LA SAL, MEX.",2,1,3,0,0,0,
11-jul-23,Cd. de México,"CUAUHTEMOC, CD. MÉX.",3,0,3,0,1,262,
12-jul-23,México,"CHIMALHUACAN, MEX.",3,0,3,0,0,0,
12-jul-23,México,"VALLE DE BRAVO, MEX.",3,0,3,0,0,0,
13-jul-23,Chiapas,"TAPACHULA, CHIS.",3,0,3,0,0,0,
13-jul-23,Cd. de México,"CUAUHTEMOC, CD. MÉX.",2,1,3,0,0,0,
13-jul-23,México,"COYOTEPEC, MEX.",2,1,3,0,0,0,
14-jul-23,Cd. de México,"MIGUEL HIDALGO, CD. MÉX.",2,1,3,0,0,27,
14-jul-23,México,"VALLE DE BRAVO, MEX.",3,0,3,0,0,0,
20-jul-23,México,"TULTITLAN, MEX.",3,0,3,0,0,0,
22-jul-23,México,"JOCOTITLAN, MEX.",3,0,3,0,0,0,
24-jul-23,Cd. de México,"CUAUHTEMOC, CD. MÉX.",2,1,3,0,0,385,
28-jul-23,Cd. de México,"VENUSTIANO CARRANZA, CD. MÉX.",3,0,3,0,0,413,
31-jul-23,Cd. de México,"CUAUHTEMOC, CD. MÉX.",3,0,3,0,0,63,
31-jul-23,México,"XONACATLAN, MEX.",3,0,3,0,0,531,
01-ago-23,Cd. de México,"CUAUHTEMOC, CD. MÉX.",3,0,3,0,0,150,
08-ago-23,Cd. de México,"CUAUHTEMOC, CD. MÉX.",3,0,3,0,0,214,
10-ago-23,Cd. de México,"TLAHUAC, CD. MÉX.",2,1,3,0,0,129,
10-ago-23,México,"SAN MARTIN DE LAS PIRAMIDES, MEX.",0,3,3,0,0,0,
11-ago-23,México,"ATLACOMULCO, MEX.",2,1,3,0,0,161,
12-ago-23,Michoacán,"ALVARO OBREGON, MICH.",2,1,3,5,4,0,
14-ago-23,Sinaloa,"MOCORITO, SIN.",2,1,3,0,0,0,
16-ago-23,Cd. de México,"CUAUHTEMOC, CD. MÉX.",3,0,3,0,0,0,
16-ago-23,Sinaloa,"SALVADOR ALVARADO, SIN.",2,1,3,0,0,87,
16-ago-23,Sinaloa,"MOCORITO, SIN.",2,1,3,0,0,0,
17-ago-23,Sinaloa,"BADIRAGUATO, SIN.",2,1,3,0,1,0,
18-ago-23,Cd. de México,"CUAUHTEMOC, CD. MÉX.",3,0,3,0,0,87,
21-ago-23,Cd. de México,"CUAUHTEMOC, CD. MÉX.",3,0,3,0,0,0,
22-ago-23,Sinaloa,"BADIRAGUATO, SIN.",2,1,3,0,0,0,
23-ago-23,Cd. de México,"GUSTAVO A. MADERO, CD. MÉX.",3,0,3,0,1,516,
23-ago-23,Sinaloa,"BADIRAGUATO, SIN.",3,0,3,0,0,0,
23-ago-23,Chihuahua,"JUÁREZ, CHIH.",2,1,3,22,2,116,
25-ago-23,Sinaloa,"SALVADOR ALVARADO, SIN.",1,2,3,0,0,0,
25-ago-23,Tamaulipas,"VICTORIA, TAMPS.",3,0,3,0,0,0,
28-ago-23,Cd. de México,"CUAUHTEMOC, CD. MÉX.",1,2,3,0,0,228,
29-ago-23,Tamaulipas,"REYNOSA, TAMPS.",1,2,3,14,1,162,
31-ago-23,Morelos,"JIUTEPEC, MOR.",3,0,3,0,1,0,
01-sep-23,Cd. de México,"BENITO JUAREZ, CD. MÉX.",3,0,3,0,0,110,
04-sep-23,Puebla,"TEHUACAN, PUE.",2,1,3,0,1,78,
07-sep-23,Cd. de México,"VENUSTIANO CARRANZA, CD. MÉX.",3,0,3,0,0,354,
08-sep-23,Michoacán,"MARAVATIO, MICH.",2,1,3,77,0,113,
13-sep-23,Chihuahua,"JUÁREZ, CHIH.",3,0,3,0,0,129,
18-sep-23,Cd. de México,"CUAUHTEMOC, CD. MÉX.",3,0,3,0,0,470,
19-sep-23,Cd. de México,"BENITO JUAREZ, CD. MÉX.",3,0,3,0,0,192,
20-sep-23,Cd. de México,"BENITO JUAREZ, CD. MÉX.",2,1,3,0,0,139,
22-sep-23,Cd. de México,"ALVARO OBREGON, CD. MÉX.",0,3,3,0,0,186,
26-sep-23,Cd. de México,"ALVARO OBREGON, CD. MÉX.",3,0,3,0,0,34,
27-sep-23,Veracruz,"POZA RICA DE HIDALGO, VER.",2,1,3,0,0,273,
28-sep-23,Cd. de México,"CUAUHTEMOC, CD. MÉX.",3,0,3,0,0,42,
02-oct-23,Sinaloa,"MAZATLAN, SIN.",3,0,3,0,0,5,
02-oct-23,Sinaloa,"ROSARIO, SIN.",2,1,3,0,0,0,
03-oct-23,Sinaloa,"ESCUINAPA, SIN.",2,1,3,0,0,0,
03-oct-23,Chihuahua,"JUÁREZ, CHIH.",2,1,3,0,0,32,
04-oct-23,Sinaloa,"ROSARIO, SIN.",0,3,3,0,0,0,
04-oct-23,Sinaloa,"ESCUINAPA, SIN.",2,1,3,0,0,0,
05-oct-23,Sinaloa,"MAZATLAN, SIN.",2,1,3,0,1,470,
09-oct-23,Sinaloa,"MAZATLAN, SIN.",2,1,3,0,0,"1,242",
10-oct-23,Chihuahua,"CHIHUAHUA, CHIH.",3,0,3,2,0,511,
10-oct-23,Sinaloa,"ROSARIO, SIN.",2,1,3,0,0,0,
12-oct-23,Sinaloa,"ESCUINAPA, SIN.",2,1,3,0,0,0,
16-oct-23,Coahuila,"FRONTERA, COAH.",2,1,3,3,0,0,
18-oct-23,Cd. de México,"CUAUHTEMOC, CD. MÉX.",3,0,3,0,0,41,
19-oct-23,Coahuila,"FRONTERA, COAH.",1,2,3,1,0,0,
24-oct-23,Tlaxcala,"HUAMANTLA, TLAX.",2,1,3,0,0,0,
25-oct-23,Coahuila,"FRONTERA, COAH.",3,0,3,3,0,300,
25-oct-23,Tlaxcala,"HUAMANTLA, TLAX.",3,0,3,0,0,0,
27-oct-23,Cd. de México,"GUSTAVO A. MADERO, CD. MÉX.",0,3,3,0,0,985,
31-oct-23,Coahuila,"MONCLOVA, COAH.",1,2,3,7,0,800,
02-nov-23,Tlaxcala,"TLAXCALA, TLAX.",2,1,3,0,0,0,
03-nov-23,Tlaxcala,"TLAXCALA, TLAX.",1,2,3,0,0,0,
04-nov-23,Tlaxcala,"TLAXCALA, TLAX.",3,0,3,0,0,0,
08-nov-23,Sinaloa,"SAN IGNACIO, SIN.",1,2,3,0,0,188,
09-nov-23,Cd. de México,"BENITO JUAREZ, CD. MÉX.",3,0,3,0,0,40,
12-nov-23,Guanajuato,"PENJAMO, GTO.",3,0,3,0,0,0,
23-nov-23,Chihuahua,"JUÁREZ, CHIH.",3,0,3,2,0,243,
24-nov-23,Morelos,"CUAUTLA, MOR.",2,1,3,2,1,172,
30-nov-23,México,"NEZAHUALCOYOTL, MEX.",3,0,3,3,0,336,
06-dic-23,Chihuahua,"JUÁREZ, CHIH.",3,0,3,1,0,286,
13-dic-23,Cd. de México,"COYOACAN, CD. MÉX.",2,1,3,0,0,51,
15-dic-23,Sinaloa,"CULIACAN, SIN.",3,0,3,0,0,50,
15-dic-23,Cd. de México,"CUAUHTEMOC, CD. MÉX.",3,0,3,0,0,0,
15-ene-24,Zacatecas,"JEREZ, ZAC.",3,0,3,0,0,53,
04-mar-24,Zacatecas,"FRESNILLO, ZAC.",3,0,3,27,0,217,
08-mar-24,Cd. de México,"GUSTAVO A. MADERO, CD. MÉX.",3,0,3,0,0,0,
12-mar-24,Cd. de México,"IZTAPALAPA, CD. MÉX.",3,0,3,0,0,50,
16-abr-24,Cd. de México,"CUAUHTEMOC, CD. MÉX.",2,1,3,0,0,0,
25-abr-24,Cd. de México,"CUAUHTEMOC, CD. MÉX.",3,0,3,0,0,8,
29-abr-24,Cd. de México,"LA MAGDALENA CONTRERAS, CD. MÉX.",3,0,3,0,0,0,
06-may-24,Cd. de México,"COYOACAN, CD. MÉX.",2,1,3,0,0,19,
10-may-24,Cd. de México,"COYOACAN, CD. MÉX.",1,2,3,0,0,23,
21-may-24,Cd. de México,"CUAUHTEMOC, CD. MÉX.",3,0,3,0,0,321,
28-may-24,Cd. de México,"CUAUHTEMOC, CD. MÉX.",1,2,3,0,0,"3,450",
04-jun-24,Cd. de México,"CUAUHTEMOC, CD. MÉX.",3,0,3,0,0,259,
13-jun-24,Cd. de México,"CUAUHTEMOC, CD. MÉX.",3,0,3,0,0,40,
14-jun-24,Cd. de México,"CUAUHTEMOC, CD. MÉX.",2,1,3,0,0,0,
14-jun-24,Oaxaca,"OAXACA DE JUAREZ, OAX.",3,0,3,3,4,245,
17-jun-24,Sinaloa,"BADIRAGUATO, SIN.",3,0,3,0,0,0,
20-jun-24,Cd. de México,"CUAUHTEMOC, CD. MÉX.",2,1,3,0,0,0,
19-jun-24,Michoacán,"JACONA, MICH.",2,1,3,20,0,16,
21-jun-24,Sinaloa,"BADIRAGUATO, SIN.",2,1,3,0,3,300,
21-jun-24,Sinaloa,"CULIACAN, SIN.",3,0,3,0,3,0,
24-jun-24,Sinaloa,"MOCORITO, SIN.",3,0,3,0,8,60,
26-jun-24,Zacatecas,"FRESNILLO, ZAC.",2,1,3,9,0,479,
28-jun-24,Sinaloa,"BADIRAGUATO, SIN.",1,2,3,0,0,0,
27-jun-24,Sinaloa,"SALVADOR ALVARADO, SIN.",3,0,3,0,0,653,
26-jun-24,Sinaloa,"MOCORITO, SIN.",2,1,3,0,5,785,
03-feb-13,TAMPS.,"ALTAMIRA, TAMPS.",2,0,2,0,0,0,
04-feb-13,JAL.,"ATOTONILCO EL ALTO, JAL.",2,0,2,1,0,2,
05-feb-13,CHIH.,"ROSALES, CHIH.",1,1,2,1,0,92,
05-feb-13,B.C.,"TIJUANA, B.C.",1,1,2,0,0,0,
06-feb-13,JAL.,"ATOTONILCO EL ALTO, JAL.",1,1,2,0,0,0,
06-feb-13,B.C.,"ENSENADA, B.C.",1,1,2,0,0,0,
07-feb-13,B.C.,"ENSENADA, B.C.",1,1,2,0,0,0,
08-feb-13,TAMPS.,"GUSTAVO DIAZ ORDAZ, TAMPS.",0,2,2,0,0,0,
08-feb-13,JAL.,"ATOTONILCO EL ALTO, JAL.",0,2,2,0,0,0,
11-feb-13,CHIH.,"JUÁREZ, CHIH.",0,2,2,0,0,0,
11-feb-13,CHIH.,"OJINAGA, CHIH.",2,0,2,0,0,0,
11-feb-13,JAL.,"DEGOLLADO, JAL.",2,0,2,0,0,0,
12-feb-13,JAL.,"ARANDAS, JAL.",2,0,2,3,0,18,
14-feb-13,TAMPS.,"REYNOSA, TAMPS.",0,2,2,0,0,0,
14-feb-13,B.C.,"TIJUANA, B.C.",1,1,2,0,0,0,
15-feb-13,TAMPS.,"NUEVO LAREDO, TAMPS.",2,0,2,0,0,0,
17-feb-13,GRO.,"ACAPULCO DE JUAREZ, GRO.",1,1,2,0,4,39,
18-feb-13,GRO.,"ATOYAC DE ALVAREZ, GRO.",2,0,2,1,0,0,
18-feb-13,CAMP.,"CAMP., CAMP.",0,2,2,0,0,0,
19-feb-13,CHIH.,"CHIH., CHIH.",2,0,2,0,0,336,
23-feb-13,TAMPS.,"VICTORIA, TAMPS.",2,0,2,13,4,165,
23-feb-13,JAL.,"DEGOLLADO, JAL.",2,0,2,1,0,0,
24-feb-13,TAMPS.,"CIUDAD MADERO, TAMPS.",2,0,2,5,0,784,
25-feb-13,CAMP.,"CAMP., CAMP.",2,0,2,0,0,0,
26-feb-13,CHIH.,"CHIH., CHIH.",2,0,2,2,0,86,
26-feb-13,CHIH.,"JUÁREZ, CHIH.",2,0,2,0,0,0,
26-feb-13,HGO.,"HUEJUTLA DE REYES, HGO.",2,0,2,0,0,0,
27-feb-13,CHIH.,"ALDAMA, CHIH.",1,1,2,0,0,0,
27-feb-13,JAL.,"ZAPOTLAN EL GRANDE, JAL.",2,0,2,1,0,12,
27-feb-13,JAL.,"DEGOLLADO, JAL.",2,0,2,0,0,0,
01-mar-13,N.L.,"APODACA, N.L.",2,0,2,0,0,251,
01-mar-13,TAMPS.,"VICTORIA, TAMPS.",2,0,2,0,5,0,
02-mar-13,HGO.,"TULA DE ALLENDE, HGO.",2,0,2,0,0,0,
03-mar-13,TAMPS.,"TAMPICO, TAMPS.",2,0,2,35,0,1807,
03-mar-13,N.L.,"SAN NICOLAS DE LOS GARZA, N.L.",2,0,2,0,0,510,
03-mar-13,TAMPS.,"TAMPICO, TAMPS.",2,0,2,0,0,106,
03-mar-13,TAMPS.,"CIUDAD MADERO, TAMPS.",2,0,2,29,3,713,
04-mar-13,N.L.,"GUADALUPE, N.L.",1,1,2,1,0,35,
04-mar-13,N.L.,"SANTA CATARINA, N.L.",1,1,2,0,0,56,
04-mar-13,N.L.,"SAN PEDRO GARZA GARCIA, N.L.",2,0,2,2,1,1683,
05-mar-13,HGO.,"PACHUCA DE SOTO, HGO.",2,0,2,0,6,104,
05-mar-13,CHIH.,"CHIH., CHIH.",2,0,2,4,0,273,
05-mar-13,N.L.,"JUAREZ, N.L.",1,1,2,0,0,100,
05-mar-13,N.L.,"SAN PEDRO GARZA GARCIA, N.L.",2,0,2,7,0,1525,
06-mar-13,HGO.,"TULA DE ALLENDE, HGO.",0,2,2,0,0,0,
06-mar-13,HGO.,"HUEJUTLA DE REYES, HGO.",1,1,2,0,0,0,
06-mar-13,HGO.,"PACHUCA DE SOTO, HGO.",2,0,2,0,2,55,
07-mar-13,HGO.,"TULA DE ALLENDE, HGO.",2,0,2,0,0,0,
07-mar-13,N.L.,"GRAL. ESCOBEDO, N.L.",1,1,2,0,0,1300,
07-mar-13,CAMP.,"HOPELCHÉN, CAMP.",2,0,2,0,0,0,
07-mar-13,CHIH.,"CHIH., CHIH.",1,1,2,4,0,33,
07-mar-13,TAMPS.,"VICTORIA, TAMPS.",0,2,2,0,0,91,
08-mar-13,TAMPS.,"NUEVO LAREDO, TAMPS.",0,2,2,0,0,108,
08-mar-13,TAMPS.,"GUSTAVO DIAZ ORDAZ, TAMPS.",1,1,2,0,0,0,
09-mar-13,JAL.,"PUERTO VALLARTA, JAL.",1,1,2,0,0,0,
09-mar-13,N.L.,"GRAL. ESCOBEDO, N.L.",2,0,2,0,0,1100,
09-mar-13,TAMPS.,"TAMPICO, TAMPS.",2,0,2,0,0,0,
11-mar-13,HGO.,"TIZAYUCA, HGO.",2,0,2,0,1,100,
12-mar-13,HGO.,"IXMIQUILPAN, HGO.",2,0,2,0,0,0,
12-mar-13,HGO.,"TEPEAPULCO, HGO.",1,1,2,0,1,0,
12-mar-13,VER.,"TUXPAM, VER.",2,0,2,0,0,0,
12-mar-13,CHIH.,"CHIH., CHIH.",1,1,2,4,0,101,
13-mar-13,HGO.,"ACTOPAN, HGO.",2,0,2,0,0,0,
13-mar-13,HGO.,"IXMIQUILPAN, HGO.",1,1,2,0,0,0,
14-mar-13,CAMP.,"HOPELCHÉN, CAMP.",1,1,2,0,0,0,
14-mar-13,AGS.,"AGS., AGS.",2,0,2,0,0,0,
14-mar-13,HGO.,"TEPEAPULCO, HGO.",1,1,2,0,0,74,
15-mar-13,HGO.,"ACTOPAN, HGO.",2,0,2,0,0,0,
15-mar-13,VER.,"OTEAPAN, VER.",0,2,2,0,0,0,
15-mar-13,VER.,"VER., VER.",2,0,2,1,0,465,
15-mar-13,TAMPS.,"TAMPICO, TAMPS.",2,0,2,21,2,532,
15-mar-13,S.L.P.,"AHUALULCO, S.L.P.",2,0,2,0,0,0,
16-mar-13,HGO.,"IXMIQUILPAN, HGO.",2,0,2,0,0,0,
16-mar-13,VER.,"VER., VER.",2,0,2,0,0,0,
18-mar-13,N.L.,"CADEREYTA JIMENEZ, N.L.",1,1,2,0,0,21,
18-mar-13,HGO.,"IXMIQUILPAN, HGO.",2,0,2,0,1,0,
19-mar-13,HGO.,"TEPEAPULCO, HGO.",1,1,2,0,0,105,
19-mar-13,HGO.,"TIZAYUCA, HGO.",0,2,2,0,0,100,
19-mar-13,CHIH.,"CUAUHTÉMOC, CHIH.",1,1,2,0,0,0,
19-mar-13,TAMPS.,"VICTORIA, TAMPS.",2,0,2,0,0,50,
20-mar-13,HGO.,"IXMIQUILPAN, HGO.",2,0,2,0,0,0,
21-mar-13,HGO.,"TEPEAPULCO, HGO.",2,0,2,0,0,0,
21-mar-13,S.L.P.,"SOLEDAD DE GRACIANO SANCHEZ, S.L.P.",2,0,2,0,0,0,
22-mar-13,CHIH.,"MANUEL BENAVIDES, CHIH.",0,2,2,0,0,0,
22-mar-13,CHIH.,"CUAUHTÉMOC, CHIH.",2,0,2,0,0,0,
22-mar-13,HGO.,"TEPEAPULCO, HGO.",2,0,2,0,0,0,
23-mar-13,TAMPS.,"TAMPICO, TAMPS.",2,0,2,15,0,150,
24-mar-13,TAMPS.,"TAMPICO, TAMPS.",0,2,2,20,1,91,
25-mar-13,HGO.,"TEPEAPULCO, HGO.",0,2,2,0,3,0,
25-mar-13,HGO.,"TIZAYUCA, HGO.",1,1,2,0,0,93,
25-mar-13,CHIH.,"CUAUHTÉMOC, CHIH.",2,0,2,0,0,0,
26-mar-13,VER.,"CARLOS A. CARRILLO, VER.",2,0,2,0,0,0,
26-mar-13,S.L.P.,"SOLEDAD DE GRACIANO SANCHEZ, S.L.P.",2,0,2,0,1,54,
26-mar-13,VER.,"VER., VER.",1,1,2,0,0,5,
26-mar-13,CHIH.,"CUAUHTÉMOC, CHIH.",2,0,2,0,0,0,
28-mar-13,YUC.,"VALLADOLID, YUC.",2,0,2,0,0,171,
29-mar-13,YUC.,"VALLADOLID, YUC.",2,0,2,0,0,0,
30-mar-13,N.L.,"ALLENDE, N.L.",0,2,2,0,0,0,
31-mar-13,Q. ROO,"OTHON P. BLANCO, Q. ROO",1,1,2,0,0,25,
31-mar-13,Q. ROO,"BENITO JUAREZ, Q. ROO",2,0,2,0,0,166,
01-abr-13,MICH.,"SALVADOR ESCALANTE, MICH.",1,1,2,0,0,0,
01-abr-13,TAMPS.,"XICOTENCATL, TAMPS.",1,1,2,0,0,0,
01-abr-13,TAMPS.,"XICOTENCATL, TAMPS.",1,1,2,0,0,337,
04-abr-13,COL.,"COL., COL.",2,0,2,0,0,24,
04-abr-13,MICH.,"LA HUACANA, MICH.",2,0,2,0,0,0,
05-abr-13,MICH.,"LA HUACANA, MICH.",1,1,2,0,0,0,
06-abr-13,JAL.,"CABO CORRIENTES, JAL.",2,0,2,0,0,0,
06-abr-13,TAMPS.,"GONZALEZ, TAMPS.",2,0,2,1,0,12,
06-abr-13,COL.,"COL., COL.",2,0,2,0,0,26,
06-abr-13,B.C.,"TIJUANA, B.C.",1,1,2,0,3,0,
06-abr-13,Q. ROO,"BENITO JUAREZ, Q. ROO",2,0,2,0,0,273,
06-abr-13,COAH.,"MONCLOVA, COAH.",1,1,2,0,2,62,
08-abr-13,N.L.,"LOS HERRERAS, N.L.",1,1,2,2,0,750,
08-abr-13,MICH.,"SALVADOR ESCALANTE, MICH.",1,1,2,1,0,0,
08-abr-13,MEX.,"IXTAPAN DE LA SAL, MEX.",0,2,2,0,0,0,
09-abr-13,NAY.,"TEPIC, NAY.",1,1,2,0,0,0,
09-abr-13,MEX.,"IXTAPAN DE LA SAL, MEX.",2,0,2,1,0,6,
09-abr-13,OAX.,"SANTIAGO PINOTEPA NACIONAL, OAX.",2,0,2,0,0,0,
09-abr-13,CHIH.,"CUAUHTÉMOC, CHIH.",2,0,2,0,0,0,
10-abr-13,MICH.,"SALVADOR ESCALANTE, MICH.",0,2,2,0,0,0,
10-abr-13,N.L.,"GALEANA, N.L.",0,2,2,0,0,0,
10-abr-13,TAMPS.,"VICTORIA, TAMPS.",2,0,2,0,2,0,
11-abr-13,N.L.,"MINA, N.L.",1,1,2,6,0,150,
11-abr-13,OAX.,"SAN AGUSTIN ETLA, OAX.",0,2,2,0,0,520,
12-abr-13,CHIH.,"JANOS, CHIH.",1,1,2,0,0,0,
12-abr-13,NAY.,"ACAPONETA, NAY.",0,2,2,0,0,0,
12-abr-13,HGO.,"TIZAYUCA, HGO.",2,0,2,0,0,110,
12-abr-13,MICH.,"LA HUACANA, MICH.",2,0,2,0,0,0,
13-abr-13,OAX.,"PINOTEPA DE DON LUIS, OAX.",2,0,2,0,0,0,
13-abr-13,MICH.,"SALVADOR ESCALANTE, MICH.",2,0,2,0,0,0,
13-abr-13,MICH.,"LA HUACANA, MICH.",2,0,2,0,0,0,
14-abr-13,OAX.,"MATIAS ROMERO AVENDAÑO, OAX.",1,1,2,0,0,0,
14-abr-13,N.L.,"GALEANA, N.L.",2,0,2,0,0,0,
14-abr-13,TAMPS.,"TAMPICO, TAMPS.",2,0,2,2,0,20,
14-abr-13,TAMPS.,"GONZALEZ, TAMPS.",1,1,2,1,0,189,
16-abr-13,S.L.P.,"MATEHUALA, S.L.P.",2,0,2,0,0,0,
17-abr-13,MICH.,"TACAMBARO, MICH.",0,2,2,0,0,0,
18-abr-13,VER.,"MEDELLIN, VER.",2,0,2,0,0,9,
18-abr-13,NAY.,"ACAPONETA, NAY.",1,1,2,0,0,0,
18-abr-13,S.L.P.,"RIOVERDE, S.L.P.",2,0,2,0,0,0,
18-abr-13,TAMPS.,"REYNOSA, TAMPS.",1,1,2,0,0,0,
19-abr-13,OAX.,"JUCHITAN DE ZARAGOZA, OAX.",2,0,2,16,0,0,
19-abr-13,TAMPS.,"CIUDAD MADERO, TAMPS.",2,0,2,0,0,179,
20-abr-13,OAX.,"SANTIAGO NILTEPEC, OAX.",1,1,2,0,0,0,
20-abr-13,OAX.,"SAN MIGUEL EL GRANDE, OAX.",0,2,2,0,0,0,
20-abr-13,TAMPS.,"GONZALEZ, TAMPS.",1,1,2,2,0,0,
20-abr-13,N.L.,"CARMEN, N.L.",1,1,2,1,0,100,
21-abr-13,OAX.,"SAN MIGUEL EL GRANDE, OAX.",1,1,2,0,0,0,
22-abr-13,HGO.,"HUEHUETLA, HGO.",2,0,2,0,0,0,
22-abr-13,CHIS.,"SALTO DE AGUA, CHIS.",1,1,2,0,0,0,
23-abr-13,NAY.,"ACAPONETA, NAY.",1,1,2,0,0,0,
23-abr-13,QRO.,"ARROYO SECO, QRO.",2,0,2,0,0,0,
23-abr-13,VER.,"BOCA DEL RIO, VER.",2,0,2,2,0,52,
23-abr-13,B.C.,"ENSENADA, B.C.",1,1,2,0,0,0,
23-abr-13,GRO.,"PETATLAN, GRO.",2,0,2,0,0,0,
23-abr-13,GRO.,"ZIHUATANEJO DE AZUETA, GRO.",2,0,2,0,0,0,
23-abr-13,S.L.P.,"SALINAS, S.L.P.",1,1,2,0,0,0,
23-abr-13,AGS.,"SAN FRANCISCO DE LOS ROMO, AGS.",2,0,2,1,0,48,
23-abr-13,SIN.,"GUASAVE, SIN.",1,1,2,0,9,0,
24-abr-13,AGS.,"SAN FRANCISCO DE LOS ROMO, AGS.",2,0,2,0,0,205,
24-abr-13,S.L.P.,"SALINAS, S.L.P.",2,0,2,0,0,0,
25-abr-13,S.L.P.,"SALINAS, S.L.P.",2,0,2,0,0,0,
25-abr-13,VER.,"BOCA DEL RIO, VER.",2,0,2,0,0,15,
25-abr-13,COL.,"COL., COL.",2,0,2,0,1,227,
25-abr-13,NAY.,"ACAPONETA, NAY.",0,2,2,0,0,0,
25-abr-13,MICH.,"APATZINGAN, MICH.",2,0,2,1,0,0,
25-abr-13,OAX.,"SAN JOSE CHILTEPEC, OAX.",2,0,2,0,0,0,
26-abr-13,MICH.,"CHURUMUCO, MICH.",2,0,2,0,0,0,
26-abr-13,N.L.,"GRAL. ZUAZUA, N.L.",2,0,2,1,0,50,
26-abr-13,VER.,"MEDELLIN, VER.",0,2,2,0,0,0,
26-abr-13,QRO.,"JALPAN DE SERRA, QRO.",2,0,2,0,0,0,
26-abr-13,MICH.,"TACAMBARO, MICH.",2,0,2,0,0,0,
26-abr-13,TAMPS.,"MAINERO, TAMPS.",2,0,2,0,0,0,
27-abr-13,OAX.,"LOMA BONITA, OAX.",2,0,2,0,0,0,
27-abr-13,VER.,"CORDOBA, VER.",2,0,2,1,0,24,
27-abr-13,TAMPS.,"VICTORIA, TAMPS.",2,0,2,7,3,80,
27-abr-13,TAMPS.,"TAMPICO, TAMPS.",1,1,2,18,0,872,
27-abr-13,OAX.,"LOMA BONITA, OAX.",2,0,2,0,0,0,
27-abr-13,YUC.,"TICUL, YUC.",1,1,2,0,0,0,
28-abr-13,CHIS.,"LAS MARGARITAS, CHIS.",2,0,2,0,0,0,
28-abr-13,MICH.,"MARAVATIO, MICH.",2,0,2,0,1,0,
28-abr-13,TAMPS.,"GONZALEZ, TAMPS.",2,0,2,0,0,45,
29-abr-13,VER.,"MEDELLIN, VER.",1,1,2,0,0,0,
29-abr-13,OAX.,"SANTA MARIA HUATULCO, OAX.",1,1,2,0,0,0,
29-abr-13,SIN.,"EL FUERTE, SIN.",0,2,2,0,8,0,
30-abr-13,CHIS.,"LAS MARGARITAS, CHIS.",2,0,2,0,0,0,
30-abr-13,SIN.,"EL FUERTE, SIN.",1,1,2,0,12,0,
30-abr-13,B.C.,"ENSENADA, B.C.",0,2,2,0,0,0,
30-abr-13,TAMPS.,"XICOTENCATL, TAMPS.",2,0,2,0,0,0,
30-abr-13,B.C.,"ENSENADA, B.C.",0,2,2,0,0,0,
01-may-13,SIN.,"EL FUERTE, SIN.",0,2,2,0,0,0,
01-may-13,N.L.,"CIENEGA DE FLORES, N.L.",1,1,2,5,0,200,
02-may-13,N.L.,"LINARES, N.L.",0,2,2,1,0,30,
02-may-13,VER.,"MEDELLIN, VER.",2,0,2,0,0,0,
02-may-13,CHIS.,"LAS MARGARITAS, CHIS.",1,1,2,0,0,0,
02-may-13,MICH.,"AGUILILLA, MICH.",2,0,2,1,0,0,
03-may-13,OAX.,"LOMA BONITA, OAX.",2,0,2,0,0,0,
03-may-13,CHIS.,"LAS MARGARITAS, CHIS.",1,1,2,0,0,0,
03-may-13,MICH.,"TURICATO, MICH.",2,0,2,0,0,0,
03-may-13,B.C.,"TIJUANA, B.C.",1,1,2,0,0,0,
03-may-13,B.C.,"ENSENADA, B.C.",1,1,2,0,0,0,
03-may-13,TAMPS.,"CIUDAD MADERO, TAMPS.",2,0,2,0,0,0,
04-may-13,TAB.,"CARDENAS, TAB.",2,0,2,0,0,0,
05-may-13,MICH.,"TURICATO, MICH.",2,0,2,0,0,0,
06-may-13,MICH.,"TURICATO, MICH.",1,1,2,0,0,0,
07-may-13,CAMP.,"CHAMPOTÓN, CAMP.",1,1,2,0,0,0,
07-may-13,NAY.,"TEPIC, NAY.",2,0,2,0,0,0,
07-may-13,TAMPS.,"EL MANTE, TAMPS.",1,1,2,0,0,0,
07-may-13,B.C.,"ENSENADA, B.C.",0,2,2,0,0,0,
08-may-13,MICH.,"AGUILILLA, MICH.",1,1,2,0,0,0,
08-may-13,GRO.,"ACAPULCO DE JUAREZ, GRO.",1,1,2,0,1,45,
08-may-13,MICH.,"TURICATO, MICH.",2,0,2,0,0,0,
08-may-13,B.C.S.,"MULEGÉ, B.C.S.",0,2,2,0,0,0,
09-may-13,MICH.,"JIQUILPAN, MICH.",1,1,2,0,0,0,
09-may-13,TAB.,"CARDENAS, TAB.",2,0,2,0,0,0,
09-may-13,B.C.,"ENSENADA, B.C.",1,1,2,0,0,0,
11-may-13,B.C.,"ENSENADA, B.C.",1,1,2,0,0,0,
12-may-13,MICH.,"ZACAPU, MICH.",2,0,2,0,0,0,
12-may-13,MICH.,"TURICATO, MICH.",1,1,2,0,0,0,
13-may-13,MICH.,"HUETAMO, MICH.",2,0,2,0,0,0,
13-may-13,CHIS.,"OCOSINGO, CHIS.",0,2,2,0,0,0,
13-may-13,B.C.S.,"MULEGÉ, B.C.S.",0,2,2,0,0,0,
14-may-13,MICH.,"URUAPAN, MICH.",1,1,2,2,0,0,
14-may-13,TAMPS.,"EL MANTE, TAMPS.",1,1,2,0,0,0,
16-may-13,SIN.,"SIN., SIN.",1,1,2,0,14,0,
17-may-13,TAB.,"HUIMANGUILLO, TAB.",2,0,2,0,0,0,
17-may-13,SIN.,"SIN., SIN.",2,0,2,0,6,0,
18-may-13,MICH.,"LAZARO CARDENAS, MICH.",2,0,2,0,0,0,
18-may-13,N.L.,"PESQUERIA, N.L.",1,1,2,6,0,500,
18-may-13,TAMPS.,"REYNOSA, TAMPS.",2,0,2,0,0,0,
18-may-13,TAMPS.,"REYNOSA, TAMPS.",2,0,2,0,0,0,
19-may-13,VER.,"OTEAPAN, VER.",0,2,2,0,0,0,
19-may-13,AGS.,"AGS., AGS.",0,2,2,0,0,200,
19-may-13,VER.,"VER., VER.",1,1,2,0,1,0,
19-may-13,GRO.,"ATOYAC DE ALVAREZ, GRO.",1,1,2,0,0,0,
19-may-13,B.C.,"ENSENADA, B.C.",0,2,2,0,0,0,
20-may-13,TAB.,"HUIMANGUILLO, TAB.",1,1,2,0,0,0,
20-may-13,CHIH.,"JUÁREZ, CHIH.",2,0,2,0,0,0,
21-may-13,CHIH.,"JUÁREZ, CHIH.",0,2,2,0,0,0,
21-may-13,TAB.,"HUIMANGUILLO, TAB.",2,0,2,0,0,0,
21-may-13,N.L.,"AGUALEGUAS, N.L.",1,1,2,0,0,200,
21-may-13,COAH.,"TORREÓN, COAH.",2,0,2,0,0,0,
22-may-13,MICH.,"ZITACUARO, MICH.",1,1,2,0,0,0,
22-may-13,N.L.,"LOS RAMONES, N.L.",1,1,2,3,0,0,
22-may-13,MICH.,"LAZARO CARDENAS, MICH.",2,0,2,0,0,0,
22-may-13,COAH.,"MONCLOVA, COAH.",2,0,2,1,0,0,
22-may-13,MICH.,"ZITACUARO, MICH.",1,1,2,0,0,0,
22-may-13,B.C.,"MEXICALI, B.C.",1,1,2,0,7,0,
23-may-13,S.L.P.,"SAN LUIS POTOSI, S.L.P.",2,0,2,0,0,0,
23-may-13,AGS.,"SAN JOSÉ DE GRACIA, AGS.",2,0,2,0,0,14,
23-may-13,CHIS.,"COMITAN DE DOMÍNGUEZ, CHIS.",2,0,2,0,0,0,
23-may-13,B.C.S.,"MULEGÉ, B.C.S.",0,2,2,0,0,0,
23-may-13,B.C.,"ENSENADA, B.C.",0,2,2,0,0,0,
24-may-13,AGS.,"SAN JOSÉ DE GRACIA, AGS.",0,2,2,0,0,48,
24-may-13,N.L.,"PARAS, N.L.",0,2,2,0,0,0,
24-may-13,OAX.,"MIAHUATLAN DE PORFIRIO DIAZ, OAX.",2,0,2,30,0,49,
24-may-13,B.C.S.,"MULEGÉ, B.C.S.",2,0,2,0,0,0,
25-may-13,N.L.,"PARAS, N.L.",0,2,2,4,0,25,
25-may-13,S.L.P.,"CIUDAD VALLES, S.L.P.",2,0,2,0,0,0,
27-may-13,MICH.,"ZITACUARO, MICH.",2,0,2,1,0,0,
27-may-13,MICH.,"COAHUAYANA, MICH.",1,1,2,2,0,20,
27-may-13,CHIH.,"JUÁREZ, CHIH.",1,1,2,0,0,0,
27-may-13,CHIS.,"COMITAN DE DOMÍNGUEZ, CHIS.",2,0,2,0,0,0,
28-may-13,N.L.,"DR. ARROYO, N.L.",0,2,2,17,0,50,
28-may-13,CHIH.,"CUAUHTÉMOC, CHIH.",1,1,2,0,0,0,
28-may-13,MICH.,"LAZARO CARDENAS, MICH.",2,0,2,0,0,0,
28-may-13,B.C.S.,"MULEGÉ, B.C.S.",0,2,2,0,0,0,
29-may-13,MICH.,"COAHUAYANA, MICH.",2,0,2,2,0,0,
29-may-13,OAX.,"MIAHUATLAN DE PORFIRIO DIAZ, OAX.",2,0,2,5,1,0,
30-may-13,NAY.,"ROSAMORADA, NAY.",0,2,2,0,0,0,
30-may-13,MICH.,"LAZARO CARDENAS, MICH.",2,0,2,0,0,0,
30-may-13,S.L.P.,"CIUDAD VALLES, S.L.P.",1,1,2,0,0,0,
31-may-13,SIN.,"SALVADOR ALVARADO, SIN.",1,1,2,0,11,0,
31-may-13,TAB.,"BALANCAN, TAB.",1,1,2,0,0,0,
31-may-13,B.C.S.,"MULEGÉ, B.C.S.",0,2,2,0,0,0,
31-may-13,B.C.S.,"MULEGÉ, B.C.S.",0,2,2,0,0,0,
31-may-13,B.C.,"TIJUANA, B.C.",1,1,2,0,0,0,
01-jun-13,TAB.,"HUIMANGUILLO, TAB.",2,0,2,1,0,5,
02-jun-13,OAX.,"MATIAS ROMERO AVENDAÑO, OAX.",1,1,2,0,0,0,
04-jun-13,S.L.P.,"SAN LUIS POTOSI, S.L.P.",2,0,2,0,0,0,
05-jun-13,COAH.,"ACUÑA, COAH.",0,2,2,0,0,0,
05-jun-13,B.C.,"TIJUANA, B.C.",2,0,2,0,0,0,
05-jun-13,S.L.P.,"CIUDAD VALLES, S.L.P.",2,0,2,0,0,0,
05-jun-13,S.L.P.,"SAN LUIS POTOSI, S.L.P.",2,0,2,0,0,0,
06-jun-13,NAY.,"ROSAMORADA, NAY.",2,0,2,0,0,0,
07-jun-13,OAX.,"CIUDAD IXTEPEC, OAX.",0,2,2,0,0,0,
08-jun-13,B.C.,"TIJUANA, B.C.",0,2,2,0,0,0,
09-jun-13,MICH.,"APATZINGAN, MICH.",1,1,2,0,0,0,
09-jun-13,B.C.S.,"LA PAZ, B.C.S.",2,0,2,0,0,0,
10-jun-13,TAB.,"BALANCAN, TAB.",2,0,2,0,0,0,
11-jun-13,S.L.P.,"SAN LUIS POTOSI, S.L.P.",1,1,2,0,0,0,
12-jun-13,OAX.,"MATIAS ROMERO AVENDAÑO, OAX.",1,1,2,0,0,0,
12-jun-13,B.C.S.,"MULEGÉ, B.C.S.",0,2,2,0,0,0,
13-jun-13,S.L.P.,"CIUDAD VALLES, S.L.P.",1,1,2,0,0,0,
14-jun-13,B.C.,"ENSENADA, B.C.",0,2,2,0,0,0,
14-jun-13,MICH.,"BUENAVISTA, MICH.",0,2,2,0,0,0,
14-jun-13,CHIH.,"ALDAMA, CHIH.",0,2,2,0,0,0,
14-jun-13,TAMPS.,"EL MANTE, TAMPS.",1,1,2,0,0,0,
14-jun-13,TAMPS.,"VICTORIA, TAMPS.",2,0,2,0,3,0,
15-jun-13,CHIS.,"YAJALÓN, CHIS.",0,2,2,0,0,0,
16-jun-13,B.C.S.,"LOS CABOS, B.C.S.",1,1,2,1,0,0,
18-jun-13,SIN.,"BADIRAGUATO, SIN.",0,2,2,0,0,0,
19-jun-13,COAH.,"TORREÓN, COAH.",0,2,2,0,0,0,
19-jun-13,B.C.,"TIJUANA, B.C.",1,1,2,0,0,0,
21-jun-13,B.C.S.,"LA PAZ, B.C.S.",0,2,2,0,0,0,
22-jun-13,GRO.,"ATENANGO DEL RIO, GRO.",1,1,2,0,0,0,
22-jun-13,CHIH.,"CHIH., CHIH.",2,0,2,0,0,8,
22-jun-13,B.C.S.,"MULEGÉ, B.C.S.",0,2,2,0,0,0,
22-jun-13,TAMPS.,"GONZALEZ, TAMPS.",2,0,2,0,0,23,
23-jun-13,B.C.S.,"LOS CABOS, B.C.S.",0,2,2,0,0,0,
23-jun-13,TAB.,"BALANCAN, TAB.",2,0,2,0,0,0,
24-jun-13,NAY.,"RUIZ, NAY.",1,1,2,0,0,0,
24-jun-13,PUE.,"TEHUACAN, PUE.",2,0,2,0,0,0,
25-jun-13,COAH.,"SACRAMENTO, COAH.",1,1,2,0,0,0,
26-jun-13,B.C.,"TIJUANA, B.C.",0,2,2,0,0,0,
27-jun-13,PUE.,"HUAUCHINANGO, PUE.",1,1,2,0,0,50,
27-jun-13,TAB.,"BALANCAN, TAB.",2,0,2,0,0,0,
27-jun-13,CHIS.,"CHICOMUSELO, CHIS.",1,1,2,0,0,0,
28-jun-13,CHIS.,"CHICOMUSELO, CHIS.",1,1,2,0,0,0,
28-jun-13,PUE.,"HUAUCHINANGO, PUE.",2,0,2,0,0,0,
29-jun-13,CHIS.,"YAJALÓN, CHIS.",0,2,2,0,0,0,
29-jun-13,B.C.S.,"MULEGÉ, B.C.S.",2,0,2,0,0,0,
29-jun-13,B.C.,"TIJUANA, B.C.",2,0,2,0,0,0,
30-jun-13,JAL.,"AUTLAN DE NAVARRO, JAL.",2,0,2,0,0,0,
30-jun-13,B.C.S.,"LA PAZ, B.C.S.",1,1,2,0,0,0,
01-jul-13,NAY.,"HUAJICORI, NAY.",2,0,2,0,0,0,
02-jul-13,PUE.,"XICOTEPEC, PUE.",2,0,2,0,0,50,
03-jul-13,B.C.,"ENSENADA, B.C.",0,2,2,0,0,0,
03-jul-13,SIN.,"NAVOLATO, SIN.",1,1,2,0,2,0,
04-jul-13,CHIS.,"TONALÁ, CHIS.",0,2,2,1,0,0,
05-jul-13,NAY.,"HUAJICORI, NAY.",2,0,2,0,0,0,
06-jul-13,JAL.,"CIHUATLAN, JAL.",0,2,2,0,0,24,
06-jul-13,CHIS.,"TONALÁ, CHIS.",2,0,2,0,0,0,
08-jul-13,TAB.,"TEAPA, TAB.",2,0,2,1,0,0,
08-jul-13,PUE.,"TEHUACAN, PUE.",2,0,2,0,0,50,
09-jul-13,CHIS.,"CINTALAPA, CHIS.",1,1,2,0,0,0,
09-jul-13,PUE.,"TEHUACAN, PUE.",2,0,2,0,0,0,
09-jul-13,B.C.,"ENSENADA, B.C.",0,2,2,0,0,0,
09-jul-13,N.L.,"JUAREZ, N.L.",0,2,2,0,0,0,
10-jul-13,SIN.,"NAVOLATO, SIN.",2,0,2,0,0,0,
11-jul-13,PUE.,"TECAMACHALCO, PUE.",0,2,2,0,0,0,
11-jul-13,CHIS.,"HUEHUETÁN, CHIS.",2,0,2,0,0,0,
11-jul-13,CHIS.,"JIQUIPILAS, CHIS.",1,1,2,0,0,0,
11-jul-13,B.C.,"ENSENADA, B.C.",1,1,2,0,0,0,
12-jul-13,SIN.,"NAVOLATO, SIN.",2,0,2,0,6,0,
13-jul-13,CHIS.,"HUEHUETÁN, CHIS.",0,2,2,0,0,0,
14-jul-13,TAB.,"BALANCAN, TAB.",1,1,2,0,0,0,
15-jul-13,COAH.,"TORREÓN, COAH.",2,0,2,0,0,0,
15-jul-13,B.C.,"TIJUANA, B.C.",1,1,2,0,0,0,
16-jul-13,CHIH.,"MADERA, CHIH.",1,1,2,9,0,0,
16-jul-13,COAH.,"TORREÓN, COAH.",2,0,2,0,0,0,
17-jul-13,NAY.,"AHUACATLAN, NAY.",1,1,2,0,0,0,
17-jul-13,TAB.,"TEAPA, TAB.",1,1,2,2,0,7,
17-jul-13,COAH.,"TORREÓN, COAH.",2,0,2,0,0,0,
17-jul-13,PUE.,"HUITZILAN DE SERDAN, PUE.",0,2,2,3,0,100,
18-jul-13,CHIS.,"JIQUIPILAS, CHIS.",1,1,2,0,0,0,
18-jul-13,PUE.,"PUE., PUE.",2,0,2,5,1,255,
18-jul-13,QRO.,"QUERETARO, QRO.",2,0,2,0,1,0,
18-jul-13,QRO.,"CORREGIDORA, QRO.",2,0,2,0,1,0,
19-jul-13,PUE.,"LOS REYES DE JUAREZ, PUE.",1,1,2,0,0,0,
19-jul-13,COAH.,"TORREÓN, COAH.",1,1,2,0,0,0,
20-jul-13,VER.,"COATZACOALCOS, VER.",2,0,2,0,0,0,
20-jul-13,PUE.,"SAN MARTIN TEXMELUCAN, PUE.",2,0,2,0,0,0,
20-jul-13,N.L.,"GRAL. ESCOBEDO, N.L.",1,1,2,0,0,0,
20-jul-13,JAL.,"TALPA DE ALLENDE, JAL.",2,0,2,0,0,0,
22-jul-13,COAH.,"TORREÓN, COAH.",2,0,2,0,0,0,
22-jul-13,AGS.,"ASIENTOS, AGS.",1,1,2,0,0,234,
22-jul-13,PUE.,"VENUSTIANO CARRANZA, PUE.",1,1,2,0,0,0,
23-jul-13,NAY.,"COMPOSTELA, NAY.",0,2,2,0,0,0,
24-jul-13,PUE.,"LOS REYES DE JUAREZ, PUE.",1,1,2,0,0,50,
24-jul-13,GRO.,"ACAPULCO DE JUAREZ, GRO.",2,0,2,0,3,7,
24-jul-13,JAL.,"GUADALAJARA, JAL.",1,1,2,0,0,0,
24-jul-13,B.C.,"TIJUANA, B.C.",0,2,2,0,0,0,
25-jul-13,CHIS.,"TUZANTÁN, CHIS.",1,1,2,0,0,40,
25-jul-13,PUE.,"SAN MARTIN TEXMELUCAN, PUE.",2,0,2,0,3,125,
25-jul-13,TAMPS.,"NUEVO LAREDO, TAMPS.",0,2,2,0,0,36,
26-jul-13,PUE.,"SAN MARTIN TEXMELUCAN, PUE.",2,0,2,1,2,378,
26-jul-13,MOR.,"PUENTE DE IXTLA, MOR.",1,1,2,0,0,0,
26-jul-13,S.L.P.,"CIUDAD DEL MAIZ, S.L.P.",2,0,2,0,0,0,
26-jul-13,CHIS.,"TUXTLA GUTIÉRREZ, CHIS.",1,1,2,0,2,475,
27-jul-13,CHIS.,"TUZANTÁN, CHIS.",1,1,2,0,0,0,
27-jul-13,N.L.,"GRAL. ESCOBEDO, N.L.",2,0,2,11,0,260,
27-jul-13,B.C.S.,"MULEGÉ, B.C.S.",1,1,2,0,0,0,
28-jul-13,CHIS.,"TUXTLA GUTIÉRREZ, CHIS.",1,1,2,0,2,475,
28-jul-13,CHIS.,"TUZANTÁN, CHIS.",2,0,2,0,2,2,
29-jul-13,NAY.,"TECUALA, NAY.",2,0,2,0,0,0,
29-jul-13,N.L.,"GARCIA, N.L.",1,1,2,10,0,0,
29-jul-13,B.C.,"TIJUANA, B.C.",1,1,2,0,0,0,
29-jul-13,B.C.,"ENSENADA, B.C.",0,2,2,0,0,0,
29-jul-13,TLAX.,"TLAX., TLAX.",2,0,2,1,0,20,
29-jul-13,PUE.,"VENUSTIANO CARRANZA, PUE.",0,2,2,0,0,0,
30-jul-13,B.C.,"ENSENADA, B.C.",2,0,2,0,0,0,
30-jul-13,PUE.,"PUE., PUE.",2,0,2,0,0,0,
31-jul-13,N.L.,"GARCIA, N.L.",1,1,2,0,0,0,
31-jul-13,NAY.,"COMPOSTELA, NAY.",0,2,2,0,0,0,
31-jul-13,B.C.,"TIJUANA, B.C.",1,1,2,0,0,0,
01-ago-13,PUE.,"SAN MARTIN TEXMELUCAN, PUE.",0,2,2,0,2,230,
01-ago-13,B.C.,"ENSENADA, B.C.",0,2,2,0,0,0,
01-ago-13,N.L.,"GARCIA, N.L.",1,1,2,14,0,400,
02-ago-13,N.L.,"GARCIA, N.L.",1,1,2,0,0,0,
05-ago-13,TLAX.,"TLAX., TLAX.",2,0,2,0,0,0,
06-ago-13,MOR.,"PUENTE DE IXTLA, MOR.",2,0,2,0,0,0,
06-ago-13,CHIH.,"ASCENSIÓN, CHIH.",0,2,2,0,0,0,
06-ago-13,SIN.,"CULIACAN, SIN.",1,1,2,0,4,0,
06-ago-13,B.C.,"TIJUANA, B.C.",2,0,2,0,0,0,
07-ago-13,PUE.,"ATLIXCO, PUE.",1,1,2,5,4,228,
07-ago-13,COAH.,"TORREÓN, COAH.",2,0,2,0,0,0,
07-ago-13,MOR.,"PUENTE DE IXTLA, MOR.",2,0,2,0,0,0,
07-ago-13,JAL.,"PIHUAMO, JAL.",2,0,2,1,0,0,
08-ago-13,VER.,"COATZACOALCOS, VER.",2,0,2,0,0,0,
08-ago-13,B.C.,"TIJUANA, B.C.",1,1,2,0,0,0,
08-ago-13,PUE.,"ATLIXCO, PUE.",1,1,2,11,5,62,
09-ago-13,PUE.,"ATLIXCO, PUE.",2,0,2,0,0,931,
09-ago-13,N.L.,"SAN NICOLAS DE LOS GARZA, N.L.",2,0,2,6,0,236,
09-ago-13,HGO.,"HUEJUTLA DE REYES, HGO.",2,0,2,0,0,0,
11-ago-13,N.L.,"SAN NICOLAS DE LOS GARZA, N.L.",1,1,2,0,0,0,
11-ago-13,JAL.,"CIHUATLAN, JAL.",2,0,2,0,0,0,
12-ago-13,HGO.,"HUEJUTLA DE REYES, HGO.",0,2,2,0,2,0,
12-ago-13,HGO.,"IXMIQUILPAN, HGO.",2,0,2,0,0,0,
12-ago-13,JAL.,"TONALA, JAL.",0,2,2,0,0,0,
13-ago-13,SIN.,"SAN IGNACIO, SIN.",1,1,2,0,0,0,
13-ago-13,YUC.,"PETO, YUC.",0,2,2,0,0,112,
14-ago-13,TLAX.,"TLAX., TLAX.",2,0,2,1,0,5,
14-ago-13,YUC.,"PETO, YUC.",2,0,2,0,0,0,
14-ago-13,N.L.,"SAN NICOLAS DE LOS GARZA, N.L.",1,1,2,0,0,558,
16-ago-13,N.L.,"SAN NICOLAS DE LOS GARZA, N.L.",1,1,2,4,0,350,
16-ago-13,N.L.,"SANTA CATARINA, N.L.",2,0,2,25,0,0,
17-ago-13,HGO.,"HUEJUTLA DE REYES, HGO.",2,0,2,0,0,0,
17-ago-13,HGO.,"PACHUCA DE SOTO, HGO.",1,1,2,0,0,600,
17-ago-13,MOR.,"CUAUTLA, MOR.",2,0,2,1,1,26,
17-ago-13,COAH.,"TORREÓN, COAH.",2,0,2,0,0,39,
18-ago-13,N.L.,"SAN NICOLAS DE LOS GARZA, N.L.",1,1,2,3,0,0,
19-ago-13,MOR.,"CUAUTLA, MOR.",1,1,2,0,1,0,
20-ago-13,B.C.,"ENSENADA, B.C.",1,1,2,0,0,0,
20-ago-13,N.L.,"GARCIA, N.L.",1,1,2,5,0,46,
21-ago-13,PUE.,"TEPEACA, PUE.",2,0,2,2,0,403,
21-ago-13,PUE.,"ZACATLAN, PUE.",2,0,2,0,0,0,
21-ago-13,N.L.,"SAN PEDRO GARZA GARCIA, N.L.",0,2,2,2,0,200,
21-ago-13,HGO.,"TEPEAPULCO, HGO.",0,2,2,0,0,0,
21-ago-13,SON.,"HERMOSILLO, SON.",2,0,2,27,0,750,
22-ago-13,PUE.,"ZACATLAN, PUE.",0,2,2,0,0,0,
22-ago-13,HGO.,"TEPEAPULCO, HGO.",2,0,2,0,0,68,
23-ago-13,HGO.,"JACALA DE LEDEZMA, HGO.",1,1,2,0,0,0,
23-ago-13,SON.,"HERMOSILLO, SON.",1,1,2,23,0,11,
23-ago-13,SON.,"CAJEME, SON.",0,2,2,23,0,126,
23-ago-13,B.C.,"MEXICALI, B.C.",0,2,2,0,0,0,
24-ago-13,HGO.,"TEPEAPULCO, HGO.",0,2,2,0,0,0,
25-ago-13,MOR.,"CUAUTLA, MOR.",0,2,2,0,0,55,
26-ago-13,MOR.,"CUAUTLA, MOR.",2,0,2,0,1,180,
26-ago-13,HGO.,"TEPEAPULCO, HGO.",1,1,2,0,0,0,
26-ago-13,COAH.,"ACUÑA, COAH.",2,0,2,1,0,100,
26-ago-13,SON.,"CAJEME, SON.",2,0,2,0,0,0,
27-ago-13,TLAX.,"TLAX., TLAX.",2,0,2,1,0,0,
27-ago-13,N.L.,"PARAS, N.L.",0,2,2,10,0,150,
27-ago-13,N.L.,"SAN PEDRO GARZA GARCIA, N.L.",2,0,2,0,0,50,
27-ago-13,PUE.,"ATLIXCO, PUE.",2,0,2,0,0,116,
28-ago-13,HGO.,"TEPEAPULCO, HGO.",1,1,2,0,0,0,
28-ago-13,JAL.,"GUADALAJARA, JAL.",2,0,2,0,0,0,
28-ago-13,N.L.,"PARAS, N.L.",0,2,2,0,0,0,
28-ago-13,SIN.,"MAZATLAN, SIN.",1,1,2,0,7,0,
28-ago-13,B.C.,"TIJUANA, B.C.",2,0,2,0,0,0,
28-ago-13,GTO.,"SAN FRANCISCO DEL RINCON, GTO.",0,2,2,0,0,0,
29-ago-13,HGO.,"TEPEAPULCO, HGO.",1,1,2,0,0,0,
29-ago-13,Q. ROO,"OTHON P. BLANCO, Q. ROO",0,2,2,0,0,40,
31-ago-13,B.C.,"ENSENADA, B.C.",0,2,2,0,0,0,
31-ago-13,GTO.,"CELAYA, GTO.",2,0,2,0,0,0,
01-sep-13,B.C.,"TIJUANA, B.C.",2,0,2,0,0,0,
01-sep-13,JAL.,"CUAUTITLAN DE GARCIA BARRAGAN, JAL.",1,1,2,0,1,200,
02-sep-13,MOR.,"XOCHITEPEC, MOR.",1,1,2,1,1,159,
03-sep-13,PUE.,"ATLIXCO, PUE.",1,1,2,0,0,90,
05-sep-13,SON.,"HERMOSILLO, SON.",2,0,2,11,0,0,
05-sep-13,MOR.,"XOCHITEPEC, MOR.",2,0,2,1,0,0,
06-sep-13,N.L.,"AGUALEGUAS, N.L.",0,2,2,0,0,100,
06-sep-13,MOR.,"XOCHITEPEC, MOR.",2,0,2,1,0,0,
07-sep-13,COAH.,"ACUÑA, COAH.",2,0,2,0,0,0,
07-sep-13,B.C.,"TECATE, B.C.",2,0,2,0,0,0,
07-sep-13,PUE.,"ATLIXCO, PUE.",1,1,2,1,0,326,
08-sep-13,MOR.,"XOCHITEPEC, MOR.",2,0,2,0,1,0,
08-sep-13,N.L.,"GRAL. BRAVO, N.L.",0,2,2,0,0,0,
08-sep-13,SON.,"SAN LUIS RIO COLORADO, SON.",2,0,2,1,4,0,
09-sep-13,B.C.,"ENSENADA, B.C.",2,0,2,0,0,0,
10-sep-13,MOR.,"XOCHITEPEC, MOR.",1,1,2,0,0,1,
10-sep-13,N.L.,"GRAL. TREVIÑO, N.L.",0,2,2,6,0,20,
11-sep-13,MOR.,"XOCHITEPEC, MOR.",2,0,2,1,0,110,
12-sep-13,B.C.,"TECATE, B.C.",0,2,2,0,0,0,
12-sep-13,PUE.,"ATLIXCO, PUE.",2,0,2,0,1,0,
13-sep-13,MOR.,"XOCHITEPEC, MOR.",1,1,2,0,1,132,
13-sep-13,CHIH.,"OJINAGA, CHIH.",0,2,2,0,0,0,
14-sep-13,B.C.,"TIJUANA, B.C.",1,1,2,0,0,0,
21-sep-13,MOR.,"XOCHITEPEC, MOR.",2,0,2,0,0,0,
21-sep-13,B.C.,"TECATE, B.C.",0,2,2,0,0,0,
21-sep-13,SON.,"SAN LUIS RIO COLORADO, SON.",1,1,2,2,1,5,
22-sep-13,MOR.,"XOCHITEPEC, MOR.",2,0,2,0,1,0,
23-sep-13,PUE.,"ATLIXCO, PUE.",2,0,2,0,1,378,
24-sep-13,B.C.,"ENSENADA, B.C.",0,2,2,0,0,0,
25-sep-13,MOR.,"TEMIXCO, MOR.",2,0,2,0,0,0,
26-sep-13,PUE.,"ATLIXCO, PUE.",1,1,2,6,0,20,
26-sep-13,SON.,"HERMOSILLO, SON.",1,1,2,0,0,160,
26-sep-13,SON.,"CAJEME, SON.",1,1,2,1,0,32,
27-sep-13,MOR.,"XOCHITEPEC, MOR.",1,1,2,0,0,129,
27-sep-13,ZAC.,"GUADALUPE, ZAC.",2,0,2,1,0,231,
27-sep-13,NAY.,"ACAPONETA, NAY.",2,0,2,0,0,0,
28-sep-13,MOR.,"XOCHITEPEC, MOR.",2,0,2,0,2,25,
29-sep-13,B.C.,"ENSENADA, B.C.",2,0,2,0,0,0,
01-oct-13,YUC.,"CHOCHOLA, YUC.",1,1,2,0,0,0,
01-oct-13,CHIS.,"MAPASTEPEC, CHIS.",2,0,2,0,0,0,
02-oct-13,B.C.,"TECATE, B.C.",0,2,2,0,0,0,
02-oct-13,SON.,"CAJEME, SON.",1,1,2,1,0,0,
02-oct-13,ZAC.,"TLALTENANGO DE SANCHEZ ROMAN, ZAC.",2,0,2,9,4,142,
03-oct-13,B.C.,"TIJUANA, B.C.",2,0,2,0,0,0,
03-oct-13,ZAC.,"JEREZ, ZAC.",2,0,2,0,0,23,
03-oct-13,ZAC.,"FRESNILLO, ZAC.",0,2,2,0,1,0,
04-oct-13,ZAC.,"ZAC., ZAC.",2,0,2,3,0,490,
04-oct-13,B.C.,"TIJUANA, B.C.",1,1,2,0,0,0,
05-oct-13,N.L.,"LAMPAZOS DE NARANJO, N.L.",1,1,2,2,0,0,
07-oct-13,SIN.,"ESCUINAPA, SIN.",1,1,2,0,0,0,
08-oct-13,NAY.,"TEPIC, NAY.",1,1,2,0,0,0,
08-oct-13,CHIS.,"ARRIAGA, CHIS.",1,1,2,0,0,0,
08-oct-13,SIN.,"ESCUINAPA, SIN.",1,1,2,0,0,0,
08-oct-13,ZAC.,"ZAC., ZAC.",2,0,2,0,0,29,
08-oct-13,CHIH.,"NUEVO CASAS GRANDES, CHIH.",0,2,2,0,0,11,
09-oct-13,ZAC.,"ZAC., ZAC.",2,0,2,9,0,11,
09-oct-13,YUC.,"UMAN, YUC.",2,0,2,0,0,0,
09-oct-13,N.L.,"VILLALDAMA, N.L.",2,0,2,0,0,0,
09-oct-13,SON.,"HERMOSILLO, SON.",2,0,2,6,0,112,
10-oct-13,ZAC.,"VALPARAISO, ZAC.",2,0,2,2,0,0,
10-oct-13,NAY.,"TEPIC, NAY.",1,1,2,0,0,0,
11-oct-13,ZAC.,"JEREZ, ZAC.",1,1,2,1,0,90,
11-oct-13,ZAC.,"RIO GRANDE, ZAC.",2,0,2,0,0,127,
11-oct-13,COAH.,"MONCLOVA, COAH.",2,0,2,0,0,424,
11-oct-13,JAL.,"TOTOTLAN, JAL.",0,2,2,1,0,0,
11-oct-13,ZAC.,"GUADALUPE, ZAC.",1,1,2,0,0,40,
11-oct-13,ZAC.,"VALPARAISO, ZAC.",2,0,2,0,0,0,
14-oct-13,COAH.,"SALTILLO, COAH.",2,0,2,0,0,444,
15-oct-13,COAH.,"ACUÑA, COAH.",0,2,2,0,0,0,
15-oct-13,ZAC.,"GUADALUPE, ZAC.",2,0,2,0,1,1320,
15-oct-13,YUC.,"RIO LAGARTOS, YUC.",2,0,2,0,0,0,
15-oct-13,AGS.,"AGS., AGS.",2,0,2,2,0,20,
16-oct-13,NAY.,"IXTLAN DEL RIO, NAY.",2,0,2,1,0,0,
16-oct-13,OAX.,"JUCHITAN DE ZARAGOZA, OAX.",2,0,2,2,0,0,
16-oct-13,VER.,"XALAPA, VER.",2,0,2,0,0,0,
16-oct-13,CHIS.,"TAPACHULA, CHIS.",2,0,2,0,0,0,
16-oct-13,ZAC.,"JEREZ, ZAC.",2,0,2,2,0,0,
17-oct-13,HGO.,"TULANCINGO DE BRAVO, HGO.",2,0,2,0,2,0,
18-oct-13,HGO.,"TULANCINGO DE BRAVO, HGO.",2,0,2,0,0,0,
18-oct-13,ZAC.,"ZAC., ZAC.",2,0,2,0,0,150,
18-oct-13,ZAC.,"TLALTENANGO DE SANCHEZ ROMAN, ZAC.",2,0,2,0,0,30,
18-oct-13,N.L.,"MINA, N.L.",1,1,2,0,0,0,
19-oct-13,ZAC.,"TLALTENANGO DE SANCHEZ ROMAN, ZAC.",2,0,2,1,0,110,
19-oct-13,B.C.,"TECATE, B.C.",2,0,2,0,0,0,
21-oct-13,SON.,"CAJEME, SON.",1,1,2,0,0,0,
21-oct-13,N.L.,"HGO., N.L.",2,0,2,0,0,0,
22-oct-13,COAH.,"ACUÑA, COAH.",0,2,2,0,0,0,
25-oct-13,CHIS.,"HUIXTLA, CHIS.",2,0,2,0,0,0,
28-oct-13,CHIS.,"HUIXTLA, CHIS.",1,1,2,0,0,0,
29-oct-13,ZAC.,"VALPARAISO, ZAC.",1,1,2,1,0,26,
29-oct-13,CHIS.,"TAPACHULA, CHIS.",1,1,2,0,0,70,
29-oct-13,CHIS.,"EL PORVENIR, CHIS.",1,1,2,0,0,0,
29-oct-13,CHIS.,"HUIXTLA, CHIS.",1,1,2,0,0,0,
29-oct-13,SON.,"HERMOSILLO, SON.",1,1,2,0,0,0,
29-oct-13,B.C.,"ENSENADA, B.C.",0,2,2,0,0,0,
30-oct-13,CHIS.,"JIQUIPILAS, CHIS.",0,2,2,0,0,0,
30-oct-13,B.C.,"TIJUANA, B.C.",0,2,2,0,0,0,
30-oct-13,COAH.,"RAMOS ARIZPE, COAH.",0,2,2,0,0,0,
31-oct-13,COAH.,"RAMOS ARIZPE, COAH.",2,0,2,0,0,0,
31-oct-13,SON.,"CAJEME, SON.",2,0,2,0,0,0,
01-nov-13,COAH.,"RAMOS ARIZPE, COAH.",2,0,2,0,0,0,
01-nov-13,COAH.,"NUEVA ROSITA, COAH.",2,0,2,0,0,0,
01-nov-13,SON.,"HERMOSILLO, SON.",1,1,2,0,0,20,
06-nov-13,CHIS.,"TUXTLA CHICO, CHIS.",1,1,2,0,0,0,
06-nov-13,B.C.,"TIJUANA, B.C.",1,1,2,0,0,0,
06-nov-13,B.C.,"MEXICALI, B.C.",1,1,2,0,0,0,
07-nov-13,JAL.,"ACATLAN DE JUAREZ, JAL.",2,0,2,0,0,0,
09-nov-13,B.C.,"TIJUANA, B.C.",2,0,2,0,0,0,
12-nov-13,YUC.,"PANABA, YUC.",1,1,2,0,0,0,
12-nov-13,B.C.,"TIJUANA, B.C.",1,1,2,0,0,0,
13-nov-13,N.L.,"CIENEGA DE FLORES, N.L.",1,1,2,2,0,1200,
13-nov-13,COAH.,"FRONTERA, COAH.",2,0,2,0,0,0,
15-nov-13,HGO.,"PACHUCA DE SOTO, HGO.",2,0,2,0,0,0,
15-nov-13,OAX.,"MIAHUATLAN DE PORFIRIO DIAZ, OAX.",2,0,2,1,0,43,
16-nov-13,HGO.,"PACHUCA DE SOTO, HGO.",2,0,2,0,0,0,
18-nov-13,HGO.,"TEPEJI DEL RIO DE OCAMPO, HGO.",2,0,2,0,0,200,
19-nov-13,HGO.,"TEPEJI DEL RIO DE OCAMPO, HGO.",2,0,2,0,0,0,
21-nov-13,TAMPS.,"TAMPICO, TAMPS.",2,0,2,2,0,1977,
21-nov-13,PUE.,"PUE., PUE.",2,0,2,1,0,154,
22-nov-13,HGO.,"TEPEJI DEL RIO DE OCAMPO, HGO.",2,0,2,0,0,0,
22-nov-13,SON.,"CAJEME, SON.",2,0,2,1,0,25,
22-nov-13,SON.,"ETCHOJOA, SON.",2,0,2,0,0,9,
23-nov-13,SON.,"CAJEME, SON.",1,1,2,0,0,0,
23-nov-13,HGO.,"PACHUCA DE SOTO, HGO.",1,1,2,0,1,400,
25-nov-13,SON.,"MAGDALENA, SON.",1,1,2,1,0,70,
25-nov-13,SON.,"ACONCHI, SON.",1,1,2,0,0,0,
26-nov-13,SON.,"GUAYMAS, SON.",1,1,2,0,0,297,
26-nov-13,SON.,"HUATABAMPO, SON.",1,1,2,1,0,20,
26-nov-13,SON.,"NAVOJOA, SON.",2,0,2,0,0,70,
27-nov-13,SON.,"ALTAR, SON.",0,2,2,0,0,0,
27-nov-13,COAH.,"SALTILLO, COAH.",2,0,2,0,0,147,
27-nov-13,SON.,"CAJEME, SON.",1,1,2,0,1,0,
27-nov-13,SON.,"MAGDALENA, SON.",2,0,2,1,0,120,
28-nov-13,COAH.,"SALTILLO, COAH.",1,1,2,1,0,184,
28-nov-13,N.L.,"GRAL. ESCOBEDO, N.L.",2,0,2,5,0,850,
29-nov-13,SON.,"HERMOSILLO, SON.",0,2,2,1,0,0,
29-nov-13,COAH.,"SALTILLO, COAH.",2,0,2,4,0,390,
30-nov-13,SON.,"CAJEME, SON.",2,0,2,1,0,0,
30-nov-13,SON.,"CABORCA, SON.",2,0,2,1,0,69,
30-nov-13,SON.,"ALTAR, SON.",1,1,2,0,0,0,
02-dic-13,COAH.,"PIEDRAS NEGRAS, COAH.",0,2,2,0,0,0,
02-dic-13,COAH.,"SALTILLO, COAH.",2,0,2,4,0,462,
03-dic-13,SON.,"NOGALES, SON.",0,2,2,0,0,0,
04-dic-13,SON.,"NOGALES, SON.",2,0,2,0,0,19,
04-dic-13,SON.,"AGUA PRIETA, SON.",2,0,2,1,0,0,
04-dic-13,B.C.,"TIJUANA, B.C.",2,0,2,0,0,0,
04-dic-13,SON.,"HERMOSILLO, SON.",1,1,2,3,0,20,
05-dic-13,COAH.,"SALTILLO, COAH.",2,0,2,0,0,52,
05-dic-13,COAH.,"FRONTERA, COAH.",1,1,2,0,1,0,
06-dic-13,PUE.,"PUE., PUE.",2,0,2,0,1,92,
06-dic-13,YUC.,"CHUMAYEL, YUC.",1,1,2,0,0,0,
10-dic-13,N.L.,"SANTA CATARINA, N.L.",2,0,2,25,0,200,
10-dic-13,SON.,"PUERTO PEÑASCO, SON.",2,0,2,0,0,62,
11-dic-13,TAMPS.,"NUEVO LAREDO, TAMPS.",1,1,2,36,0,347,
11-dic-13,CHIS.,"PALENQUE, CHIS.",2,0,2,0,0,113,
12-dic-13,TAMPS.,"NUEVO LAREDO, TAMPS.",0,2,2,47,0,389,
12-dic-13,N.L.,"GARCIA, N.L.",2,0,2,4,0,0,
16-dic-13,N.L.,"MONTEMOR., N.L.",0,2,2,0,0,0,
17-dic-13,N.L.,"MONTEMOR., N.L.",0,2,2,0,1,0,
18-dic-13,B.C.,"TIJUANA, B.C.",1,1,2,0,0,0,
20-dic-13,N.L.,"CADEREYTA JIMENEZ, N.L.",0,2,2,0,0,245,
02-ene-14,PUE.,"ATLIXCO, PUE.",2,0,2,0,0,0,
04-ene-14,TAMPS.,"NUEVO LAREDO, TAMPS.",1,1,2,51,0,836,
09-ene-14,TAMPS.,"NUEVO LAREDO, TAMPS.",1,1,2,5,0,1078,
09-ene-14,TAMPS.,"GONZALEZ, TAMPS.",1,1,2,0,0,66,
11-ene-14,TAMPS.,"NUEVO LAREDO, TAMPS.",2,0,2,47,0,2244,
15-ene-14,Q. ROO,"BENITO JUAREZ, Q. ROO",2,0,2,0,1,259,
15-ene-14,CHIH.,"HGO. DEL PARRAL, CHIH.",2,0,2,0,0,2,
16-ene-14,TAMPS.,"CIUDAD MADERO, TAMPS.",1,1,2,0,0,1217,
17-ene-14,Q. ROO,"BENITO JUAREZ, Q. ROO",1,1,2,0,0,190,
18-ene-14,VER.,"COATZACOALCOS, VER.",2,0,2,0,0,0,
18-ene-14,Q. ROO,"BENITO JUAREZ, Q. ROO",1,1,2,0,0,190,
19-ene-14,TAMPS.,"CIUDAD MADERO, TAMPS.",2,0,2,0,0,8,
21-ene-14,Q. ROO,"BENITO JUAREZ, Q. ROO",2,0,2,0,0,312,
21-ene-14,COAH.,"ACUÑA, COAH.",0,2,2,0,0,0,
23-ene-14,COAH.,"SALTILLO, COAH.",0,2,2,0,1,194,
24-ene-14,PUE.,"TEHUACAN, PUE.",2,0,2,4,2,0,
24-ene-14,COAH.,"FRONTERA, COAH.",2,0,2,1,1,397,
26-ene-14,COAH.,"ZARAGOZA, COAH.",0,2,2,0,0,0,
28-ene-14,S.L.P.,"SAN LUIS POTOSI, S.L.P.",2,0,2,0,0,0,
28-ene-14,S.L.P.,"SALINAS, S.L.P.",1,1,2,0,0,0,
29-ene-14,COAH.,"MONCLOVA, COAH.",2,0,2,0,0,0,
30-ene-14,S.L.P.,"SAN LUIS POTOSI, S.L.P.",2,0,2,0,0,0,
31-ene-14,NAY.,"TEPIC, NAY.",2,0,2,0,0,0,
01-feb-14,COAH.,"FRONTERA, COAH.",2,0,2,0,0,0,
02-feb-14,Q. ROO,"BACALAR, Q. ROO",0,2,2,0,5,40,
03-feb-14,COAH.,"TORREÓN, COAH.",1,1,2,0,1,0,
05-feb-14,COAH.,"MÚZQUIZ, COAH.",2,0,2,1,0,46,
05-feb-14,MICH.,"LAZARO CARDENAS, MICH.",2,0,2,0,0,0,
05-feb-14,S.L.P.,"TANQUIAN DE ESCOBEDO, S.L.P.",2,0,2,1,0,67,
06-feb-14,S.L.P.,"SAN LUIS POTOSI, S.L.P.",2,0,2,0,0,0,
06-feb-14,PUE.,"PUE., PUE.",2,0,2,0,0,0,
07-feb-14,COAH.,"MONCLOVA, COAH.",2,0,2,0,0,318,
08-feb-14,MEX.,"JUCHITEPEC, MEX.",1,1,2,0,0,40,
08-feb-14,COAH.,"FRONTERA, COAH.",1,1,2,0,0,0,
09-feb-14,COAH.,"ACUÑA, COAH.",1,1,2,0,0,0,
10-feb-14,COAH.,"MONCLOVA, COAH.",1,1,2,1,0,5,
10-feb-14,COAH.,"SALTILLO, COAH.",2,0,2,474,2,0,
11-feb-14,NAY.,"TEPIC, NAY.",2,0,2,0,0,0,
11-feb-14,TAB.,"CARDENAS, TAB.",0,2,2,0,0,0,
11-feb-14,CAMP.,"CAMP., CAMP.",2,0,2,0,0,0,
11-feb-14,ZAC.,"FRESNILLO, ZAC.",1,1,2,0,0,0,
11-feb-14,COAH.,"MÚZQUIZ, COAH.",0,2,2,0,0,0,
12-feb-14,COAH.,"MÚZQUIZ, COAH.",1,1,2,1,0,62,
14-feb-14,VER.,"TUXPAM, VER.",1,1,2,0,0,50,
15-feb-14,JAL.,"LA HUERTA, JAL.",1,1,2,0,0,0,
17-feb-14,B.C.S.,"MULEGÉ, B.C.S.",1,1,2,0,0,0,
17-feb-14,VER.,"MARTINEZ DE LA TORRE, VER.",2,0,2,0,0,0,
17-feb-14,COAH.,"SALTILLO, COAH.",2,0,2,0,0,0,
17-feb-14,COAH.,"MÚZQUIZ, COAH.",1,1,2,0,0,44,
18-feb-14,HGO.,"METEPEC, HGO.",1,1,2,0,0,0,
18-feb-14,MICH.,"LAZARO CARDENAS, MICH.",2,0,2,1,0,0,
18-feb-14,ZAC.,"APOZOL, ZAC.",2,0,2,0,0,0,
20-feb-14,MICH.,"LAZARO CARDENAS, MICH.",1,1,2,0,0,0,
21-feb-14,VER.,"MARTINEZ DE LA TORRE, VER.",1,1,2,0,0,0,
21-feb-14,MICH.,"LAZARO CARDENAS, MICH.",1,1,2,2,0,0,
22-feb-14,COAH.,"PIEDRAS NEGRAS, COAH.",1,1,2,0,0,0,
24-feb-14,VER.,"MARTINEZ DE LA TORRE, VER.",1,1,2,0,0,0,
24-feb-14,S.L.P.,"CIUDAD VALLES, S.L.P.",2,0,2,1,0,22,
25-feb-14,MICH.,"LAZARO CARDENAS, MICH.",2,0,2,2,0,2,
26-feb-14,PUE.,"PUE., PUE.",2,0,2,2,0,24,
26-feb-14,S.L.P.,"TANQUIAN DE ESCOBEDO, S.L.P.",2,0,2,2,0,0,
27-feb-14,HGO.,"SAN BARTOLO TUTOTEPEC, HGO.",2,0,2,0,0,0,
03-mar-14,CHIS.,"OCOSINGO, CHIS.",1,1,2,0,0,0,
03-mar-14,VER.,"PAPANTLA, VER.",2,0,2,0,0,0,
05-mar-14,N.L.,"MONTERREY, N.L.",1,1,2,18,0,3633,
05-mar-14,VER.,"PAPANTLA, VER.",2,0,2,0,0,0,
05-mar-14,MICH.,"LAZARO CARDENAS, MICH.",1,1,2,0,0,2,
07-mar-14,SON.,"HERMOSILLO, SON.",0,2,2,0,0,0,
07-mar-14,SON.,"CAJEME, SON.",2,0,2,1,0,0,
07-mar-14,ZAC.,"VALPARAISO, ZAC.",2,0,2,0,0,0,
07-mar-14,VER.,"POZA RICA DE HGO., VER.",2,0,2,0,0,0,
07-mar-14,VER.,"PAPANTLA, VER.",2,0,2,0,0,0,
10-mar-14,VER.,"PAPANTLA, VER.",2,0,2,0,0,0,
11-mar-14,CAMP.,"CARMEN, CAMP.",0,2,2,0,0,0,
11-mar-14,VER.,"PAPANTLA, VER.",2,0,2,0,0,0,
11-mar-14,VER.,"SAN RAFAEL, VER.",1,1,2,0,0,0,
12-mar-14,VER.,"ALAMO, VER.",1,1,2,0,0,0,
12-mar-14,SON.,"CAJEME, SON.",1,1,2,1,0,22,
12-mar-14,N.L.,"SAN NICOLAS DE LOS GARZA, N.L.",2,0,2,1,0,100,
13-mar-14,B.C.,"TECATE, B.C.",1,1,2,0,0,0,
15-mar-14,VER.,"VER., VER.",2,0,2,1,0,8,
15-mar-14,B.C.,"MEXICALI, B.C.",2,0,2,0,0,0,
16-mar-14,N.L.,"MONTERREY, N.L.",2,0,2,3,0,25,
16-mar-14,VER.,"VER., VER.",2,0,2,0,0,57,
17-mar-14,TAB.,"CENTLA, TAB.",2,0,2,0,1,0,
17-mar-14,TAB.,"TENOSIQUE, TAB.",2,0,2,0,0,0,
18-mar-14,VER.,"VER., VER.",2,0,2,1,0,10,
18-mar-14,B.C.,"ENSENADA, B.C.",1,1,2,0,0,0,
19-mar-14,VER.,"VER., VER.",2,0,2,2,0,54,
20-mar-14,ZAC.,"VALPARAISO, ZAC.",2,0,2,0,0,0,
22-mar-14,N.L.,"MONTERREY, N.L.",2,0,2,5,0,100,
22-mar-14,TAMPS.,"MATAMOROS, TAMPS.",1,1,2,0,0,0,
22-mar-14,QRO.,"AMEALCO DE BONFIL, QRO.",0,2,2,0,3,0,
24-mar-14,CHIH.,"BUENAVENTURA, CHIH.",1,1,2,0,0,0,
25-mar-14,CHIS.,"TUXTLA GUTIÉRREZ, CHIS.",1,1,2,5,4,460,
25-mar-14,VER.,"TANTOYUCA, VER.",1,1,2,0,0,0,
25-mar-14,CHIS.,"TUXTLA GUTIÉRREZ, CHIS.",1,1,2,5,4,460,
26-mar-14,TAMPS.,"TAMPICO, TAMPS.",1,1,2,0,0,71,
26-mar-14,ZAC.,"SOMBRERETE, ZAC.",2,0,2,0,0,0,
26-mar-14,QRO.,"COLON, QRO.",1,1,2,0,4,0,
26-mar-14,N.L.,"SAN NICOLAS DE LOS GARZA, N.L.",1,1,2,2,0,250,
26-mar-14,N.L.,"MONTERREY, N.L.",2,0,2,1,0,750,
27-mar-14,YUC.,"PANABA, YUC.",1,1,2,0,0,0,
27-mar-14,ZAC.,"ZAC., ZAC.",1,1,2,14,0,1302,
27-mar-14,YUC.,"PANABA, YUC.",1,1,2,0,0,0,
27-mar-14,MICH.,"LAZARO CARDENAS, MICH.",2,0,2,1,0,0,
27-mar-14,OAX.,"OAX. DE JUAREZ, OAX.",2,0,2,2,0,0,
28-mar-14,B.C.,"MEXICALI, B.C.",0,2,2,0,0,0,
28-mar-14,N.L.,"MONTERREY, N.L.",2,0,2,69,0,978,
30-mar-14,OAX.,"HEROICA CIUDAD DE HUAJUAPAN DE LEON, OAX.",2,0,2,1,0,6,
31-mar-14,CHIS.,"OCOSINGO, CHIS.",1,1,2,0,0,0,
31-mar-14,JAL.,"TLAQUEPAQUE, JAL.",1,1,2,0,0,0,
31-mar-14,TAMPS.,"REYNOSA, TAMPS.",1,1,2,0,0,0,
31-mar-14,N.L.,"MONTERREY, N.L.",2,0,2,8,0,230,
01-abr-14,OAX.,"OAX. DE JUAREZ, OAX.",2,0,2,0,0,0,
01-abr-14,N.L.,"GUADALUPE, N.L.",2,0,2,0,0,0,
01-abr-14,QRO.,"PEÑAMILLER, QRO.",1,1,2,0,0,0,
01-abr-14,B.C.,"ENSENADA, B.C.",1,1,2,0,0,0,
02-abr-14,B.C.,"ENSENADA, B.C.",0,2,2,0,0,0,
04-abr-14,OAX.,"TEZOATLAN DE SEGURA Y LUNA, OAX.",2,0,2,0,0,0,
04-abr-14,JAL.,"TLAQUEPAQUE, JAL.",2,0,2,0,0,0,
04-abr-14,VER.,"TANTOYUCA, VER.",0,2,2,0,0,0,
04-abr-14,VER.,"PANUCO, VER.",1,1,2,0,0,9,
05-abr-14,CHIS.,"TUXTLA GUTIÉRREZ, CHIS.",0,2,2,1,0,321,
05-abr-14,CHIS.,"YAJALÓN, CHIS.",1,1,2,0,0,0,
06-abr-14,N.L.,"SANTA CATARINA, N.L.",0,2,2,48,0,1500,
07-abr-14,OAX.,"OAX. DE JUAREZ, OAX.",2,0,2,1,1,14,
08-abr-14,B.C.,"MEXICALI, B.C.",0,2,2,0,0,0,
09-abr-14,JAL.,"TLAQUEPAQUE, JAL.",2,0,2,0,2,0,
09-abr-14,AGS.,"AGS., AGS.",1,1,2,1,0,6,
10-abr-14,OAX.,"SANTA MARIA PETAPA, OAX.",2,0,2,0,0,0,
10-abr-14,AGS.,"AGS., AGS.",2,0,2,3,0,29,
10-abr-14,OAX.,"OAX. DE JUAREZ, OAX.",2,0,2,1,1,13,
10-abr-14,OAX.,"SANTA MARIA COLOTEPEC, OAX.",1,1,2,0,0,0,
10-abr-14,SON.,"CAJEME, SON.",1,1,2,0,1,0,
10-abr-14,N.L.,"SANTA CATARINA, N.L.",1,1,2,7,0,4341,
10-abr-14,GTO.,"ACAMBARO, GTO.",1,1,2,0,0,0,
11-abr-14,OAX.,"PINOTEPA DE DON LUIS, OAX.",2,0,2,0,0,0,
11-abr-14,OAX.,"VILLA SOLA DE VEGA, OAX.",0,2,2,0,0,0,
12-abr-14,PUE.,"TEPANCO DE LOPEZ, PUE.",2,0,2,1,0,0,
12-abr-14,N.L.,"SANTA CATARINA, N.L.",2,0,2,0,0,5000,
13-abr-14,N.L.,"GUADALUPE, N.L.",1,1,2,2,0,400,
14-abr-14,JAL.,"ZAPOPAN, JAL.",2,0,2,0,0,0,
14-abr-14,OAX.,"HEROICA CIUDAD DE HUAJUAPAN DE LEON, OAX.",2,0,2,1,0,4,
14-abr-14,N.L.,"SANTA CATARINA, N.L.",1,1,2,12,0,5369,
14-abr-14,AGS.,"AGS., AGS.",2,0,2,2,0,68,
15-abr-14,S.L.P.,"CIUDAD VALLES, S.L.P.",2,0,2,0,0,8,
16-abr-14,SON.,"CAJEME, SON.",2,0,2,0,0,15,
16-abr-14,YUC.,"SOTUTA, YUC.",1,1,2,0,0,0,
16-abr-14,OAX.,"MIAHUATLAN DE PORFIRIO DIAZ, OAX.",1,1,2,0,0,0,
16-abr-14,OAX.,"SANTO DOMINGO ARMENTA, OAX.",1,1,2,0,0,0,
20-abr-14,N.L.,"GRAL. ESCOBEDO, N.L.",0,2,2,2,0,800,
21-abr-14,OAX.,"ZIMATLAN DE ALVAREZ, OAX.",1,1,2,0,0,0,
21-abr-14,TAB.,"TENOSIQUE, TAB.",2,0,2,0,0,0,
21-abr-14,JAL.,"ZAPOPAN, JAL.",2,0,2,0,0,0,
21-abr-14,B.C.,"TIJUANA, B.C.",2,0,2,0,0,0,
22-abr-14,CHIS.,"HUEHUETÁN, CHIS.",1,1,2,1,0,38,
22-abr-14,OAX.,"TLACOLULA DE MATAMOROS, OAX.",2,0,2,0,0,0,
22-abr-14,B.C.,"MEXICALI, B.C.",0,2,2,0,0,0,
23-abr-14,MEX.,"NAUCALPAN DE JUAREZ, MEX.",2,0,2,0,0,64,
23-abr-14,OAX.,"OAX. DE JUAREZ, OAX.",1,1,2,0,0,0,
23-abr-14,B.C.,"MEXICALI, B.C.",1,1,2,0,0,0,
24-abr-14,OAX.,"ZIMATLAN DE ALVAREZ, OAX.",2,0,2,0,0,0,
25-abr-14,OAX.,"ZIMATLAN DE ALVAREZ, OAX.",2,0,2,4,0,185,
25-abr-14,B.C.,"MEXICALI, B.C.",0,2,2,0,0,0,
25-abr-14,S.L.P.,"CIUDAD VALLES, S.L.P.",1,1,2,0,0,0,
25-abr-14,MEX.,"NAUCALPAN DE JUAREZ, MEX.",2,0,2,0,0,18,
25-abr-14,CAMP.,"PALIZADA, CAMP.",0,2,2,0,0,0,
25-abr-14,N.L.,"APODACA, N.L.",1,1,2,34,2,217,
26-abr-14,CHIS.,"HUEHUETÁN, CHIS.",1,1,2,0,0,60,
26-abr-14,MEX.,"HUIXQUILUCAN, MEX.",0,2,2,0,0,0,
26-abr-14,MEX.,"CHIMALHUACAN, MEX.",2,0,2,0,1,0,
26-abr-14,B.C.,"MEXICALI, B.C.",1,1,2,0,0,0,
28-abr-14,OAX.,"PINOTEPA DE DON LUIS, OAX.",2,0,2,2,0,0,
29-abr-14,OAX.,"OAX. DE JUAREZ, OAX.",2,0,2,2,0,0,
29-abr-14,OAX.,"HEROICA CIUDAD DE HUAJUAPAN DE LEON, OAX.",2,0,2,22,0,0,
29-abr-14,MEX.,"VALLE DE BRAVO, MEX.",1,1,2,1,0,0,
29-abr-14,N.L.,"GRAL. ESCOBEDO, N.L.",2,0,2,2,0,100,
29-abr-14,N.L.,"APODACA, N.L.",1,1,2,9,0,70,
30-abr-14,SIN.,"SALVADOR ALVARADO, SIN.",2,0,2,0,0,0,
30-abr-14,B.C.,"ENSENADA, B.C.",1,1,2,0,0,0,
30-abr-14,OAX.,"OAX. DE JUAREZ, OAX.",0,2,2,0,1,0,
30-abr-14,MEX.,"HUEHUETOCA, MEX.",1,1,2,3,0,0,
01-may-14,SON.,"CAJEME, SON.",2,0,2,1,1,32,
01-may-14,SIN.,"SALVADOR ALVARADO, SIN.",2,0,2,0,0,0,
01-may-14,SIN.,"ANGOSTURA, SIN.",1,1,2,0,1,0,
02-may-14,SON.,"HERMOSILLO, SON.",2,0,2,17,0,28,
02-may-14,N.L.,"CADEREYTA JIMENEZ, N.L.",0,2,2,28,0,50,
02-may-14,MEX.,"NAUCALPAN DE JUAREZ, MEX.",2,0,2,0,1,61,
03-may-14,MEX.,"NAUCALPAN DE JUAREZ, MEX.",2,0,2,0,0,0,
05-may-14,CHIS.,"SAN CRISTOBAL DE LAS CASAS, CHIS.",2,0,2,1,0,0,
06-may-14,OAX.,"MIAHUATLAN DE PORFIRIO DIAZ, OAX.",1,1,2,5,0,34,
06-may-14,N.L.,"SAN PEDRO GARZA GARCIA, N.L.",1,1,2,0,0,0,
06-may-14,OAX.,"CIUDAD IXTEPEC, OAX.",0,2,2,6,0,0,
06-may-14,OAX.,"OAX. DE JUAREZ, OAX.",1,1,2,1,0,0,
06-may-14,OAX.,"SAN MARCOS ARTEAGA, OAX.",2,0,2,0,0,0,
06-may-14,MEX.,"IXTAPALUCA, MEX.",2,0,2,0,0,0,
07-may-14,SIN.,"ANGOSTURA, SIN.",2,0,2,0,0,0,
07-may-14,CHIS.,"SAN CRISTOBAL DE LAS CASAS, CHIS.",1,1,2,1,0,0,
08-may-14,B.C.,"TIJUANA, B.C.",1,1,2,0,0,0,
08-may-14,MEX.,"NAUCALPAN DE JUAREZ, MEX.",1,1,2,0,5,0,
08-may-14,N.L.,"SAN PEDRO GARZA GARCIA, N.L.",2,0,2,6,0,350,
09-may-14,OAX.,"JUCHITAN DE ZARAGOZA, OAX.",0,2,2,3,0,0,
10-may-14,B.C.,"ENSENADA, B.C.",2,0,2,0,0,0,
12-may-14,MEX.,"NOPALTEPEC, MEX.",1,1,2,0,0,0,
12-may-14,NAY.,"ACAPONETA, NAY.",1,1,2,0,0,0,
12-may-14,N.L.,"CADEREYTA JIMENEZ, N.L.",2,0,2,0,0,30,
13-may-14,ZAC.,"GUADALUPE, ZAC.",2,0,2,0,0,210,
13-may-14,MEX.,"NAUCALPAN DE JUAREZ, MEX.",2,0,2,0,0,40,
13-may-14,MEX.,"NOPALTEPEC, MEX.",2,0,2,0,0,47,
13-may-14,B.C.,"ENSENADA, B.C.",2,0,2,0,0,0,
14-may-14,COAH.,"MONCLOVA, COAH.",2,0,2,0,0,0,
15-may-14,OAX.,"OAX. DE JUAREZ, OAX.",0,2,2,0,0,111,
15-may-14,JAL.,"GUADALAJARA, JAL.",1,1,2,0,0,0,
15-may-14,ZAC.,"VALPARAISO, ZAC.",2,0,2,1,0,0,
15-may-14,N.L.,"SAN PEDRO GARZA GARCIA, N.L.",1,1,2,57,0,4373,
16-may-14,OAX.,"OAX. DE JUAREZ, OAX.",0,2,2,0,0,0,
16-may-14,MEX.,"NAUCALPAN DE JUAREZ, MEX.",2,0,2,0,1,394,
17-may-14,B.C.,"MEXICALI, B.C.",1,1,2,0,0,0,
19-may-14,ZAC.,"LORETO, ZAC.",1,1,2,0,0,0,
19-may-14,MEX.,"ACOLMAN, MEX.",2,0,2,0,4,0,
21-may-14,HGO.,"PACHUCA DE SOTO, HGO.",1,1,2,0,0,0,
24-may-14,HGO.,"PACHUCA DE SOTO, HGO.",1,1,2,0,0,0,
26-may-14,MEX.,"HUIXQUILUCAN, MEX.",2,0,2,0,1,19,
26-may-14,SON.,"CAJEME, SON.",2,0,2,0,0,14,
26-may-14,MEX.,"LA PAZ, MEX.",2,0,2,0,0,0,
27-may-14,B.C.,"TIJUANA, B.C.",0,2,2,0,0,0,
27-may-14,CHIH.,"GUADALUPE, CHIH.",0,2,2,1,0,0,
27-may-14,PUE.,"COXCATLAN, PUE.",2,0,2,0,0,0,
27-may-14,JAL.,"TLAQUEPAQUE, JAL.",2,0,2,0,0,19,
28-may-14,SIN.,"BADIRAGUATO, SIN.",1,1,2,0,0,0,
28-may-14,CHIH.,"MADERA, CHIH.",0,2,2,0,0,0,
29-may-14,HGO.,"PACHUCA DE SOTO, HGO.",2,0,2,0,1,41,
29-may-14,ZAC.,"LORETO, ZAC.",2,0,2,0,0,0,
29-may-14,JAL.,"TLAQUEPAQUE, JAL.",2,0,2,0,0,0,
30-may-14,JAL.,"TLAQUEPAQUE, JAL.",2,0,2,0,0,0,
30-may-14,ZAC.,"LORETO, ZAC.",2,0,2,0,0,0,
30-may-14,CHIH.,"NAMIQUIPA, CHIH.",1,1,2,0,0,0,
31-may-14,MEX.,"HUIXQUILUCAN, MEX.",2,0,2,2,0,65,
31-may-14,B.C.,"ENSENADA, B.C.",0,2,2,0,0,0,
02-jun-14,MEX.,"VILLA VICTORIA, MEX.",0,2,2,0,0,0,
03-jun-14,YUC.,"CHANKOM, YUC.",1,1,2,0,0,0,
03-jun-14,HGO.,"PACHUCA DE SOTO, HGO.",2,0,2,0,0,0,
03-jun-14,MEX.,"TEQUIXQUIAC, MEX.",1,1,2,1,0,64,
03-jun-14,QRO.,"EZEQUIEL MONTES, QRO.",1,1,2,0,0,0,
04-jun-14,ZAC.,"VILLANUEVA, ZAC.",2,0,2,0,0,0,
04-jun-14,CHIH.,"CHIH., CHIH.",1,1,2,0,0,0,
05-jun-14,ZAC.,"ZAC., ZAC.",0,2,2,0,0,0,
05-jun-14,ZAC.,"VILLANUEVA, ZAC.",1,1,2,2,0,0,
05-jun-14,N.L.,"SANTIAGO, N.L.",1,1,2,2,0,800,
06-jun-14,HGO.,"TIZAYUCA, HGO.",2,0,2,0,0,400,
06-jun-14,ZAC.,"ZAC., ZAC.",1,1,2,0,0,0,
06-jun-14,COL.,"COL., COL.",2,0,2,8,0,0,
06-jun-14,CHIH.,"CHIH., CHIH.",2,0,2,0,1,265,
09-jun-14,CHIH.,"CHIH., CHIH.",2,0,2,0,0,17,
09-jun-14,MEX.,"SAN FELIPE DEL PROGRESO, MEX.",2,0,2,0,0,0,
09-jun-14,MEX.,"JILOTEPEC, MEX.",1,1,2,1,1,1,
09-jun-14,MEX.,"ALMOLOYA DE ALQUISIRAS, MEX.",1,1,2,0,0,0,
10-jun-14,JAL.,"ZAPOPAN, JAL.",2,0,2,0,0,0,
10-jun-14,COL.,"COL., COL.",2,0,2,2,0,0,
10-jun-14,NAY.,"ACAPONETA, NAY.",2,0,2,0,0,0,
10-jun-14,MEX.,"SAN FELIPE DEL PROGRESO, MEX.",2,0,2,0,0,0,
10-jun-14,MEX.,"ALMOLOYA DE ALQUISIRAS, MEX.",2,0,2,0,0,0,
11-jun-14,YUC.,"ACANCEH, YUC.",1,1,2,0,0,0,
11-jun-14,MEX.,"JILOTEPEC, MEX.",2,0,2,0,0,0,
12-jun-14,B.C.,"TIJUANA, B.C.",2,0,2,0,0,0,
12-jun-14,S.L.P.,"MATEHUALA, S.L.P.",2,0,2,0,0,36,
13-jun-14,HGO.,"TIZAYUCA, HGO.",2,0,2,0,0,236,
13-jun-14,SON.,"CAJEME, SON.",1,1,2,0,0,0,
13-jun-14,CHIH.,"HGO. DEL PARRAL, CHIH.",0,2,2,0,0,0,
13-jun-14,COAH.,"FRONTERA, COAH.",1,1,2,0,0,0,
13-jun-14,COAH.,"TORREÓN, COAH.",2,0,2,0,0,0,
14-jun-14,COL.,"TECOMÁN, COL.",2,0,2,0,0,26,
16-jun-14,ZAC.,"VILLANUEVA, ZAC.",2,0,2,0,0,0,
16-jun-14,MEX.,"TECAMAC, MEX.",2,0,2,0,0,0,
17-jun-14,B.C.,"ENSENADA, B.C.",0,2,2,0,0,0,
17-jun-14,ZAC.,"VILLANUEVA, ZAC.",2,0,2,0,0,0,
17-jun-14,COAH.,"MONCLOVA, COAH.",0,2,2,0,0,0,
17-jun-14,COAH.,"TORREÓN, COAH.",1,1,2,0,0,0,
17-jun-14,MEX.,"TECAMAC, MEX.",2,0,2,0,0,0,
17-jun-14,MEX.,"COACALCO DE BERRIOZABAL, MEX.",2,0,2,0,0,116,
17-jun-14,MEX.,"CUAUTITLAN IZCALLI, MEX.",2,0,2,0,2,0,
18-jun-14,YUC.,"TIMUCUY, YUC.",2,0,2,0,0,0,
18-jun-14,JAL.,"GUADALAJARA, JAL.",1,1,2,0,0,0,
18-jun-14,HGO.,"TULANCINGO DE BRAVO, HGO.",2,0,2,0,0,0,
19-jun-14,MEX.,"IXTAPALUCA, MEX.",1,1,2,0,2,0,
19-jun-14,B.C.,"TIJUANA, B.C.",1,1,2,0,0,0,
19-jun-14,COAH.,"MÚZQUIZ, COAH.",2,0,2,0,0,0,
20-jun-14,COL.,"COL., COL.",1,1,2,0,0,0,
20-jun-14,CHIH.,"CHIH., CHIH.",1,1,2,0,1,385,
20-jun-14,N.L.,"LOS ALDAMAS, N.L.",0,2,2,0,0,0,
21-jun-14,HGO.,"TULANCINGO DE BRAVO, HGO.",1,1,2,0,0,0,
21-jun-14,B.C.,"TIJUANA, B.C.",2,0,2,0,0,0,
21-jun-14,MEX.,"VALLE DE CHALCO SOLIDARIDAD, MEX.",2,0,2,0,0,0,
23-jun-14,B.C.S.,"COMONDÚ, B.C.S.",1,1,2,0,0,0,
23-jun-14,CHIH.,"CHIH., CHIH.",0,2,2,0,0,0,
23-jun-14,COAH.,"MONCLOVA, COAH.",1,1,2,0,0,0,
23-jun-14,COAH.,"TORREÓN, COAH.",2,0,2,0,0,0,
23-jun-14,COAH.,"SALTILLO, COAH.",2,0,2,0,0,68,
23-jun-14,MEX.,"CHALCO, MEX.",1,1,2,0,0,0,
24-jun-14,COAH.,"PIEDRAS NEGRAS, COAH.",0,2,2,0,0,0,
25-jun-14,ZAC.,"VILLANUEVA, ZAC.",1,1,2,0,0,0,
25-jun-14,SON.,"HERMOSILLO, SON.",1,1,2,0,0,401,
25-jun-14,COAH.,"FRONTERA, COAH.",1,1,2,0,0,0,
25-jun-14,COAH.,"MÚZQUIZ, COAH.",2,0,2,0,0,0,
26-jun-14,SIN.,"NAVOLATO, SIN.",2,0,2,0,0,0,
27-jun-14,COAH.,"PIEDRAS NEGRAS, COAH.",0,2,2,0,0,0,
27-jun-14,SIN.,"NAVOLATO, SIN.",1,1,2,0,0,0,
27-jun-14,PUE.,"PUE., PUE.",2,0,2,1,0,6,
28-jun-14,HGO.,"TULANCINGO DE BRAVO, HGO.",0,2,2,0,1,40,
01-jul-14,SIN.,"SAN IGNACIO, SIN.",2,0,2,0,0,0,
02-jul-14,COAH.,"MÚZQUIZ, COAH.",2,0,2,2,2,176,
02-jul-14,Q. ROO,"OTHON P. BLANCO, Q. ROO",2,0,2,0,0,209,
04-jul-14,SIN.,"SAN IGNACIO, SIN.",1,1,2,0,0,0,
05-jul-14,COL.,"COL., COL.",2,0,2,0,0,150,
06-jul-14,B.C.,"TECATE, B.C.",1,1,2,0,0,0,
07-jul-14,HGO.,"NOPALA DE VILLAGRAN, HGO.",0,2,2,0,0,0,
08-jul-14,CHIS.,"ARRIAGA, CHIS.",0,2,2,0,0,39,
09-jul-14,CHIS.,"ARRIAGA, CHIS.",1,1,2,2,0,222,
10-jul-14,CHIS.,"ARRIAGA, CHIS.",1,1,2,1,0,149,
12-jul-14,SON.,"CAJEME, SON.",1,1,2,1,0,0,
12-jul-14,TAMPS.,"MATAMOROS, TAMPS.",1,1,2,0,0,0,
14-jul-14,COAH.,"TORREÓN, COAH.",2,0,2,0,0,0,
14-jul-14,COL.,"TECOMÁN, COL.",1,1,2,0,0,0,
15-jul-14,N.L.,"LOS HERRERAS, N.L.",1,1,2,2,0,130,
15-jul-14,COAH.,"PIEDRAS NEGRAS, COAH.",1,1,2,0,0,0,
17-jul-14,N.L.,"ANAHUAC, N.L.",1,1,2,2,0,0,
18-jul-14,JAL.,"TLAQUEPAQUE, JAL.",0,2,2,0,0,0,
18-jul-14,COAH.,"MONCLOVA, COAH.",1,1,2,20,0,0,
18-jul-14,SON.,"CAJEME, SON.",2,0,2,0,0,0,
19-jul-14,N.L.,"LOS HERRERAS, N.L.",0,2,2,2,0,0,
19-jul-14,B.C.,"TIJUANA, B.C.",1,1,2,0,0,0,
22-jul-14,B.C.,"TECATE, B.C.",0,2,2,0,0,0,
23-jul-14,COAH.,"TORREÓN, COAH.",2,0,2,0,0,0,
24-jul-14,CHIS.,"CINTALAPA, CHIS.",2,0,2,0,0,0,
24-jul-14,COAH.,"TORREÓN, COAH.",2,0,2,0,0,0,
25-jul-14,COAH.,"PIEDRAS NEGRAS, COAH.",2,0,2,0,0,0,
25-jul-14,B.C.S.,"LA PAZ, B.C.S.",1,1,2,0,0,0,
25-jul-14,N.L.,"MINA, N.L.",0,2,2,0,0,0,
26-jul-14,B.C.S.,"MULEGÉ, B.C.S.",0,2,2,0,0,0,
26-jul-14,B.C.,"TIJUANA, B.C.",2,0,2,0,0,0,
28-jul-14,SON.,"CAJEME, SON.",1,1,2,1,0,14,
30-jul-14,COL.,"COL., COL.",2,0,2,1,0,0,
31-jul-14,COL.,"COL., COL.",2,0,2,0,0,0,
31-jul-14,CAMP.,"CAMP., CAMP.",2,0,2,0,0,0,
01-ago-14,SON.,"CAJEME, SON.",2,0,2,0,0,0,
02-ago-14,B.C.,"TIJUANA, B.C.",1,1,2,0,0,0,
04-ago-14,VER.,"COATZACOALCOS, VER.",2,0,2,0,0,0,
07-ago-14,CHIH.,"JUÁREZ, CHIH.",2,0,2,0,0,0,
07-ago-14,N.L.,"CERRALVO, N.L.",1,1,2,43,0,2730,
08-ago-14,JAL.,"GUADALAJARA, JAL.",2,0,2,0,0,0,
08-ago-14,COAH.,"PIEDRAS NEGRAS, COAH.",0,2,2,0,0,0,
08-ago-14,PUE.,"ATLIXCO, PUE.",0,2,2,0,0,0,
08-ago-14,CHIH.,"JUÁREZ, CHIH.",2,0,2,0,0,0,
09-ago-14,B.C.,"ENSENADA, B.C.",1,1,2,0,0,0,
09-ago-14,AGS.,"EL LLANO, AGS.",1,1,2,8,0,109,
09-ago-14,TAMPS.,"MATAMOROS, TAMPS.",2,0,2,0,0,0,
11-ago-14,B.C.,"TIJUANA, B.C.",2,0,2,0,0,0,
12-ago-14,NAY.,"ACAPONETA, NAY.",1,1,2,0,0,0,
13-ago-14,CHIH.,"JUÁREZ, CHIH.",2,0,2,0,0,0,
13-ago-14,SON.,"HERMOSILLO, SON.",2,0,2,1,0,0,
14-ago-14,COAH.,"TORREÓN, COAH.",2,0,2,0,0,0,
15-ago-14,COAH.,"PIEDRAS NEGRAS, COAH.",2,0,2,0,0,0,
16-ago-14,AGS.,"EL LLANO, AGS.",1,1,2,8,0,406,
16-ago-14,TAMPS.,"REYNOSA, TAMPS.",0,2,2,0,0,0,
16-ago-14,B.C.,"MEXICALI, B.C.",1,1,2,0,0,0,
19-ago-14,B.C.,"TIJUANA, B.C.",0,2,2,0,0,0,
19-ago-14,NAY.,"ACAPONETA, NAY.",1,1,2,0,0,0,
20-ago-14,CHIH.,"JUÁREZ, CHIH.",1,1,2,0,0,0,
20-ago-14,SON.,"CAJEME, SON.",2,0,2,0,0,0,
20-ago-14,B.C.,"ENSENADA, B.C.",1,1,2,0,0,0,
21-ago-14,SIN.,"COSALA, SIN.",1,1,2,0,0,0,
21-ago-14,NAY.,"ACAPONETA, NAY.",1,1,2,0,0,0,
22-ago-14,SON.,"HERMOSILLO, SON.",0,2,2,10,0,0,
25-ago-14,NAY.,"ACAPONETA, NAY.",1,1,2,0,0,0,
25-ago-14,VER.,"COATZACOALCOS, VER.",2,0,2,0,0,0,
26-ago-14,COL.,"COL., COL.",2,0,2,0,0,0,
27-ago-14,NAY.,"ACAPONETA, NAY.",1,1,2,0,0,0,
28-ago-14,VER.,"MARTINEZ DE LA TORRE, VER.",0,2,2,0,0,0,
28-ago-14,MICH.,"APATZINGAN, MICH.",2,0,2,1,0,0,
28-ago-14,SON.,"HERMOSILLO, SON.",0,2,2,0,0,0,
29-ago-14,B.C.,"TIJUANA, B.C.",1,1,2,0,0,0,
29-ago-14,AGS.,"JESÚS MARÍA, AGS.",2,0,2,0,0,0,
01-sep-14,MICH.,"APATZINGAN, MICH.",0,2,2,3,0,0,
01-sep-14,MICH.,"LAZARO CARDENAS, MICH.",2,0,2,1,0,792,
01-sep-14,SON.,"CAJEME, SON.",1,1,2,1,0,36,
01-sep-14,CHIH.,"JUÁREZ, CHIH.",1,1,2,0,0,0,
02-sep-14,TAB.,"TENOSIQUE, TAB.",1,1,2,0,0,0,
02-sep-14,MICH.,"APATZINGAN, MICH.",1,1,2,1,0,55,
03-sep-14,MICH.,"ZITACUARO, MICH.",2,0,2,0,0,0,
03-sep-14,B.C.,"ENSENADA, B.C.",2,0,2,0,0,0,
04-sep-14,AGS.,"JESÚS MARÍA, AGS.",1,1,2,1,0,235,
05-sep-14,AGS.,"JESÚS MARÍA, AGS.",1,1,2,0,0,9,
05-sep-14,N.L.,"APODACA, N.L.",2,0,2,1,1,531,
05-sep-14,CHIH.,"JUÁREZ, CHIH.",0,2,2,0,0,0,
05-sep-14,N.L.,"APODACA, N.L.",2,0,2,3,1,531,
05-sep-14,VER.,"MARTINEZ DE LA TORRE, VER.",1,1,2,0,0,0,
06-sep-14,SON.,"CAJEME, SON.",1,1,2,0,0,0,
07-sep-14,MICH.,"SAHUAYO, MICH.",2,0,2,0,0,46,
08-sep-14,MICH.,"SAHUAYO, MICH.",2,0,2,0,0,45,
08-sep-14,TAMPS.,"VICTORIA, TAMPS.",1,1,2,4,0,45,
09-sep-14,B.C.,"TIJUANA, B.C.",1,1,2,0,0,0,
09-sep-14,MICH.,"SAHUAYO, MICH.",1,1,2,0,0,120,
09-sep-14,N.L.,"APODACA, N.L.",2,0,2,1,0,526,
09-sep-14,TAMPS.,"VICTORIA, TAMPS.",0,2,2,1,0,169,
10-sep-14,SON.,"CAJEME, SON.",2,0,2,0,0,2000,
10-sep-14,PUE.,"TEPEACA, PUE.",2,0,2,2,0,25,
11-sep-14,PUE.,"TEPEACA, PUE.",1,1,2,0,0,0,
12-sep-14,TAB.,"HUIMANGUILLO, TAB.",2,0,2,0,0,10,
18-sep-14,COL.,"TECOMÁN, COL.",1,1,2,0,0,0,
18-sep-14,COAH.,"SALTILLO, COAH.",0,2,2,0,2,136,
19-sep-14,TAB.,"HUIMANGUILLO, TAB.",2,0,2,0,0,0,
19-sep-14,MICH.,"APATZINGAN, MICH.",2,0,2,1,0,0,
20-sep-14,MICH.,"JIQUILPAN, MICH.",1,1,2,1,0,311,
20-sep-14,HGO.,"HUICHAPAN, HGO.",1,1,2,0,0,0,
23-sep-14,S.L.P.,"SAN LUIS POTOSI, S.L.P.",2,0,2,0,0,0,
23-sep-14,MICH.,"COALCOMAN DE VAZQUEZ PALLARES, MICH.",2,0,2,0,0,0,
23-sep-14,COAH.,"TORREÓN, COAH.",2,0,2,0,0,0,
24-sep-14,AGS.,"SAN JOSÉ DE GRACIA, AGS.",2,0,2,0,0,0,
24-sep-14,B.C.,"TIJUANA, B.C.",1,1,2,0,0,0,
25-sep-14,MICH.,"APATZINGAN, MICH.",2,0,2,0,0,100,
26-sep-14,TAB.,"CENTRO, TAB.",2,0,2,0,0,80,
26-sep-14,N.L.,"GARCIA, N.L.",1,1,2,100,0,800,
26-sep-14,MICH.,"COAHUAYANA, MICH.",1,1,2,1,0,0,
30-sep-14,AGS.,"AGS., AGS.",1,1,2,0,0,0,
01-oct-14,MICH.,"GABRIEL ZAMORA, MICH.",0,2,2,0,0,1050,
01-oct-14,MICH.,"LA HUACANA, MICH.",2,0,2,2,0,0,
01-oct-14,B.C.,"ENSENADA, B.C.",0,2,2,0,0,0,
02-oct-14,B.C.,"ENSENADA, B.C.",1,1,2,0,0,0,
02-oct-14,AGS.,"AGS., AGS.",0,2,2,0,0,0,
02-oct-14,MICH.,"TIQUICHEO DE NICOLAS ROMERO, MICH.",0,2,2,0,0,0,
03-oct-14,SIN.,"ESCUINAPA, SIN.",1,1,2,0,0,0,
04-oct-14,MICH.,"ZINAPECUARO, MICH.",2,0,2,1,0,174,
06-oct-14,N.L.,"MONTERREY, N.L.",1,1,2,1,0,550,
07-oct-14,SON.,"CANANEA, SON.",1,1,2,2,0,336,
08-oct-14,SON.,"ALAMOS, SON.",2,0,2,1,0,0,
08-oct-14,SON.,"AGUA PRIETA, SON.",1,1,2,0,0,0,
09-oct-14,SIN.,"ELOTA, SIN.",2,0,2,0,1,0,
09-oct-14,SON.,"CARBO, SON.",2,0,2,0,0,180,
09-oct-14,SON.,"CAJEME, SON.",1,1,2,0,0,4,
09-oct-14,SON.,"BENITO JUAREZ, SON.",2,0,2,0,0,20,
09-oct-14,SON.,"GUAYMAS, SON.",2,0,2,0,0,0,
09-oct-14,SON.,"NAVOJOA, SON.",2,0,2,0,0,73,
09-oct-14,SON.,"ALAMOS, SON.",2,0,2,1,0,0,
09-oct-14,SON.,"CANANEA, SON.",2,0,2,0,0,94,
09-oct-14,SON.,"FRONTERAS, SON.",0,2,2,0,0,0,
09-oct-14,AGS.,"AGS., AGS.",1,1,2,0,0,40,
09-oct-14,N.L.,"SAN NICOLAS DE LOS GARZA, N.L.",2,0,2,0,0,0,
10-oct-14,B.C.,"ENSENADA, B.C.",2,0,2,0,0,0,
10-oct-14,COAH.,"TORREÓN, COAH.",1,1,2,0,0,391,
10-oct-14,PUE.,"ACATZINGO, PUE.",2,0,2,0,0,0,
10-oct-14,SON.,"EMPALME, SON.",2,0,2,6,0,34,
10-oct-14,SON.,"FRONTERAS, SON.",0,2,2,0,0,0,
11-oct-14,SON.,"ETCHOJOA, SON.",2,0,2,0,0,0,
11-oct-14,SON.,"FRONTERAS, SON.",0,2,2,0,0,0,
11-oct-14,SON.,"GENERAL PLUTARCO ELIAS CALLES, SON.",2,0,2,0,0,0,
12-oct-14,GRO.,"TECPAN DE GALEANA, GRO.",0,2,2,0,0,0,
13-oct-14,MOR.,"CUERNAVACA, MOR.",0,2,2,0,1,0,
13-oct-14,SON.,"NOGALES, SON.",1,1,2,19,1,39,
13-oct-14,SON.,"CABORCA, SON.",1,1,2,0,0,0,
13-oct-14,B.C.,"TIJUANA, B.C.",0,2,2,0,0,0,
13-oct-14,SON.,"HERMOSILLO, SON.",1,1,2,6,0,60,
13-oct-14,SIN.,"CONCORDIA, SIN.",1,1,2,0,0,0,
13-oct-14,MICH.,"AGUILILLA, MICH.",2,0,2,2,0,0,
13-oct-14,MICH.,"PARACHO, MICH.",1,1,2,0,0,1533,
13-oct-14,TAMPS.,"LLERA, TAMPS.",1,1,2,0,0,0,
13-oct-14,MICH.,"AGUILILLA, MICH.",2,0,2,2,0,0,
14-oct-14,SON.,"ALAMOS, SON.",1,1,2,0,0,0,
14-oct-14,TAMPS.,"RIO BRAVO, TAMPS.",2,0,2,4,0,0,
15-oct-14,MICH.,"AGUILILLA, MICH.",2,0,2,1,0,0,
15-oct-14,B.C.,"TIJUANA, B.C.",1,1,2,0,0,0,
16-oct-14,MOR.,"CUERNAVACA, MOR.",2,0,2,0,0,20,
16-oct-14,AGS.,"AGS., AGS.",1,1,2,0,0,0,
16-oct-14,GRO.,"TELOLOAPAN, GRO.",1,1,2,0,0,0,
16-oct-14,MICH.,"HGO., MICH.",1,1,2,1,0,89,
16-oct-14,SON.,"NOGALES, SON.",1,1,2,0,0,83,
16-oct-14,SON.,"CANANEA, SON.",2,0,2,0,0,20,
16-oct-14,SON.,"AGUA PRIETA, SON.",0,2,2,1,0,10,
16-oct-14,SON.,"PITIQUITO, SON.",0,2,2,0,0,0,
16-oct-14,SON.,"NAVOJOA, SON.",2,0,2,2,0,117,
17-oct-14,SON.,"CAJEME, SON.",1,1,2,0,0,0,
17-oct-14,SON.,"ALAMOS, SON.",2,0,2,0,0,0,
17-oct-14,ZAC.,"GUADALUPE, ZAC.",1,1,2,0,0,0,
17-oct-14,CHIS.,"VILLAFLORES, CHIS.",1,1,2,0,0,0,
18-oct-14,MICH.,"ZACAPU, MICH.",2,0,2,1,0,1100,
18-oct-14,SON.,"SAN MIGUEL DE HORCASITAS, SON.",2,0,2,0,0,0,
18-oct-14,SON.,"CAJEME, SON.",2,0,2,0,0,0,
19-oct-14,MICH.,"PATZCUARO, MICH.",2,0,2,1,0,0,
19-oct-14,SON.,"BENITO JUAREZ, SON.",0,2,2,0,0,0,
19-oct-14,CHIS.,"SAN CRISTOBAL DE LAS CASAS, CHIS.",2,0,2,0,0,0,
19-oct-14,CHIS.,"PICHUCALCO, CHIS.",2,0,2,0,0,0,
20-oct-14,MICH.,"ZACAPU, MICH.",2,0,2,2,0,980,
20-oct-14,TAMPS.,"PADILLA, TAMPS.",0,2,2,0,0,0,
20-oct-14,VER.,"SOLEDAD DE DOBLADO, VER.",1,1,2,0,0,0,
20-oct-14,TLAX.,"ZACATELCO, TLAX.",2,0,2,0,0,0,
20-oct-14,SON.,"MAGDALENA, SON.",1,1,2,0,0,0,
20-oct-14,SON.,"SANTA ANA, SON.",0,2,2,2,0,50,
20-oct-14,CHIS.,"VILLAFLORES, CHIS.",1,1,2,0,0,0,
21-oct-14,COAH.,"SALTILLO, COAH.",2,0,2,0,0,51,
21-oct-14,SON.,"FRONTERAS, SON.",0,2,2,0,0,0,
21-oct-14,SON.,"PITIQUITO, SON.",2,0,2,0,0,0,
21-oct-14,CHIS.,"OCOSINGO, CHIS.",2,0,2,2,0,84,
22-oct-14,B.C.,"ENSENADA, B.C.",0,2,2,0,0,0,
22-oct-14,ZAC.,"GUADALUPE, ZAC.",0,2,2,0,0,0,
23-oct-14,MOR.,"CUERNAVACA, MOR.",0,2,2,0,6,0,
23-oct-14,SON.,"NAVOJOA, SON.",2,0,2,0,0,0,
23-oct-14,CHIS.,"TONALÁ, CHIS.",0,2,2,1,0,101,
24-oct-14,MICH.,"MORELIA, MICH.",2,0,2,2,0,0,
24-oct-14,MICH.,"TACAMBARO, MICH.",1,1,2,0,0,400,
24-oct-14,MICH.,"TEPALCATEPEC, MICH.",2,0,2,0,0,24,
24-oct-14,SON.,"SANTA ANA, SON.",0,2,2,0,0,0,
24-oct-14,SON.,"GENERAL PLUTARCO ELIAS CALLES, SON.",1,1,2,0,0,0,
25-oct-14,SON.,"CANANEA, SON.",0,2,2,0,0,0,
25-oct-14,SON.,"SAN LUIS RIO COLORADO, SON.",1,1,2,0,0,0,
25-oct-14,CHIS.,"OCOSINGO, CHIS.",0,2,2,0,0,0,
25-oct-14,MICH.,"TACAMBARO, MICH.",0,2,2,0,0,500,
25-oct-14,CHIS.,"OCOZOCOAUTLA DE ESPINOSA, CHIS.",1,1,2,0,0,72,
26-oct-14,CHIS.,"SAN CRISTOBAL DE LAS CASAS, CHIS.",2,0,2,0,0,0,
26-oct-14,MICH.,"MORELIA, MICH.",1,1,2,1,0,3725,
27-oct-14,MOR.,"CUERNAVACA, MOR.",0,2,2,0,1,0,
27-oct-14,MICH.,"TACAMBARO, MICH.",2,0,2,0,0,0,
27-oct-14,TAMPS.,"PADILLA, TAMPS.",1,1,2,0,0,0,
27-oct-14,B.C.,"ENSENADA, B.C.",2,0,2,0,0,0,
27-oct-14,MICH.,"LAZARO CARDENAS, MICH.",2,0,2,0,0,266,
27-oct-14,SON.,"HERMOSILLO, SON.",2,0,2,18,0,50,
27-oct-14,AGS.,"AGS., AGS.",1,1,2,5,0,173,
27-oct-14,N.L.,"APODACA, N.L.",0,2,2,14,0,1320,
27-oct-14,SON.,"PUERTO PEÑASCO, SON.",2,0,2,0,0,0,
27-oct-14,SON.,"PITIQUITO, SON.",1,1,2,1,0,0,
28-oct-14,TLAX.,"TLAX., TLAX.",1,1,2,1,0,0,
28-oct-14,SON.,"GUAYMAS, SON.",1,1,2,1,0,0,
28-oct-14,SON.,"EMPALME, SON.",2,0,2,1,0,0,
28-oct-14,SON.,"NOGALES, SON.",1,1,2,1,0,0,
28-oct-14,S.L.P.,"SAN LUIS POTOSI, S.L.P.",2,0,2,0,0,0,
29-oct-14,SON.,"HERMOSILLO, SON.",2,0,2,18,0,80,
29-oct-14,SON.,"GUAYMAS, SON.",1,1,2,0,0,2,
29-oct-14,COAH.,"SALTILLO, COAH.",2,0,2,0,0,52,
29-oct-14,N.L.,"APODACA, N.L.",1,1,2,22,0,1238,
29-oct-14,TLAX.,"TEOLOCHOLCO, TLAX.",1,1,2,0,0,0,
29-oct-14,CHIS.,"SAN CRISTOBAL DE LAS CASAS, CHIS.",1,1,2,0,0,0,
29-oct-14,CHIS.,"OCOSINGO, CHIS.",0,2,2,2,0,467,
30-oct-14,TLAX.,"TEOLOCHOLCO, TLAX.",1,1,2,0,0,0,
30-oct-14,N.L.,"APODACA, N.L.",0,2,2,19,0,1104,
30-oct-14,CHIS.,"PICHUCALCO, CHIS.",2,0,2,2,1,622,
30-oct-14,GRO.,"PETATLAN, GRO.",1,1,2,0,0,0,
30-oct-14,SON.,"NOGALES, SON.",1,1,2,20,0,77,
31-oct-14,SON.,"PUERTO PEÑASCO, SON.",1,1,2,0,0,0,
31-oct-14,CHIS.,"OCOSINGO, CHIS.",1,1,2,2,0,733,
31-oct-14,GRO.,"BENITO JUAREZ, GRO.",1,1,2,0,0,0,
31-oct-14,SON.,"EMPALME, SON.",2,0,2,0,0,0,
31-oct-14,B.C.,"ENSENADA, B.C.",1,1,2,0,0,0,
31-oct-14,GRO.,"TELOLOAPAN, GRO.",1,1,2,1,0,0,
31-oct-14,MOR.,"CUERNAVACA, MOR.",0,2,2,0,0,0,
01-nov-14,B.C.,"ENSENADA, B.C.",2,0,2,0,0,0,
01-nov-14,SON.,"MAGDALENA, SON.",2,0,2,0,0,0,
02-nov-14,GRO.,"TELOLOAPAN, GRO.",2,0,2,0,0,0,
03-nov-14,CHIS.,"SAN CRISTOBAL DE LAS CASAS, CHIS.",1,1,2,0,0,0,
03-nov-14,GRO.,"PUNGARABATO, GRO.",0,2,2,0,0,0,
04-nov-14,GRO.,"PUNGARABATO, GRO.",1,1,2,0,0,0,
04-nov-14,GRO.,"FLORENCIO VILLARREAL, GRO.",1,1,2,0,0,0,
05-nov-14,CHIS.,"PALENQUE, CHIS.",1,1,2,4,0,693,
06-nov-14,CHIS.,"OCOZOCOAUTLA DE ESPINOSA, CHIS.",2,0,2,0,0,112,
06-nov-14,GRO.,"PUNGARABATO, GRO.",2,0,2,0,0,0,
06-nov-14,GRO.,"TELOLOAPAN, GRO.",0,2,2,0,0,0,
07-nov-14,AGS.,"AGS., AGS.",2,0,2,0,0,50,
08-nov-14,GRO.,"ATOYAC DE ALVAREZ, GRO.",2,0,2,0,0,0,
09-nov-14,CHIS.,"TAPACHULA, CHIS.",2,0,2,1,0,330,
09-nov-14,CHIS.,"OCOZOCOAUTLA DE ESPINOSA, CHIS.",2,0,2,0,0,0,
09-nov-14,CHIS.,"PALENQUE, CHIS.",0,2,2,0,0,0,
10-nov-14,CHIS.,"COMITAN DE DOMÍNGUEZ, CHIS.",1,1,2,4,0,168,
10-nov-14,TLAX.,"CALPULALPAN, TLAX.",1,1,2,0,0,4,
11-nov-14,CHIS.,"PALENQUE, CHIS.",2,0,2,1,0,181,
14-nov-14,B.C.S.,"MULEGÉ, B.C.S.",1,1,2,0,0,0,
18-nov-14,TLAX.,"HUAMANTLA, TLAX.",0,2,2,0,0,0,
18-nov-14,SIN.,"SALVADOR ALVARADO, SIN.",1,1,2,0,5,0,
19-nov-14,AGS.,"CALVILLO, AGS.",2,0,2,0,0,0,
19-nov-14,GRO.,"ACAPULCO DE JUAREZ, GRO.",1,1,2,0,0,0,
24-nov-14,HGO.,"HUEJUTLA DE REYES, HGO.",2,0,2,0,0,0,
05-dic-14,NAY.,"ACAPONETA, NAY.",2,0,2,0,0,0,
05-dic-14,B.C.S.,"LOS CABOS, B.C.S.",0,2,2,0,0,0,
07-dic-14,JAL.,"TOMATLAN, JAL.",0,2,2,0,0,0,
11-dic-14,COAH.,"TORREÓN, COAH.",2,0,2,0,0,0,
12-dic-14,NAY.,"ACAPONETA, NAY.",2,0,2,0,0,0,
15-dic-14,CHIS.,"BENEMÉRITO DE LAS AMÉRICAS, CHIS.",1,1,2,0,0,0,
16-dic-14,DGO.,"GOMEZ PALACIO, DGO.",0,2,2,0,0,0,
16-dic-14,B.C.S.,"LA PAZ, B.C.S.",1,1,2,0,0,0,
17-dic-14,COAH.,"TORREÓN, COAH.",2,0,2,0,0,0,
18-dic-14,COAH.,"ACUÑA, COAH.",1,1,2,0,0,0,
19-dic-14,DGO.,"DGO., DGO.",2,0,2,8,4,0,
20-dic-14,COAH.,"TORREÓN, COAH.",0,2,2,0,0,0,
20-dic-14,GRO.,"ACAPULCO DE JUAREZ, GRO.",0,2,2,4,0,116,
20-dic-14,DGO.,"DGO., DGO.",0,2,2,10,1,0,
22-dic-14,CHIS.,"BENEMÉRITO DE LAS AMÉRICAS, CHIS.",1,1,2,0,0,0,
23-dic-14,TAB.,"TEAPA, TAB.",1,1,2,0,0,0,
25-dic-14,DGO.,"GOMEZ PALACIO, DGO.",0,2,2,0,0,0,
27-dic-14,COAH.,"TORREÓN, COAH.",2,0,2,0,1,0,
30-dic-14,CHIS.,"BENEMÉRITO DE LAS AMÉRICAS, CHIS.",1,1,2,1,0,0,
02-ene-15,PUE.,"ATLIXCO, PUE.",2,0,2,0,0,0,
06-ene-15,CHIS.,"MARQUÉS DE COMILLAS, CHIS.",1,1,2,0,0,0,
07-ene-15,DGO.,"DGO., DGO.",1,1,2,0,1,0,
09-ene-15,DGO.,"DGO., DGO.",1,1,2,0,0,0,
12-ene-15,DGO.,"DGO., DGO.",2,0,2,0,0,0,
14-ene-15,COAH.,"SALTILLO, COAH.",2,0,2,0,0,36,
17-ene-15,VER.,"LA ANTIGUA, VER.",2,0,2,0,0,0,
22-ene-15,COL.,"COL., COL.",1,1,2,0,0,0,
26-ene-15,COL.,"COL., COL.",2,0,2,0,0,0,
26-ene-15,CHIS.,"BENEMÉRITO DE LAS AMÉRICAS, CHIS.",1,1,2,0,0,0,
28-ene-15,COL.,"COL., COL.",2,0,2,0,0,0,
29-ene-15,CHIS.,"BENEMÉRITO DE LAS AMÉRICAS, CHIS.",1,1,2,0,0,0,
29-ene-15,JAL.,"LAGOS DE MORENO, JAL.",1,1,2,0,0,0,
29-ene-15,PUE.,"TEHUACAN, PUE.",2,0,2,0,0,0,
30-ene-15,PUE.,"TEHUACAN, PUE.",1,1,2,0,0,21,
03-feb-15,NAY.,"TEPIC, NAY.",1,1,2,0,0,0,
10-feb-15,PUE.,"TEHUACAN, PUE.",2,0,2,0,0,0,
11-feb-15,YUC.,"TEKAL DE VENEGAS, YUC.",1,1,2,0,0,0,
11-feb-15,NAY.,"TEPIC, NAY.",2,0,2,0,0,0,
13-feb-15,NAY.,"TEPIC, NAY.",2,0,2,0,0,0,
17-feb-15,NAY.,"TEPIC, NAY.",2,0,2,0,0,2,
18-feb-15,B.C.,"MEXICALI, B.C.",2,0,2,0,0,0,
20-feb-15,YUC.,"TEMAX, YUC.",2,0,2,0,0,0,
20-feb-15,B.C.,"ENSENADA, B.C.",0,2,2,0,0,0,
21-feb-15,B.C.,"MEXICALI, B.C.",0,2,2,0,0,0,
25-feb-15,B.C.,"ENSENADA, B.C.",0,2,2,0,0,0,
26-feb-15,PUE.,"TEHUACAN, PUE.",2,0,2,0,0,0,
27-feb-15,HGO.,"PACHUCA DE SOTO, HGO.",1,1,2,0,3,0,
27-feb-15,COAH.,"TORREÓN, COAH.",0,2,2,0,0,0,
03-mar-15,B.C.,"MEXICALI, B.C.",0,2,2,0,0,0,
05-mar-15,B.C.,"MEXICALI, B.C.",2,0,2,0,0,0,
06-mar-15,HGO.,"PACHUCA DE SOTO, HGO.",1,1,2,0,11,17,
07-mar-15,HGO.,"PACHUCA DE SOTO, HGO.",0,2,2,0,0,0,
09-mar-15,B.C.,"ENSENADA, B.C.",1,1,2,0,0,0,
10-mar-15,CAMP.,"CAMP., CAMP.",1,1,2,0,0,0,
11-mar-15,CAMP.,"CAMP., CAMP.",1,1,2,0,0,0,
11-mar-15,B.C.,"TIJUANA, B.C.",1,1,2,0,0,0,
12-mar-15,CAMP.,"CAMP., CAMP.",1,1,2,0,0,0,
13-mar-15,CAMP.,"CAMP., CAMP.",1,1,2,0,0,0,
14-mar-15,OAX.,"OAX. DE JUAREZ, OAX.",2,0,2,0,0,0,
15-mar-15,CAMP.,"CAMP., CAMP.",1,1,2,0,0,0,
16-mar-15,CAMP.,"CAMP., CAMP.",1,1,2,0,0,0,
18-mar-15,OAX.,"CIUDAD IXTEPEC, OAX.",0,2,2,0,0,0,
19-mar-15,DGO.,"GOMEZ PALACIO, DGO.",1,1,2,0,0,0,
20-mar-15,HGO.,"TULA DE ALLENDE, HGO.",1,1,2,0,0,0,
22-mar-15,PUE.,"TEHUACAN, PUE.",1,1,2,0,0,0,
25-mar-15,OAX.,"MIAHUATLAN DE PORFIRIO DIAZ, OAX.",1,1,2,0,0,0,
26-mar-15,OAX.,"MIAHUATLAN DE PORFIRIO DIAZ, OAX.",2,0,2,1,0,25,
28-mar-15,HGO.,"TULA DE ALLENDE, HGO.",2,0,2,0,0,0,
01-ago-15,GRO.,"IGUALA DE LA INDEPENDENCIA, GRO.",2,0,2,0,0,0,
03-ago-15,OAX.,"OAX. DE JUAREZ, OAX.",0,2,2,0,0,0,
03-ago-15,MEX.,"TEXCOCO, MEX.",2,0,2,0,5,0,
04-ago-15,GRO.,"COYUCA DE BENITEZ, GRO.",0,2,2,0,1,0,
04-ago-15,Q. ROO,"OTHON P. BLANCO, Q. ROO",2,0,2,1,0,64,
05-ago-15,OAX.,"MIAHUATLAN DE PORFIRIO DIAZ, OAX.",2,0,2,2,0,0,
05-ago-15,VER.,"MISANTLA, VER.",1,1,2,0,0,0,
05-ago-15,Q. ROO,"OTHON P. BLANCO, Q. ROO",0,2,2,0,6,368,
05-ago-15,NAY.,"JALA, NAY.",1,1,2,0,0,0,
06-ago-15,CHIS.,"TONALÁ, CHIS.",2,0,2,0,0,84,
06-ago-15,ZAC.,"JEREZ, ZAC.",1,1,2,0,0,0,
06-ago-15,PUE.,"PUE., PUE.",2,0,2,0,0,72,
07-ago-15,TAMPS.,"REYNOSA, TAMPS.",1,1,2,0,0,0,
07-ago-15,CHIH.,"CUAUHTÉMOC, CHIH.",2,0,2,0,0,0,
08-ago-15,S.L.P.,"CIUDAD VALLES, S.L.P.",2,0,2,0,0,0,
09-ago-15,TAMPS.,"REYNOSA, TAMPS.",2,0,2,3,0,200,
10-ago-15,SIN.,"CULIACAN, SIN.",2,0,2,1,6,0,
10-ago-15,TLAX.,"TLAX., TLAX.",1,1,2,0,0,0,
10-ago-15,COAH.,"TORREÓN, COAH.",1,1,2,0,0,69,
10-ago-15,CHIH.,"JANOS, CHIH.",1,1,2,0,0,0,
11-ago-15,CHIH.,"HGO. DEL PARRAL, CHIH.",1,1,2,0,0,0,
11-ago-15,DGO.,"TLAHUALILO, DGO.",1,1,2,0,0,0,
11-ago-15,CHIH.,"CHIH., CHIH.",1,1,2,0,0,279,
12-ago-15,OAX.,"SANTA MARIA ZACATEPEC, OAX.",1,1,2,0,0,0,
12-ago-15,VER.,"MISANTLA, VER.",0,2,2,0,0,0,
12-ago-15,B.C.S.,"LA PAZ, B.C.S.",2,0,2,0,0,0,
12-ago-15,PUE.,"PUE., PUE.",2,0,2,0,0,0,
13-ago-15,VER.,"PAPANTLA, VER.",2,0,2,0,1,133,
13-ago-15,GRO.,"LEONARDO BRAVO, GRO.",2,0,2,0,0,0,
13-ago-15,SON.,"CAJEME, SON.",2,0,2,2,0,253,
13-ago-15,OAX.,"SANTA MARIA ZACATEPEC, OAX.",0,2,2,0,0,0,
13-ago-15,GRO.,"COAHUAYUTLA DE JOSE MARIA IZAZAGA, GRO.",0,2,2,0,0,0,
14-ago-15,TAB.,"CENTRO, TAB.",2,0,2,0,1,217,
14-ago-15,COAH.,"ACUÑA, COAH.",1,1,2,0,0,0,
14-ago-15,TAMPS.,"VICTORIA, TAMPS.",1,1,2,11,0,20,
15-ago-15,DGO.,"DGO., DGO.",2,0,2,0,4,0,
15-ago-15,DGO.,"GOMEZ PALACIO, DGO.",2,0,2,0,0,0,
15-ago-15,HGO.,"EMILIANO ZAPATA, HGO.",2,0,2,0,0,0,
16-ago-15,VER.,"NARANJOS AMATLAN, VER.",2,0,2,2,0,0,
17-ago-15,TLAX.,"TLAX., TLAX.",2,0,2,0,0,0,
17-ago-15,COAH.,"TORREÓN, COAH.",1,1,2,0,0,13,
17-ago-15,MEX.,"CUAUTITLAN IZCALLI, MEX.",2,0,2,0,0,0,
17-ago-15,ZAC.,"JEREZ, ZAC.",2,0,2,0,0,550,
17-ago-15,DGO.,"LERDO, DGO.",2,0,2,0,0,0,
18-ago-15,HGO.,"EMILIANO ZAPATA, HGO.",2,0,2,0,0,0,
18-ago-15,OAX.,"MIAHUATLAN DE PORFIRIO DIAZ, OAX.",2,0,2,1,0,10,
18-ago-15,COAH.,"RAMOS ARIZPE, COAH.",2,0,2,0,0,0,
18-ago-15,CHIH.,"NUEVO CASAS GRANDES, CHIH.",2,0,2,0,0,47,
18-ago-15,GRO.,"SAN MARCOS, GRO.",1,1,2,0,0,0,
18-ago-15,SON.,"HERMOSILLO, SON.",2,0,2,14,0,170,
19-ago-15,TLAX.,"CALPULALPAN, TLAX.",0,2,2,0,0,0,
19-ago-15,OAX.,"SAN JUAN BAUTISTA TUXTEPEC, OAX.",2,0,2,0,0,39,
19-ago-15,OAX.,"MIAHUATLAN DE PORFIRIO DIAZ, OAX.",2,0,2,2,0,5,
20-ago-15,PUE.,"TEHUACAN, PUE.",1,1,2,0,0,0,
20-ago-15,QRO.,"CORREGIDORA, QRO.",2,0,2,0,1,0,
20-ago-15,SON.,"HERMOSILLO, SON.",1,1,2,7,0,0,
20-ago-15,TAB.,"CENTRO, TAB.",2,0,2,0,0,271,
20-ago-15,DGO.,"GOMEZ PALACIO, DGO.",1,1,2,0,0,0,
20-ago-15,COAH.,"SABINAS, COAH.",2,0,2,0,0,0,
20-ago-15,COAH.,"MÚZQUIZ, COAH.",2,0,2,0,0,0,
21-ago-15,VER.,"TUXPAM, VER.",2,0,2,0,0,0,
21-ago-15,OAX.,"MIAHUATLAN DE PORFIRIO DIAZ, OAX.",2,0,2,0,0,0,
21-ago-15,VER.,"JALACINGO, VER.",1,1,2,1,0,0,
21-ago-15,QRO.,"CORREGIDORA, QRO.",2,0,2,0,1,0,
21-ago-15,DGO.,"DGO., DGO.",2,0,2,0,0,0,
21-ago-15,TAB.,"CENTRO, TAB.",2,0,2,3,1,50,
21-ago-15,GRO.,"SAN MARCOS, GRO.",2,0,2,0,0,0,
22-ago-15,DGO.,"GOMEZ PALACIO, DGO.",1,1,2,0,1,0,
22-ago-15,MEX.,"IXTAPAN DE LA SAL, MEX.",2,0,2,0,0,0,
23-ago-15,DGO.,"GOMEZ PALACIO, DGO.",1,1,2,9,0,0,
23-ago-15,DGO.,"TLAHUALILO, DGO.",2,0,2,0,0,0,
24-ago-15,DGO.,"DGO., DGO.",1,1,2,0,0,0,
24-ago-15,VER.,"NARANJOS AMATLAN, VER.",0,2,2,0,0,5,
24-ago-15,COAH.,"ACUÑA, COAH.",1,1,2,0,0,0,
25-ago-15,SIN.,"CULIACAN, SIN.",2,0,2,0,1,0,
25-ago-15,TLAX.,"CHIAUTEMPAN, TLAX.",2,0,2,0,0,0,
25-ago-15,ZAC.,"JEREZ, ZAC.",0,2,2,0,0,559,
25-ago-15,COAH.,"PIEDRAS NEGRAS, COAH.",0,2,2,0,0,0,
25-ago-15,MEX.,"SAN MATEO ATENCO, MEX.",2,0,2,1,0,0,
26-ago-15,VER.,"NARANJOS AMATLAN, VER.",0,2,2,2,0,0,
26-ago-15,MEX.,"SAN MATEO ATENCO, MEX.",1,1,2,0,1,0,
26-ago-15,DGO.,"GOMEZ PALACIO, DGO.",2,0,2,1,0,0,
26-ago-15,COAH.,"MONCLOVA, COAH.",2,0,2,0,0,112,
26-ago-15,COAH.,"SABINAS, COAH.",1,1,2,0,0,0,
26-ago-15,B.C.,"MEXICALI, B.C.",0,2,2,0,0,0,
26-ago-15,GRO.,"COYUCA DE BENITEZ, GRO.",2,0,2,0,0,192,
27-ago-15,TAMPS.,"EL MANTE, TAMPS.",0,2,2,0,0,0,
27-ago-15,ZAC.,"JEREZ, ZAC.",1,1,2,32,0,464,
27-ago-15,YUC.,"PROGRESO, YUC.",1,1,2,0,0,0,
27-ago-15,DGO.,"LERDO, DGO.",1,1,2,0,0,0,
27-ago-15,MEX.,"MEXICALTZINGO, MEX.",0,2,2,0,0,0,
28-ago-15,MEX.,"MEXICALTZINGO, MEX.",2,0,2,1,0,0,
28-ago-15,ZAC.,"FRESNILLO, ZAC.",0,2,2,0,0,0,
28-ago-15,DGO.,"DGO., DGO.",2,0,2,0,0,0,
28-ago-15,GRO.,"PUNGARABATO, GRO.",2,0,2,0,0,0,
28-ago-15,VER.,"TANTOYUCA, VER.",1,1,2,0,0,0,
28-ago-15,SON.,"HERMOSILLO, SON.",2,0,2,3,0,0,
28-ago-15,CHIH.,"CHIH., CHIH.",1,1,2,21,0,2537,
29-ago-15,MEX.,"MEXICALTZINGO, MEX.",1,1,2,0,0,0,
29-ago-15,COAH.,"MONCLOVA, COAH.",2,0,2,0,0,50,
29-ago-15,DGO.,"TLAHUALILO, DGO.",1,1,2,0,0,0,
30-ago-15,N.L.,"MONTERREY, N.L.",2,0,2,40,0,580,
30-ago-15,B.C.,"TIJUANA, B.C.",1,1,2,0,0,0,
31-ago-15,ZAC.,"FRESNILLO, ZAC.",2,0,2,0,0,0,
31-ago-15,COAH.,"MÚZQUIZ, COAH.",1,1,2,0,0,0,
31-ago-15,COAH.,"SABINAS, COAH.",2,0,2,0,1,0,
31-ago-15,CHIH.,"HGO. DEL PARRAL, CHIH.",2,0,2,0,0,0,
31-ago-15,MEX.,"HUIXQUILUCAN, MEX.",2,0,2,2,0,0,
01-sep-15,OAX.,"SALINA CRUZ, OAX.",1,1,2,0,0,1,
01-sep-15,SIN.,"COSALA, SIN.",1,1,2,0,5,0,
02-sep-15,SIN.,"CULIACAN, SIN.",0,2,2,0,11,0,
02-sep-15,VER.,"TIERRA BLANCA, VER.",2,0,2,0,0,0,
02-sep-15,DGO.,"TLAHUALILO, DGO.",1,1,2,0,0,0,
02-sep-15,DGO.,"MAPIMI, DGO.",1,1,2,0,0,0,
02-sep-15,B.C.,"TIJUANA, B.C.",2,0,2,0,0,0,
02-sep-15,MEX.,"HUIXQUILUCAN, MEX.",1,1,2,0,0,0,
03-sep-15,SIN.,"ANGOSTURA, SIN.",1,1,2,0,0,0,
03-sep-15,SIN.,"CHOIX, SIN.",0,2,2,0,9,0,
03-sep-15,SON.,"HERMOSILLO, SON.",2,0,2,0,0,0,
03-sep-15,B.C.,"ENSENADA, B.C.",2,0,2,0,0,0,
03-sep-15,B.C.,"MEXICALI, B.C.",2,0,2,0,0,0,
03-sep-15,COAH.,"MÚZQUIZ, COAH.",0,2,2,0,0,0,
03-sep-15,COAH.,"ACUÑA, COAH.",2,0,2,0,0,0,
04-sep-15,OAX.,"OAX. DE JUAREZ, OAX.",0,2,2,0,0,0,
04-sep-15,GRO.,"ZIHUATANEJO DE AZUETA, GRO.",2,0,2,0,0,44,
04-sep-15,B.C.,"TIJUANA, B.C.",2,0,2,0,0,0,
04-sep-15,COL.,"COL., COL.",0,2,2,0,0,19,
04-sep-15,SIN.,"CULIACAN, SIN.",1,1,2,0,4,0,
05-sep-15,MEX.,"HUIXQUILUCAN, MEX.",1,1,2,0,0,103,
06-sep-15,DGO.,"DGO., DGO.",2,0,2,1,2,0,
06-sep-15,N.L.,"GRAL. ESCOBEDO, N.L.",1,1,2,11,0,700,
06-sep-15,DGO.,"LERDO, DGO.",1,1,2,0,0,0,
07-sep-15,SIN.,"ROSARIO, SIN.",1,1,2,0,0,0,
07-sep-15,SIN.,"SAN IGNACIO, SIN.",1,1,2,0,0,0,
07-sep-15,DGO.,"LERDO, DGO.",2,0,2,0,0,0,
07-sep-15,MEX.,"CHAPULTEPEC, MEX.",1,1,2,1,0,5,
07-sep-15,DGO.,"DGO., DGO.",2,0,2,21,0,0,
07-sep-15,SON.,"HERMOSILLO, SON.",0,2,2,0,0,0,
08-sep-15,TLAX.,"TLAX., TLAX.",2,0,2,0,0,0,
08-sep-15,VER.,"PEROTE, VER.",2,0,2,0,0,0,
08-sep-15,SON.,"HERMOSILLO, SON.",2,0,2,0,0,0,
08-sep-15,SIN.,"SAN IGNACIO, SIN.",1,1,2,0,0,0,
08-sep-15,MEX.,"TONATICO, MEX.",1,1,2,0,0,115,
09-sep-15,HGO.,"MIXQUIAHUALA DE JUAREZ, HGO.",2,0,2,0,0,1000,
09-sep-15,VER.,"TANTOYUCA, VER.",2,0,2,0,0,0,
09-sep-15,SIN.,"SAN IGNACIO, SIN.",1,1,2,0,0,0,
09-sep-15,DGO.,"DGO., DGO.",2,0,2,4,2,0,
09-sep-15,TLAX.,"HUAMANTLA, TLAX.",2,0,2,0,0,0,
09-sep-15,COAH.,"RAMOS ARIZPE, COAH.",1,1,2,2,0,115,
09-sep-15,COAH.,"ACUÑA, COAH.",0,2,2,0,0,2,
10-sep-15,DGO.,"LERDO, DGO.",0,2,2,0,0,0,
10-sep-15,N.L.,"MONTERREY, N.L.",2,0,2,0,0,2786,
11-sep-15,GRO.,"COPANATOYAC, GRO.",2,0,2,0,0,0,
11-sep-15,N.L.,"MONTERREY, N.L.",2,0,2,1,0,0,
12-sep-15,N.L.,"GRAL. ESCOBEDO, N.L.",2,0,2,0,0,8200,
12-sep-15,DGO.,"LERDO, DGO.",0,2,2,0,0,0,
12-sep-15,DGO.,"TLAHUALILO, DGO.",0,2,2,0,0,0,
13-sep-15,N.L.,"MONTERREY, N.L.",2,0,2,22,0,8473,
14-sep-15,TLAX.,"TLAXCO, TLAX.",0,2,2,0,0,0,
14-sep-15,GRO.,"COPANATOYAC, GRO.",2,0,2,0,0,0,
14-sep-15,COAH.,"TORREÓN, COAH.",2,0,2,0,0,0,
14-sep-15,N.L.,"MONTERREY, N.L.",2,0,2,30,0,100,
15-sep-15,CHIH.,"HGO. DEL PARRAL, CHIH.",2,0,2,0,0,0,
15-sep-15,COAH.,"MÚZQUIZ, COAH.",1,1,2,0,0,0,
15-sep-15,B.C.,"TIJUANA, B.C.",0,2,2,0,0,0,
17-sep-15,QRO.,"QUERETARO, QRO.",1,1,2,0,0,0,
17-sep-15,DGO.,"GOMEZ PALACIO, DGO.",1,1,2,0,0,0,
17-sep-15,COAH.,"SABINAS, COAH.",1,1,2,0,0,0,
17-sep-15,CHIH.,"HGO. DEL PARRAL, CHIH.",2,0,2,0,0,46,
17-sep-15,N.L.,"MONTERREY, N.L.",1,1,2,1,0,90,
17-sep-15,N.L.,"MONTERREY, N.L.",1,1,2,1,0,90,
18-sep-15,DGO.,"DGO., DGO.",0,2,2,44,0,0,
18-sep-15,AGS.,"JESÚS MARÍA, AGS.",2,0,2,0,0,6,
19-sep-15,DGO.,"GOMEZ PALACIO, DGO.",2,0,2,0,0,0,
20-sep-15,QRO.,"QUERETARO, QRO.",1,1,2,0,0,0,
21-sep-15,VER.,"PAPANTLA, VER.",1,1,2,0,0,100,
21-sep-15,DGO.,"GOMEZ PALACIO, DGO.",0,2,2,0,0,0,
21-sep-15,DGO.,"LERDO, DGO.",1,1,2,0,0,0,
21-sep-15,QRO.,"QUERETARO, QRO.",2,0,2,0,0,0,
21-sep-15,TAMPS.,"MIGUEL ALEMAN, TAMPS.",1,1,2,0,0,0,
21-sep-15,MEX.,"TENANGO DEL VALLE, MEX.",1,1,2,1,0,40,
22-sep-15,MEX.,"TENANGO DEL VALLE, MEX.",2,0,2,1,0,0,
22-sep-15,TLAX.,"TLAXCO, TLAX.",1,1,2,0,0,0,
23-sep-15,N.L.,"SAN PEDRO GARZA GARCIA, N.L.",2,0,2,30,0,1100,
23-sep-15,SIN.,"ROSARIO, SIN.",1,1,2,0,1,0,
23-sep-15,SIN.,"SAN IGNACIO, SIN.",0,2,2,0,0,0,
23-sep-15,SIN.,"CULIACAN, SIN.",2,0,2,0,17,0,
23-sep-15,B.C.,"ENSENADA, B.C.",1,1,2,0,0,0,
23-sep-15,MEX.,"TLALMANALCO, MEX.",1,1,2,0,0,181,
24-sep-15,MEX.,"TLALMANALCO, MEX.",2,0,2,0,0,0,
24-sep-15,COAH.,"TORREÓN, COAH.",1,1,2,0,0,0,
24-sep-15,DGO.,"TLAHUALILO, DGO.",0,2,2,0,0,0,
25-sep-15,DGO.,"DGO., DGO.",2,0,2,1,1,0,
25-sep-15,CHIH.,"HGO. DEL PARRAL, CHIH.",0,2,2,0,0,0,
25-sep-15,DGO.,"TLAHUALILO, DGO.",1,1,2,0,0,0,
25-sep-15,COAH.,"SABINAS, COAH.",1,1,2,0,1,0,
25-sep-15,COAH.,"ACUÑA, COAH.",1,1,2,0,0,129,
25-sep-15,MEX.,"TENANCINGO, MEX.",2,0,2,0,0,96,
25-sep-15,SIN.,"ROSARIO, SIN.",2,0,2,0,0,0,
26-sep-15,VER.,"PUEBLO VIEJO, VER.",1,1,2,1,0,2,
28-sep-15,GRO.,"FLORENCIO VILLARREAL, GRO.",1,1,2,0,0,0,
28-sep-15,TLAX.,"TLAX., TLAX.",1,1,2,0,0,0,
28-sep-15,TLAX.,"NATIVITAS, TLAX.",2,0,2,0,0,0,
28-sep-15,DGO.,"DGO., DGO.",1,1,2,0,0,0,
29-sep-15,COAH.,"TORREÓN, COAH.",2,0,2,0,0,0,
29-sep-15,COAH.,"ACUÑA, COAH.",1,1,2,0,0,0,
29-sep-15,SIN.,"BADIRAGUATO, SIN.",1,1,2,0,0,0,
29-sep-15,SIN.,"NAVOLATO, SIN.",1,1,2,0,2,0,
30-sep-15,SIN.,"ESCUINAPA, SIN.",0,2,2,0,0,0,
30-sep-15,COAH.,"MONCLOVA, COAH.",1,1,2,0,0,53,
30-sep-15,COAH.,"SABINAS, COAH.",1,1,2,0,0,0,
30-sep-15,MEX.,"TEOLOYUCAN, MEX.",1,1,2,0,0,0,
01-oct-15,MEX.,"NICOLAS ROMERO, MEX.",1,1,2,1,10,0,
01-oct-15,MEX.,"OCOYOACAC, MEX.",2,0,2,2,0,70,
01-oct-15,SIN.,"NAVOLATO, SIN.",1,1,2,0,10,0,
01-oct-15,MEX.,"TEOLOYUCAN, MEX.",2,0,2,0,1,0,
02-oct-15,HGO.,"TULANCINGO DE BRAVO, HGO.",1,1,2,0,0,0,
02-oct-15,B.C.,"ENSENADA, B.C.",0,2,2,0,0,0,
02-oct-15,B.C.,"MEXICALI, B.C.",1,1,2,0,0,0,
03-oct-15,B.C.,"MEXICALI, B.C.",1,1,2,0,0,0,
03-oct-15,MEX.,"OCOYOACAC, MEX.",1,1,2,0,0,0,
05-oct-15,VER.,"IGNACIO DE LA LLAVE, VER.",0,2,2,0,0,0,
05-oct-15,COAH.,"TORREÓN, COAH.",2,0,2,0,0,0,
05-oct-15,COAH.,"ACUÑA, COAH.",0,2,2,0,0,0,
06-oct-15,GRO.,"SAN MIGUEL TOTOLAPAN, GRO.",1,1,2,0,0,0,
06-oct-15,DGO.,"DGO., DGO.",2,0,2,6,0,0,
06-oct-15,VER.,"IGNACIO DE LA LLAVE, VER.",0,2,2,0,0,261,
06-oct-15,COAH.,"PIEDRAS NEGRAS, COAH.",2,0,2,0,1,180,
07-oct-15,SIN.,"ELOTA, SIN.",2,0,2,0,0,0,
07-oct-15,COAH.,"ACUÑA, COAH.",1,1,2,0,0,0,
07-oct-15,B.C.,"TIJUANA, B.C.",2,0,2,0,0,0,
08-oct-15,COL.,"COL., COL.",1,1,2,0,0,0,
08-oct-15,COAH.,"TORREÓN, COAH.",2,0,2,0,0,0,
08-oct-15,TAMPS.,"CIUDAD MADERO, TAMPS.",2,0,2,0,0,519,
08-oct-15,CHIH.,"HGO. DEL PARRAL, CHIH.",1,1,2,0,0,73,
08-oct-15,DGO.,"DGO., DGO.",0,2,2,0,0,0,
08-oct-15,NAY.,"AHUACATLAN, NAY.",2,0,2,0,0,0,
09-oct-15,HGO.,"HUICHAPAN, HGO.",0,2,2,0,0,0,
09-oct-15,N.L.,"SAN NICOLAS DE LOS GARZA, N.L.",2,0,2,30,0,4500,
09-oct-15,PUE.,"PUE., PUE.",2,0,2,0,0,0,
09-oct-15,SON.,"HERMOSILLO, SON.",2,0,2,1,0,0,
09-oct-15,B.C.,"TIJUANA, B.C.",2,0,2,0,0,0,
10-oct-15,HGO.,"TULANCINGO DE BRAVO, HGO.",1,1,2,0,0,211,
10-oct-15,TLAX.,"ZACATELCO, TLAX.",1,1,2,0,0,0,
10-oct-15,B.C.,"TIJUANA, B.C.",1,1,2,0,0,0,
12-oct-15,MEX.,"SAN ANTONIO LA ISLA, MEX.",0,2,2,0,0,0,
12-oct-15,MEX.,"NEXTLALPAN, MEX., MEX.",2,0,2,0,0,54,
12-oct-15,B.C.,"ENSENADA, B.C.",1,1,2,0,0,0,
12-oct-15,DGO.,"LERDO, DGO.",1,1,2,0,0,0,
12-oct-15,VER.,"TLALIXCOYAN, VER.",1,1,2,0,0,0,
13-oct-15,COAH.,"TORREÓN, COAH.",2,0,2,0,0,0,
13-oct-15,VER.,"MARTINEZ DE LA TORRE, VER.",1,1,2,0,0,0,
13-oct-15,HGO.,"HUAUTLA, HGO.",1,1,2,0,0,0,
13-oct-15,GRO.,"COYUCA DE CATALAN, GRO.",2,0,2,0,0,0,
13-oct-15,MEX.,"NEXTLALPAN, MEX., MEX.",1,1,2,1,2,0,
14-oct-15,GRO.,"ATOYAC DE ALVAREZ, GRO.",2,0,2,0,0,0,
14-oct-15,MEX.,"SAN ANTONIO LA ISLA, MEX.",2,0,2,1,0,6,
14-oct-15,MEX.,"VALLE DE BRAVO, MEX.",2,0,2,2,0,4,
14-oct-15,COAH.,"TORREÓN, COAH.",2,0,2,0,0,0,
15-oct-15,SON.,"CAJEME, SON.",1,1,2,0,0,0,
15-oct-15,MEX.,"VALLE DE BRAVO, MEX.",1,1,2,0,0,4,
16-oct-15,SIN.,"ESCUINAPA, SIN.",1,1,2,0,0,0,
16-oct-15,SIN.,"NAVOLATO, SIN.",0,2,2,0,2,0,
16-oct-15,GRO.,"ATOYAC DE ALVAREZ, GRO.",2,0,2,0,0,0,
16-oct-15,MEX.,"LA PAZ, MEX.",1,1,2,0,0,0,
16-oct-15,MEX.,"SAN ANTONIO LA ISLA, MEX.",1,1,2,4,0,0,
17-oct-15,HGO.,"HUAUTLA, HGO.",2,0,2,0,0,200,
17-oct-15,HGO.,"TULANCINGO DE BRAVO, HGO.",2,0,2,0,0,29,
17-oct-15,GRO.,"PUNGARABATO, GRO.",0,2,2,0,0,0,
17-oct-15,N.L.,"SAN NICOLAS DE LOS GARZA, N.L.",2,0,2,94,0,4500,
19-oct-15,N.L.,"SAN NICOLAS DE LOS GARZA, N.L.",1,1,2,1,0,500,
20-oct-15,SIN.,"MOCORITO, SIN.",1,1,2,0,0,0,
20-oct-15,DGO.,"GOMEZ PALACIO, DGO.",1,1,2,0,0,0,
20-oct-15,D.F.,"ALVARO OBREGON, D.F.",2,0,2,0,3,0,
20-oct-15,MEX.,"TEOTIHUACAN, MEX.",1,1,2,0,0,90,
21-oct-15,COAH.,"SALTILLO, COAH.",2,0,2,0,1,129,
21-oct-15,MEX.,"TEOTIHUACAN, MEX.",1,1,2,0,1,0,
22-oct-15,SIN.,"MOCORITO, SIN.",2,0,2,0,0,0,
23-oct-15,N.L.,"LOS HERRERAS, N.L.",1,1,2,0,0,0,
24-oct-15,DGO.,"DGO., DGO.",2,0,2,0,0,0,
26-oct-15,MEX.,"CALIMAYA, MEX.",2,0,2,0,0,0,
26-oct-15,MEX.,"TEXCALYACAC, MEX.",1,1,2,0,0,7,
26-oct-15,GRO.,"ATOYAC DE ALVAREZ, GRO.",1,1,2,0,0,0,
26-oct-15,COAH.,"TORREÓN, COAH.",1,1,2,0,0,0,
26-oct-15,MEX.,"COCOTITLAN, MEX.",2,0,2,0,0,0,
27-oct-15,SON.,"HERMOSILLO, SON.",2,0,2,0,0,0,
27-oct-15,SON.,"CAJEME, SON.",0,2,2,0,0,0,
28-oct-15,COAH.,"ACUÑA, COAH.",2,0,2,20,0,1,
29-oct-15,DGO.,"DGO., DGO.",0,2,2,3,0,0,
29-oct-15,COAH.,"PIEDRAS NEGRAS, COAH.",0,2,2,0,0,0,
29-oct-15,COAH.,"MATAMOROS, COAH.",2,0,2,3,0,49,
29-oct-15,N.L.,"LOS ALDAMAS, N.L.",1,1,2,0,0,0,
30-oct-15,MEX.,"COCOTITLAN, MEX.",2,0,2,0,0,0,
01-nov-15,B.C.,"TIJUANA, B.C.",1,1,2,0,0,0,
02-nov-15,DGO.,"LERDO, DGO.",0,2,2,0,0,0,
02-nov-15,HGO.,"ZACUALTIPAN DE ANGELES, HGO.",2,0,2,0,0,0,
02-nov-15,COAH.,"MATAMOROS, COAH.",1,1,2,0,0,0,
03-nov-15,AGS.,"JESÚS MARÍA, AGS.",2,0,2,10,0,383,
03-nov-15,DGO.,"GOMEZ PALACIO, DGO.",2,0,2,0,0,0,
03-nov-15,MEX.,"CAPULHUAC, MEX.",2,0,2,0,0,0,
04-nov-15,B.C.,"ENSENADA, B.C.",1,1,2,0,0,0,
05-nov-15,B.C.,"TIJUANA, B.C.",1,1,2,0,0,0,
05-nov-15,B.C.,"ENSENADA, B.C.",0,2,2,0,0,0,
05-nov-15,MEX.,"PAPALOTLA, MEX.",2,0,2,0,0,0,
05-nov-15,MEX.,"VALLE DE CHALCO SOLIDARIDAD, MEX.",0,2,2,0,0,0,
05-nov-15,COAH.,"SABINAS, COAH.",0,2,2,0,0,0,
05-nov-15,DGO.,"GOMEZ PALACIO, DGO.",0,2,2,0,0,0,
06-nov-15,TAB.,"BALANCAN, TAB.",2,0,2,0,0,0,
06-nov-15,B.C.,"ENSENADA, B.C.",0,2,2,0,0,0,
06-nov-15,COAH.,"ACUÑA, COAH.",2,0,2,1,0,3,
06-nov-15,MEX.,"CAPULHUAC, MEX.",1,1,2,0,0,0,
06-nov-15,MOR.,"CUERNAVACA, MOR.",2,0,2,0,6,0,
07-nov-15,MOR.,"CUERNAVACA, MOR.",1,1,2,0,4,0,
09-nov-15,COAH.,"SAN PEDRO, COAH.",2,0,2,0,0,0,
09-nov-15,COAH.,"MONCLOVA, COAH.",2,0,2,0,0,0,
09-nov-15,COAH.,"SABINAS, COAH.",1,1,2,0,0,0,
09-nov-15,MEX.,"CHIAUTLA, MEX.",1,1,2,0,0,0,
10-nov-15,CHIS.,"TUXTLA CHICO, CHIS.",1,1,2,0,0,0,
10-nov-15,B.C.,"TIJUANA, B.C.",2,0,2,0,0,0,
11-nov-15,B.C.,"TIJUANA, B.C.",2,0,2,0,0,0,
11-nov-15,MOR.,"CUERNAVACA, MOR.",0,2,2,0,1,0,
11-nov-15,MEX.,"MALINALCO, MEX.",2,0,2,1,0,0,
11-nov-15,TAMPS.,"EL MANTE, TAMPS.",2,0,2,0,0,0,
12-nov-15,YUC.,"CALOTMUL, YUC.",2,0,2,0,1,455,
12-nov-15,COAH.,"MATAMOROS, COAH.",2,0,2,0,0,0,
12-nov-15,MEX.,"CHIAUTLA, MEX.",0,2,2,0,0,0,
13-nov-15,COAH.,"ACUÑA, COAH.",1,1,2,0,0,0,
13-nov-15,B.C.,"TIJUANA, B.C.",1,1,2,0,0,0,
14-nov-15,GRO.,"AJUCHITLAN DEL PROGRESO, GRO.",1,1,2,0,0,0,
14-nov-15,GRO.,"AJUCHITLAN DEL PROGRESO, GRO.",1,1,2,0,0,0,
14-nov-15,MEX.,"TECAMAC, MEX.",2,0,2,2,1,2,
15-nov-15,GRO.,"AJUCHITLAN DEL PROGRESO, GRO.",1,1,2,3,0,0,
17-nov-15,DGO.,"DGO., DGO.",1,1,2,2,0,0,
17-nov-15,B.C.,"MEXICALI, B.C.",1,1,2,0,0,0,
17-nov-15,N.L.,"MONTERREY, N.L.",1,1,2,7,0,0,
17-nov-15,TAMPS.,"MATAMOROS, TAMPS.",0,2,2,0,0,0,
17-nov-15,MEX.,"NOPALTEPEC, MEX.",0,2,2,0,0,0,
18-nov-15,SIN.,"SIN., SIN.",2,0,2,0,0,0,
18-nov-15,DGO.,"DGO., DGO.",2,0,2,20,0,0,
18-nov-15,TAMPS.,"MATAMOROS, TAMPS.",2,0,2,0,0,0,
18-nov-15,COAH.,"MATAMOROS, COAH.",2,0,2,0,0,0,
18-nov-15,MEX.,"NOPALTEPEC, MEX.",0,2,2,0,0,16,
19-nov-15,HGO.,"TEPEAPULCO, HGO.",2,0,2,0,0,500,
19-nov-15,N.L.,"GRAL. ESCOBEDO, N.L.",2,0,2,1,0,0,
19-nov-15,COAH.,"SAN PEDRO, COAH.",2,0,2,1,4,28,
20-nov-15,COAH.,"RAMOS ARIZPE, COAH.",2,0,2,0,0,0,
20-nov-15,MEX.,"RAYON, MEX.",2,0,2,1,0,0,
20-nov-15,AGS.,"AGS., AGS.",1,1,2,0,0,10,
20-nov-15,MEX.,"OTUMBA, MEX.",0,2,2,0,0,48,
21-nov-15,MEX.,"RAYON, MEX.",2,0,2,2,0,0,
21-nov-15,HGO.,"TLAXCOAPAN, HGO.",2,0,2,0,0,0,
22-nov-15,MOR.,"CUERNAVACA, MOR.",2,0,2,0,0,0,
23-nov-15,N.L.,"MONTERREY, N.L.",2,0,2,1,0,0,
23-nov-15,COAH.,"SABINAS, COAH.",1,1,2,0,0,0,
23-nov-15,DGO.,"DGO., DGO.",1,1,2,0,0,0,
23-nov-15,GRO.,"TELOLOAPAN, GRO.",1,1,2,0,0,0,
24-nov-15,N.L.,"GRAL. ESCOBEDO, N.L.",2,0,2,2,0,0,
24-nov-15,COAH.,"SABINAS, COAH.",2,0,2,0,0,0,
24-nov-15,COAH.,"ACUÑA, COAH.",2,0,2,0,0,0,
24-nov-15,SON.,"ALAMOS, SON.",2,0,2,0,0,0,
25-nov-15,N.L.,"MONTERREY, N.L.",2,0,2,1,0,100,
25-nov-15,SON.,"CAJEME, SON.",0,2,2,0,0,0,
25-nov-15,SON.,"NAVOJOA, SON.",2,0,2,0,0,0,
25-nov-15,SON.,"NOGALES, SON.",2,0,2,2,0,55,
25-nov-15,SON.,"CABORCA, SON.",0,2,2,0,0,100,
25-nov-15,MEX.,"AXAPUSCO, MEX.",2,0,2,0,1,0,
25-nov-15,MEX.,"TEMASCALAPA, MEX.",0,2,2,0,0,98,
26-nov-15,MEX.,"AXAPUSCO, MEX.",2,0,2,0,1,0,
26-nov-15,MEX.,"TEMASCALAPA, MEX.",0,2,2,0,0,98,
26-nov-15,SON.,"EMPALME, SON.",0,2,2,0,0,0,
26-nov-15,COAH.,"MATAMOROS, COAH.",2,0,2,0,0,0,
26-nov-15,SON.,"SAN LUIS RIO COLORADO, SON.",0,2,2,2,0,106,
27-nov-15,SON.,"CAJEME, SON.",2,0,2,0,0,0,
27-nov-15,SON.,"NOGALES, SON.",2,0,2,3,0,2,
27-nov-15,SON.,"CANANEA, SON.",2,0,2,0,0,0,
27-nov-15,SON.,"PITIQUITO, SON.",2,0,2,8,0,700,
27-nov-15,COAH.,"MÚZQUIZ, COAH.",1,1,2,0,0,0,
27-nov-15,YUC.,"VALLADOLID, YUC.",0,2,2,0,0,27,
27-nov-15,YUC.,"MOTUL, YUC.",2,0,2,3,0,154,
27-nov-15,N.L.,"MONTERREY, N.L.",2,0,2,1,0,200,
27-nov-15,SON.,"NOGALES, SON.",2,0,2,1,0,0,
27-nov-15,SON.,"SAN LUIS RIO COLORADO, SON.",0,2,2,5,0,0,
28-nov-15,N.L.,"GRAL. ESCOBEDO, N.L.",2,0,2,0,0,1150,
28-nov-15,SON.,"CAJEME, SON.",2,0,2,0,0,0,
30-nov-15,ZAC.,"ZAC., ZAC.",0,2,2,0,0,0,
01-dic-15,GRO.,"ATOYAC DE ALVAREZ, GRO.",0,2,2,0,0,0,
01-dic-15,TAB.,"BALANCAN, TAB.",1,1,2,0,0,0,
01-dic-15,COAH.,"RAMOS ARIZPE, COAH.",1,1,2,0,0,0,
01-dic-15,SON.,"CAJEME, SON.",2,0,2,2,0,559,
01-dic-15,HGO.,"TEPETITLAN, HGO.",1,1,2,0,0,0,
02-dic-15,SON.,"MAGDALENA, SON.",2,0,2,0,0,0,
02-dic-15,SON.,"HUATABAMPO, SON.",2,0,2,3,0,0,
02-dic-15,AGS.,"AGS., AGS.",1,1,2,8,0,68,
02-dic-15,COAH.,"ACUÑA, COAH.",1,1,2,0,0,0,
02-dic-15,B.C.,"ENSENADA, B.C.",1,1,2,0,0,0,
03-dic-15,SON.,"NOGALES, SON.",2,0,2,1,0,65,
03-dic-15,SON.,"AGUA PRIETA, SON.",1,1,2,1,0,24,
03-dic-15,N.L.,"MONTERREY, N.L.",2,0,2,0,0,0,
04-dic-15,B.C.,"TIJUANA, B.C.",0,2,2,0,0,0,
04-dic-15,SON.,"NAVOJOA, SON.",1,1,2,0,0,100,
04-dic-15,SON.,"SAN LUIS RIO COLORADO, SON.",1,1,2,1,1,93,
04-dic-15,TAB.,"TENOSIQUE, TAB.",0,2,2,0,0,0,
04-dic-15,S.L.P.,"SALINAS, S.L.P.",1,1,2,0,0,0,
05-dic-15,TAMPS.,"NUEVO LAREDO, TAMPS.",0,2,2,0,0,0,
05-dic-15,TAMPS.,"MATAMOROS, TAMPS.",2,0,2,2,0,0,
05-dic-15,SON.,"EMPALME, SON.",2,0,2,0,0,0,
05-dic-15,SON.,"ALTAR, SON.",1,1,2,0,0,0,
05-dic-15,COAH.,"TORREÓN, COAH.",1,1,2,12,0,0,
06-dic-15,TAMPS.,"MATAMOROS, TAMPS.",2,0,2,0,0,0,
07-dic-15,SON.,"SAN LUIS RIO COLORADO, SON.",1,1,2,2,0,38,
07-dic-15,B.C.,"TIJUANA, B.C.",2,0,2,0,0,0,
07-dic-15,B.C.,"ENSENADA, B.C.",0,2,2,0,0,0,
08-dic-15,S.L.P.,"CIUDAD VALLES, S.L.P.",1,1,2,0,0,0,
08-dic-15,S.L.P.,"RIOVERDE, S.L.P.",2,0,2,0,0,200,
08-dic-15,SON.,"CANANEA, SON.",0,2,2,0,0,0,
08-dic-15,SON.,"PITIQUITO, SON.",1,1,2,0,0,151,
09-dic-15,GTO.,"SAN JUAN DEL RIO, QRO.",2,0,2,0,0,0,
09-dic-15,QRO.,"SAN JUAN DEL RIO, QRO.",2,0,2,0,0,0,
09-dic-15,SON.,"GUAYMAS, SON.",0,2,2,0,0,0,
09-dic-15,SON.,"HUATABAMPO, SON.",2,0,2,0,0,0,
09-dic-15,B.C.,"ENSENADA, B.C.",1,1,2,0,0,0,
09-dic-15,GRO.,"HUITZUCO DE LOS FIGUEROA, GRO.",2,0,2,0,0,0,
09-dic-15,S.L.P.,"CIUDAD VALLES, S.L.P.",0,2,2,0,0,0,
10-dic-15,S.L.P.,"CIUDAD VALLES, S.L.P.",1,1,2,0,0,0,
10-dic-15,MOR.,"CUERNAVACA, MOR.",1,1,2,0,1,0,
10-dic-15,B.C.,"ENSENADA, B.C.",0,2,2,0,0,0,
10-dic-15,SON.,"NAVOJOA, SON.",2,0,2,1,0,100,
10-dic-15,SON.,"BENITO JUAREZ, SON.",2,0,2,0,0,0,
11-dic-15,SON.,"NAVOJOA, SON.",2,0,2,2,0,0,
11-dic-15,SON.,"NOGALES, SON.",2,0,2,2,0,37,
11-dic-15,SON.,"MAGDALENA, SON.",2,0,2,1,0,0,
11-dic-15,MOR.,"CUERNAVACA, MOR.",1,1,2,0,3,0,
11-dic-15,B.C.,"TIJUANA, B.C.",2,0,2,0,0,0,
12-dic-15,CHIH.,"HGO. DEL PARRAL, CHIH.",2,0,2,1,0,210,
12-dic-15,SON.,"AGUA PRIETA, SON.",1,1,2,1,0,11,
13-dic-15,CHIH.,"HGO. DEL PARRAL, CHIH.",2,0,2,0,0,11,
14-dic-15,B.C.,"MEXICALI, B.C.",0,2,2,0,0,0,
14-dic-15,DGO.,"DGO., DGO.",1,1,2,1,0,0,
15-dic-15,GRO.,"CHILPANCINGO DE LOS BRAVO, GRO.",2,0,2,0,0,0,
15-dic-15,GRO.,"ATOYAC DE ALVAREZ, GRO.",1,1,2,0,0,0,
15-dic-15,Q. ROO,"COZUMEL, Q. ROO",2,0,2,0,0,902,
16-dic-15,QRO.,"SAN JUAN DEL RIO, QRO.",2,0,2,0,0,0,
20-dic-15,CHIS.,"COMITAN DE DOMÍNGUEZ, CHIS.",1,1,2,0,0,421,
22-dic-15,DGO.,"DGO., DGO.",1,1,2,122,1,0,
23-dic-15,DGO.,"DGO., DGO.",1,1,2,2,0,0,
26-dic-15,B.C.,"ENSENADA, B.C.",1,1,2,0,0,0,
29-dic-15,B.C.,"TIJUANA, B.C.",1,1,2,0,0,0,
30-dic-15,DGO.,"DGO., DGO.",2,0,2,0,0,0,
30-dic-15,B.C.,"TIJUANA, B.C.",2,0,2,0,0,0,
08-ene-16,DGO.,"DGO., DGO.",2,0,2,0,1,0,
13-ene-16,B.C.,"TIJUANA, B.C.",2,0,2,0,0,0,
16-ene-16,TAMPS.,"MATAMOROS, TAMPS.",0,2,2,0,0,0,
16-ene-16,B.C.,"ENSENADA, B.C.",0,2,2,0,0,0,
16-ene-16,B.C.,"MEXICALI, B.C.",1,1,2,0,0,0,
18-ene-16,COAH.,"MONCLOVA, COAH.",1,1,2,0,0,0,
19-ene-16,DGO.,"DGO., DGO.",2,0,2,0,0,0,
20-ene-16,COAH.,"PIEDRAS NEGRAS, COAH.",2,0,2,0,0,0,
20-ene-16,COAH.,"SAN PEDRO, COAH.",2,0,2,0,0,0,
20-ene-16,CHIH.,"NUEVO CASAS GRANDES, CHIH.",2,0,2,0,0,8,
21-ene-16,COAH.,"SALTILLO, COAH.",2,0,2,0,0,46,
22-ene-16,COAH.,"MONCLOVA, COAH.",2,0,2,13,0,348,
23-ene-16,COAH.,"SAN PEDRO, COAH.",2,0,2,0,0,48,
25-ene-16,COAH.,"TORREÓN, COAH.",2,0,2,0,0,0,
25-ene-16,COAH.,"TORREÓN, COAH.",2,0,2,0,0,0,
26-ene-16,COAH.,"TORREÓN, COAH.",2,0,2,0,0,0,
27-ene-16,COAH.,"TORREÓN, COAH.",2,0,2,0,0,0,
28-ene-16,COAH.,"SALTILLO, COAH.",2,0,2,0,0,28,
29-ene-16,B.C.,"ENSENADA, B.C.",2,0,2,0,0,0,
29-ene-16,COAH.,"MATAMOROS, COAH.",2,0,2,0,0,0,
29-ene-16,GRO.,"ARCELIA, GRO.",0,2,2,0,0,0,
31-ene-16,COAH.,"MONCLOVA, COAH.",1,1,2,0,0,228,
31-ene-16,COAH.,"MATAMOROS, COAH.",2,0,2,0,0,0,
31-ene-16,B.C.,"TIJUANA, B.C.",1,1,2,0,0,0,
02-feb-16,COAH.,"JIMÉNEZ, COAH.",2,0,2,0,0,122,
03-feb-16,OAX.,"CIUDAD IXTEPEC, OAX.",0,2,2,3,0,182,
03-feb-16,COAH.,"MATAMOROS, COAH.",2,0,2,0,0,0,
04-feb-16,TAB.,"CARDENAS, TAB.",2,0,2,0,0,0,
08-feb-16,DGO.,"SANTIAGO PAPASQUIARO, DGO.",2,0,2,0,0,0,
08-feb-16,COAH.,"MONCLOVA, COAH.",1,1,2,0,0,7,
08-feb-16,COAH.,"MATAMOROS, COAH.",2,0,2,0,0,0,
09-feb-16,COAH.,"SABINAS, COAH.",1,1,2,0,0,0,
12-feb-16,COAH.,"MATAMOROS, COAH.",1,1,2,0,0,0,
12-feb-16,COAH.,"SAN PEDRO, COAH.",2,0,2,0,0,0,
15-feb-16,COAH.,"MATAMOROS, COAH.",1,1,2,0,0,0,
17-feb-16,HGO.,"PACHUCA DE SOTO, HGO.",1,1,2,0,0,600,
17-feb-16,COAH.,"MONCLOVA, COAH.",1,1,2,0,0,116,
17-feb-16,COAH.,"SALTILLO, COAH.",2,0,2,0,1,0,
23-feb-16,COAH.,"SABINAS, COAH.",2,0,2,0,0,0,
23-feb-16,TAB.,"HUIMANGUILLO, TAB.",1,1,2,0,0,0,
23-feb-16,COAH.,"MATAMOROS, COAH.",2,0,2,11,0,0,
23-feb-16,HGO.,"TULANCINGO DE BRAVO, HGO.",1,1,2,0,0,0,
24-feb-16,COAH.,"MÚZQUIZ, COAH.",2,0,2,0,0,0,
25-feb-16,HGO.,"TEPEJI DEL RIO DE OCAMPO, HGO.",2,0,2,0,0,0,
25-feb-16,COAH.,"TORREÓN, COAH.",2,0,2,1,0,0,
26-feb-16,CHIH.,"MANUEL BENAVIDES, CHIH.",0,2,2,0,0,0,
29-feb-16,COAH.,"TORREÓN, COAH.",1,1,2,0,0,0,
29-feb-16,HGO.,"PACHUCA DE SOTO, HGO.",1,1,2,0,0,0,
01-mar-16,COAH.,"SABINAS, COAH.",1,1,2,0,0,0,
04-mar-16,COAH.,"MONCLOVA, COAH.",1,1,2,0,0,14,
04-mar-16,COAH.,"SABINAS, COAH.",0,2,2,0,0,0,
06-mar-16,GRO.,"SAN MIGUEL TOTOLAPAN, GRO.",0,2,2,0,0,0,
07-mar-16,COAH.,"TORREÓN, COAH.",1,1,2,0,0,0,
07-mar-16,COAH.,"SABINAS, COAH.",1,1,2,0,0,0,
07-mar-16,COAH.,"MÚZQUIZ, COAH.",1,1,2,0,0,0,
09-mar-16,CHIS.,"BENEMÉRITO DE LAS AMÉRICAS, CHIS.",0,2,2,0,0,0,
09-mar-16,COAH.,"SABINAS, COAH.",1,1,2,0,0,0,
09-mar-16,COAH.,"SALTILLO, COAH.",1,1,2,0,0,1834,
10-mar-16,COAH.,"SABINAS, COAH.",1,1,2,0,0,0,
12-mar-16,COAH.,"NUEVA ROSITA, COAH.",2,0,2,0,0,0,
13-mar-16,TAMPS.,"MATAMOROS, TAMPS.",2,0,2,1,0,0,
14-mar-16,OAX.,"CIUDAD IXTEPEC, OAX.",0,2,2,0,0,0,
14-mar-16,GRO.,"COYUCA DE BENITEZ, GRO.",1,1,2,0,0,0,
15-mar-16,COAH.,"PIEDRAS NEGRAS, COAH.",1,1,2,0,0,0,
16-mar-16,COAH.,"MÚZQUIZ, COAH.",1,1,2,0,0,0,
16-mar-16,DGO.,"DGO., DGO.",2,0,2,0,0,0,
17-mar-16,COAH.,"SAN PEDRO, COAH.",2,0,2,0,0,0,
18-mar-16,COAH.,"MONCLOVA, COAH.",1,1,2,3,0,125,
19-mar-16,COL.,"COL., COL.",2,0,2,0,0,0,
24-mar-16,COAH.,"SAN PEDRO, COAH.",0,2,2,0,0,0,
24-mar-16,COAH.,"TORREÓN, COAH.",2,0,2,0,0,0,
25-mar-16,COAH.,"PIEDRAS NEGRAS, COAH.",1,1,2,4,0,18,
25-mar-16,COAH.,"SAN PEDRO, COAH.",0,2,2,0,0,0,
28-mar-16,COAH.,"SALTILLO, COAH.",1,1,2,0,0,0,
29-mar-16,COAH.,"MONCLOVA, COAH.",0,2,2,0,0,78,
30-mar-16,COAH.,"SAN PEDRO, COAH.",1,1,2,0,0,0,
30-mar-16,ZAC.,"RIO GRANDE, ZAC.",2,0,2,0,0,0,
31-mar-16,COAH.,"FRANCISCO I. MADERO, COAH.",1,1,2,0,0,0,
31-mar-16,COAH.,"SALTILLO, COAH.",1,1,2,0,0,68,
31-mar-16,GRO.,"IGUALA DE LA INDEPENDENCIA, GRO.",2,0,2,0,0,0,
02-abr-16,COAH.,"TORREÓN, COAH.",2,0,2,0,0,0,
02-abr-16,GRO.,"TELOLOAPAN, GRO.",1,1,2,0,0,0,
04-abr-16,COAH.,"FRANCISCO I. MADERO, COAH.",2,0,2,10,0,0,
05-abr-16,COAH.,"FRANCISCO I. MADERO, COAH.",2,0,2,0,0,0,
05-abr-16,COAH.,"ACUÑA, COAH.",1,1,2,0,0,0,
07-abr-16,GTO.,"SALAMANCA, GTO.",0,2,2,0,0,0,
08-abr-16,COAH.,"FRANCISCO I. MADERO, COAH.",2,0,2,0,0,0,
09-abr-16,S.L.P.,"CIUDAD VALLES, S.L.P.",1,1,2,1,0,0,
10-abr-16,S.L.P.,"CIUDAD VALLES, S.L.P.",2,0,2,1,0,0,
10-abr-16,S.L.P.,"SAN LUIS POTOSI, S.L.P.",2,0,2,0,0,0,
10-abr-16,S.L.P.,"SOLEDAD DE GRACIANO SANCHEZ, S.L.P.",1,1,2,0,0,0,
11-abr-16,S.L.P.,"SAN LUIS POTOSI, S.L.P.",2,0,2,11,0,0,
12-abr-16,COAH.,"TORREÓN, COAH.",2,0,2,0,0,55,
13-abr-16,COAH.,"SALTILLO, COAH.",1,1,2,0,2,0,
16-abr-16,S.L.P.,"SAN LUIS POTOSI, S.L.P.",2,0,2,0,0,0,
16-abr-16,DGO.,"DGO., DGO.",2,0,2,5,0,0,
17-abr-16,COAH.,"MATAMOROS, COAH.",2,0,2,0,0,0,
19-abr-16,COAH.,"PIEDRAS NEGRAS, COAH.",1,1,2,1,0,0,
19-abr-16,COAH.,"MONCLOVA, COAH.",1,1,2,1,0,14,
20-abr-16,COAH.,"TORREÓN, COAH.",1,1,2,0,1,0,
23-abr-16,COAH.,"SAN PEDRO, COAH.",0,2,2,0,0,36,
25-abr-16,COAH.,"TORREÓN, COAH.",2,0,2,0,0,0,
26-abr-16,COAH.,"MONCLOVA, COAH.",1,1,2,0,0,72,
26-abr-16,COAH.,"FRANCISCO I. MADERO, COAH.",2,0,2,0,0,0,
29-abr-16,COAH.,"SALTILLO, COAH.",0,2,2,0,5,0,
30-abr-16,GRO.,"PUNGARABATO, GRO.",2,0,2,0,0,0,
02-may-16,COAH.,"FRANCISCO I. MADERO, COAH.",2,0,2,0,0,0,
02-may-16,GRO.,"PEDRO ASCENCIO ALQUISIRAS, GRO.",2,0,2,0,0,0,
03-may-16,COAH.,"SAN PEDRO, COAH.",0,2,2,0,0,0,
04-may-16,COAH.,"TORREÓN, COAH.",1,1,2,0,0,0,
07-may-16,COAH.,"FRANCISCO I. MADERO, COAH.",2,0,2,0,0,0,
09-may-16,DGO.,"DGO., DGO.",2,0,2,0,0,0,
09-may-16,GRO.,"CHILPANCINGO DE LOS BRAVO, GRO.",2,0,2,0,0,0,
10-may-16,GTO.,"ROMITA, GTO.",0,2,2,0,0,0,
10-may-16,COAH.,"PIEDRAS NEGRAS, COAH.",0,2,2,4,0,0,
12-may-16,COAH.,"SALTILLO, COAH.",2,0,2,0,0,0,
13-may-16,GRO.,"COYUCA DE CATALAN, GRO.",2,0,2,0,0,35,
13-may-16,GRO.,"CHILPANCINGO DE LOS BRAVO, GRO.",2,0,2,0,0,0,
14-may-16,COAH.,"PIEDRAS NEGRAS, COAH.",1,1,2,0,0,10,
16-may-16,COAH.,"SAN PEDRO, COAH.",1,1,2,0,0,0,
18-may-16,GRO.,"TLAPA DE COMONFORT, GRO.",1,1,2,0,0,0,
19-may-16,COAH.,"SALTILLO, COAH.",1,1,2,0,0,50,
19-may-16,COAH.,"RAMOS ARIZPE, COAH.",1,1,2,0,0,300,
19-may-16,COAH.,"ACUÑA, COAH.",2,0,2,0,0,0,
20-may-16,GRO.,"TLAPA DE COMONFORT, GRO.",0,2,2,0,0,0,
20-may-16,COAH.,"TORREÓN, COAH.",2,0,2,0,0,0,
20-may-16,COAH.,"FRANCISCO I. MADERO, COAH.",2,0,2,0,2,0,
20-may-16,N.L.,"MONTERREY, N.L.",2,0,2,0,0,0,
21-may-16,COAH.,"RAMOS ARIZPE, COAH.",2,0,2,0,1,30,
22-may-16,N.L.,"MONTERREY, N.L.",2,0,2,2,0,37,
23-may-16,COAH.,"SALTILLO, COAH.",1,1,2,0,0,0,
23-may-16,DGO.,"DGO., DGO.",2,0,2,1,0,0,
24-may-16,DGO.,"DGO., DGO.",1,1,2,4,4,0,
24-may-16,N.L.,"MONTERREY, N.L.",2,0,2,0,0,149,
25-may-16,COAH.,"SAN PEDRO, COAH.",2,0,2,0,0,0,
26-may-16,COAH.,"MONCLOVA, COAH.",1,1,2,0,0,37,
26-may-16,COAH.,"FRANCISCO I. MADERO, COAH.",2,0,2,0,0,0,
27-may-16,COAH.,"SAN PEDRO, COAH.",0,2,2,0,0,0,
28-may-16,N.L.,"MONTERREY, N.L.",2,0,2,0,0,0,
28-may-16,N.L.,"GUADALUPE, N.L.",1,1,2,0,0,0,
31-may-16,N.L.,"APODACA, N.L.",0,2,2,0,0,763,
02-jun-16,COAH.,"PIEDRAS NEGRAS, COAH.",0,2,2,0,0,0,
02-jun-16,COAH.,"TORREÓN, COAH.",2,0,2,0,0,55,
02-jun-16,COAH.,"MÚZQUIZ, COAH.",1,1,2,0,0,0,
06-jun-16,COAH.,"SAN PEDRO, COAH.",1,1,2,0,0,0,
08-jun-16,COAH.,"SALTILLO, COAH.",2,0,2,0,0,0,
09-jun-16,COAH.,"SALTILLO, COAH.",2,0,2,3,0,54,
10-jun-16,N.L.,"CADEREYTA JIMENEZ, N.L.",1,1,2,0,0,0,
10-jun-16,COAH.,"MÚZQUIZ, COAH.",1,1,2,0,0,0,
11-jun-16,COAH.,"TORREÓN, COAH.",2,0,2,0,0,0,
13-jun-16,N.L.,"CADEREYTA JIMENEZ, N.L.",2,0,2,0,0,50,
13-jun-16,COAH.,"MÚZQUIZ, COAH.",1,1,2,0,0,0,
14-jun-16,COAH.,"MONCLOVA, COAH.",2,0,2,0,0,18,
14-jun-16,N.L.,"CADEREYTA JIMENEZ, N.L.",2,0,2,0,0,0,
16-jun-16,VER.,"POZA RICA DE HGO., VER.",1,1,2,0,0,500,
17-jun-16,COAH.,"MONCLOVA, COAH.",2,0,2,0,0,50,
20-jun-16,SIN.,"MAZATLAN, SIN.",1,1,2,0,4,0,
20-jun-16,COAH.,"MONCLOVA, COAH.",0,2,2,0,0,0,
21-jun-16,N.L.,"SAN PEDRO GARZA GARCIA, N.L.",2,0,2,0,0,0,
21-jun-16,COAH.,"PIEDRAS NEGRAS, COAH.",1,1,2,0,0,4,
22-jun-16,N.L.,"SANTA CATARINA, N.L.",1,1,2,0,0,0,
23-jun-16,N.L.,"SANTA CATARINA, N.L.",2,0,2,0,0,50,
24-jun-16,COAH.,"MONCLOVA, COAH.",1,1,2,0,0,7,
24-jun-16,COAH.,"FRANCISCO I. MADERO, COAH.",0,2,2,0,0,0,
27-jun-16,COAH.,"MONCLOVA, COAH.",1,1,2,0,0,0,
29-jun-16,HGO.,"PACHUCA DE SOTO, HGO.",0,2,2,0,0,0,
30-jun-16,HGO.,"PACHUCA DE SOTO, HGO.",2,0,2,0,0,0,
30-jun-16,COAH.,"TORREÓN, COAH.",0,2,2,0,1,0,
01-jul-16,COAH.,"TORREÓN, COAH.",2,0,2,0,0,0,
02-jul-16,COAH.,"ACUÑA, COAH.",0,2,2,0,0,0,
04-jul-16,HGO.,"PACHUCA DE SOTO, HGO.",2,0,2,0,0,0,
05-jul-16,SIN.,"SAN IGNACIO, SIN.",2,0,2,0,0,0,
06-jul-16,HGO.,"ZEMPOALA, HGO.",0,2,2,0,0,0,
06-jul-16,N.L.,"SALINAS VICTORIA, N.L.",2,0,2,0,0,0,
06-jul-16,N.L.,"VALLECILLO, N.L.",2,0,2,0,0,0,
06-jul-16,COAH.,"SALTILLO, COAH.",1,1,2,0,0,0,
07-jul-16,COAH.,"SALTILLO, COAH.",2,0,2,0,0,0,
08-jul-16,COAH.,"RAMOS ARIZPE, COAH.",1,1,2,0,0,300,
08-jul-16,HGO.,"PACHUCA DE SOTO, HGO.",2,0,2,0,0,0,
13-jul-16,ZAC.,"GUADALUPE, ZAC.",2,0,2,0,0,400,
13-jul-16,COAH.,"MÚZQUIZ, COAH.",2,0,2,2,0,0,
13-jul-16,COAH.,"SAN PEDRO, COAH.",2,0,2,0,0,0,
14-jul-16,COAH.,"SALTILLO, COAH.",1,1,2,0,0,0,
15-jul-16,COAH.,"MONCLOVA, COAH.",2,0,2,0,0,1,
15-jul-16,COAH.,"ACUÑA, COAH.",2,0,2,0,0,0,
15-jul-16,SIN.,"CULIACAN, SIN.",1,1,2,0,0,0,
19-jul-16,N.L.,"GUADALUPE, N.L.",2,0,2,4,1,366,
20-jul-16,TLAX.,"TLAX., TLAX.",1,1,2,0,0,0,
20-jul-16,HGO.,"PACHUCA DE SOTO, HGO.",2,0,2,0,0,0,
21-jul-16,TLAX.,"PANOTLA, TLAX.",1,1,2,1,0,0,
21-jul-16,TLAX.,"HUAMANTLA, TLAX.",2,0,2,0,0,0,
21-jul-16,COAH.,"MONCLOVA, COAH.",1,1,2,0,0,49,
21-jul-16,B.C.,"TIJUANA, B.C.",0,2,2,0,0,0,
22-jul-16,B.C.,"MEXICALI, B.C.",2,0,2,0,0,0,
23-jul-16,B.C.,"TIJUANA, B.C.",0,2,2,0,0,0,
24-jul-16,B.C.,"TIJUANA, B.C.",1,1,2,0,0,0,
26-jul-16,COAH.,"PIEDRAS NEGRAS, COAH.",1,1,2,1,0,40,
26-jul-16,COAH.,"SALTILLO, COAH.",2,0,2,2,0,100,
27-jul-16,COAH.,"SALTILLO, COAH.",2,0,2,0,0,0,
28-jul-16,COAH.,"TORREÓN, COAH.",1,1,2,0,0,0,
28-jul-16,COAH.,"SALTILLO, COAH.",2,0,2,1,0,22,
28-jul-16,B.C.,"TIJUANA, B.C.",1,1,2,0,0,0,
29-jul-16,COAH.,"SALTILLO, COAH.",2,0,2,0,0,0,
29-jul-16,N.L.,"GUADALUPE, N.L.",2,0,2,1,0,117,
30-jul-16,HGO.,"PACHUCA DE SOTO, HGO.",0,2,2,0,0,0,
30-jul-16,HGO.,"TECOZAUTLA, HGO.",2,0,2,0,0,2010,
30-jul-16,B.C.,"MEXICALI, B.C.",1,1,2,0,0,0,
01-ago-16,S.L.P.,"CIUDAD VALLES, S.L.P.",1,1,2,0,0,0,
01-ago-16,COAH.,"TORREÓN, COAH.",1,1,2,0,0,0,
01-ago-16,COAH.,"MONCLOVA, COAH.",2,0,2,0,0,25,
02-ago-16,SIN.,"NAVOLATO, SIN.",2,0,2,0,0,0,
02-ago-16,TLAX.,"APIZACO, TLAX.",1,1,2,0,0,0,
03-ago-16,COAH.,"MONCLOVA, COAH.",1,1,2,0,0,0,
04-ago-16,SON.,"GUAYMAS, SON.",0,2,2,0,0,0,
04-ago-16,S.L.P.,"CIUDAD VALLES, S.L.P.",2,0,2,1,0,14,
05-ago-16,SIN.,"NAVOLATO, SIN.",2,0,2,0,5,0,
05-ago-16,B.C.,"ENSENADA, B.C.",0,2,2,0,0,0,
06-ago-16,COAH.,"ALLENDE, COAH.",2,0,2,0,0,0,
08-ago-16,TLAX.,"TLAXCO, TLAX.",1,1,2,0,0,0,
08-ago-16,HGO.,"PACHUCA DE SOTO, HGO.",1,1,2,0,0,0,
08-ago-16,COAH.,"SALTILLO, COAH.",0,2,2,0,0,37,
08-ago-16,COAH.,"PIEDRAS NEGRAS, COAH.",2,0,2,0,0,50,
09-ago-16,MEX.,"METEPEC, MEX.",0,2,2,0,0,0,
09-ago-16,MEX.,"LERMA, MEX.",1,1,2,1,0,0,
09-ago-16,SIN.,"ELOTA, SIN.",1,1,2,0,0,0,
10-ago-16,TLAX.,"TLAXCO, TLAX.",0,2,2,1,0,0,
10-ago-16,N.L.,"GRAL. ESCOBEDO, N.L.",2,0,2,0,0,18,
11-ago-16,S.L.P.,"CIUDAD VALLES, S.L.P.",1,1,2,0,0,37,
11-ago-16,SIN.,"ELOTA, SIN.",0,2,2,0,0,0,
11-ago-16,MEX.,"ACOLMAN, MEX.",0,2,2,0,0,0,
11-ago-16,B.C.,"MEXICALI, B.C.",0,2,2,0,0,0,
12-ago-16,COAH.,"MONCLOVA, COAH.",1,1,2,1,0,186,
13-ago-16,MEX.,"METEPEC, MEX.",2,0,2,0,4,55,
13-ago-16,MEX.,"LERMA, MEX.",2,0,2,2,0,13,
14-ago-16,MEX.,"HUEHUETOCA, MEX.",2,0,2,0,0,0,
14-ago-16,N.L.,"CADEREYTA JIMENEZ, N.L.",0,2,2,0,0,0,
15-ago-16,TLAX.,"CALPULALPAN, TLAX.",1,1,2,0,0,0,
15-ago-16,SON.,"HERMOSILLO, SON.",1,1,2,0,0,0,
15-ago-16,SON.,"CAJEME, SON.",2,0,2,0,0,0,
15-ago-16,MEX.,"ZUMPANGO, MEX.",2,0,2,2,0,314,
16-ago-16,SON.,"CAJEME, SON.",1,1,2,1,0,0,
16-ago-16,CHIS.,"BENEMÉRITO DE LAS AMÉRICAS, CHIS.",1,1,2,0,0,0,
16-ago-16,SIN.,"BADIRAGUATO, SIN.",1,1,2,0,0,0,
16-ago-16,COAH.,"PIEDRAS NEGRAS, COAH.",0,2,2,0,0,0,
17-ago-16,B.C.,"TIJUANA, B.C.",2,0,2,0,0,0,
17-ago-16,B.C.,"MEXICALI, B.C.",0,2,2,0,0,0,
18-ago-16,SON.,"HERMOSILLO, SON.",1,1,2,1,0,0,
18-ago-16,COAH.,"TORREÓN, COAH.",1,1,2,0,0,0,
18-ago-16,TLAX.,"ZACATELCO, TLAX.",1,1,2,0,0,22,
18-ago-16,TLAX.,"CALPULALPAN, TLAX.",2,0,2,0,0,0,
19-ago-16,SON.,"HERMOSILLO, SON.",1,1,2,35,0,1119,
19-ago-16,COAH.,"SALTILLO, COAH.",2,0,2,0,0,228,
19-ago-16,COAH.,"MONCLOVA, COAH.",2,0,2,1,0,7,
21-ago-16,MEX.,"AMECAMECA, MEX.",2,0,2,0,4,6,
22-ago-16,SIN.,"BADIRAGUATO, SIN.",0,2,2,0,1,0,
23-ago-16,MEX.,"EL ORO, MEX.",1,1,2,0,0,0,
24-ago-16,SIN.,"BADIRAGUATO, SIN.",1,1,2,0,0,20,
24-ago-16,MEX.,"EL ORO, MEX.",1,1,2,1,0,82,
26-ago-16,OAX.,"MIAHUATLAN DE PORFIRIO DIAZ, OAX.",0,2,2,18,0,0,
27-ago-16,OAX.,"CIUDAD IXTEPEC, OAX.",2,0,2,0,0,0,
28-ago-16,B.C.,"ENSENADA, B.C.",1,1,2,0,0,0,
29-ago-16,SIN.,"MOCORITO, SIN.",2,0,2,0,0,0,
29-ago-16,MEX.,"OTZOLOTEPEC, MEX.",1,1,2,0,0,0,
29-ago-16,CHIS.,"SAN CRISTOBAL DE LAS CASAS, CHIS.",1,1,2,0,0,0,
30-ago-16,B.C.,"TIJUANA, B.C.",0,2,2,0,0,0,
30-ago-16,B.C.,"TIJUANA, B.C.",0,2,2,0,0,0,
30-ago-16,B.C.,"TIJUANA, B.C.",0,2,2,0,0,0,
30-ago-16,MEX.,"CHICONCUAC, MEX.",2,0,2,0,0,38,
31-ago-16,OAX.,"OAX. DE JUAREZ, OAX.",2,0,2,0,0,0,
31-ago-16,OAX.,"SAN JUAN BAUTISTA TUXTEPEC, OAX.",1,1,2,0,0,0,
31-ago-16,N.L.,"SAN PEDRO GARZA GARCIA, N.L.",0,2,2,0,0,0,
31-ago-16,OAX.,"CIUDAD IXTEPEC, OAX.",1,1,2,0,0,0,
31-ago-16,MEX.,"SAN MATEO ATENCO, MEX.",2,0,2,0,0,72,
31-ago-16,SON.,"HERMOSILLO, SON.",1,1,2,16,0,0,
31-ago-16,SON.,"CAJEME, SON.",0,2,2,0,0,0,
31-ago-16,COAH.,"FRANCISCO I. MADERO, COAH.",2,0,2,0,0,0,
31-ago-16,COAH.,"SABINAS, COAH.",1,1,2,3,0,50,
01-sep-16,SON.,"CAJEME, SON.",1,1,2,0,0,0,
01-sep-16,MEX.,"SAN MATEO ATENCO, MEX.",2,0,2,0,0,28,
01-sep-16,COAH.,"MONCLOVA, COAH.",1,1,2,0,0,0,
01-sep-16,MEX.,"CHICONCUAC, MEX.",2,0,2,0,0,0,
02-sep-16,SON.,"CAJEME, SON.",1,1,2,0,0,0,
04-sep-16,B.C.,"TIJUANA, B.C.",2,0,2,0,0,0,
05-sep-16,MEX.,"VILLA VICTORIA, MEX.",1,1,2,0,0,0,
05-sep-16,GRO.,"IGUALA DE LA INDEPENDENCIA, GRO.",2,0,2,0,0,0,
05-sep-16,N.L.,"SAN PEDRO GARZA GARCIA, N.L.",1,1,2,14,0,67,
06-sep-16,COAH.,"PIEDRAS NEGRAS, COAH.",1,1,2,35,0,200,
06-sep-16,MEX.,"VILLA GRO., MEX.",2,0,2,0,0,0,
06-sep-16,MEX.,"VILLA VICTORIA, MEX.",1,1,2,0,0,0,
07-sep-16,COAH.,"SALTILLO, COAH.",0,2,2,0,0,0,
07-sep-16,B.C.,"TIJUANA, B.C.",1,1,2,0,0,0,
07-sep-16,MEX.,"VILLA VICTORIA, MEX.",1,1,2,0,0,0,
07-sep-16,MEX.,"SAN MARTIN DE LAS PIRAMIDES, MEX.",2,0,2,0,7,0,
08-sep-16,OAX.,"OAX. DE JUAREZ, OAX.",1,1,2,0,0,0,
08-sep-16,COAH.,"SALTILLO, COAH.",2,0,2,0,0,90,
08-sep-16,B.C.,"TIJUANA, B.C.",2,0,2,0,1,0,
08-sep-16,MEX.,"SAN MARTIN DE LAS PIRAMIDES, MEX.",1,1,2,0,0,0,
08-sep-16,MEX.,"VILLA VICTORIA, MEX.",1,1,2,0,0,0,
09-sep-16,COAH.,"SALTILLO, COAH.",1,1,2,0,0,100,
09-sep-16,COAH.,"SABINAS, COAH.",1,1,2,2,0,0,
10-sep-16,B.C.,"TIJUANA, B.C.",2,0,2,0,0,0,
10-sep-16,B.C.,"ENSENADA, B.C.",0,2,2,0,0,0,
15-sep-16,OAX.,"OAX. DE JUAREZ, OAX.",1,1,2,1,0,0,
17-sep-16,SON.,"HERMOSILLO, SON.",2,0,2,1,0,0,
19-sep-16,COAH.,"PIEDRAS NEGRAS, COAH.",1,1,2,0,0,0,
20-sep-16,B.C.,"MEXICALI, B.C.",0,2,2,0,0,0,
21-sep-16,SON.,"HERMOSILLO, SON.",0,2,2,5,0,0,
21-sep-16,MEX.,"VILLA DEL CARBON, MEX.",1,1,2,0,0,0,
22-sep-16,SON.,"CAJEME, SON.",2,0,2,1,0,0,
22-sep-16,MEX.,"VILLA DEL CARBON, MEX.",1,1,2,0,0,0,
23-sep-16,SON.,"HERMOSILLO, SON.",1,1,2,21,0,0,
23-sep-16,MEX.,"VILLA DEL CARBON, MEX.",1,1,2,0,0,0,
23-sep-16,B.C.,"TIJUANA, B.C.",2,0,2,0,0,0,
23-sep-16,COAH.,"SALTILLO, COAH.",1,1,2,15,0,100,
24-sep-16,VER.,"TANTOYUCA, VER.",2,0,2,0,0,0,
26-sep-16,MEX.,"TEMASCALTEPEC, MEX.",1,1,2,0,0,15,
26-sep-16,MEX.,"TEMASCALCINGO, MEX.",2,0,2,0,0,0,
27-sep-16,COAH.,"TORREÓN, COAH.",2,0,2,0,0,0,
28-sep-16,MEX.,"TLALMANALCO, MEX.",1,1,2,0,0,0,
28-sep-16,CHIS.,"VILLAFLORES, CHIS.",1,1,2,0,0,319,
28-sep-16,N.L.,"VALLECILLO, N.L.",2,0,2,0,0,0,
29-sep-16,MEX.,"TEMASCALCINGO, MEX.",1,1,2,0,0,0,
29-sep-16,TAB.,"CENTRO, TAB.",0,2,2,0,0,0,
29-sep-16,MEX.,"TEZOYUCA, MEX.",1,1,2,0,0,0,
29-sep-16,MEX.,"TLALMANALCO, MEX.",2,0,2,0,1,0,
01-oct-16,MEX.,"TLALMANALCO, MEX.",1,1,2,0,0,9,
01-oct-16,MEX.,"COCOTITLAN, MEX.",2,0,2,0,0,0,
03-oct-16,SIN.,"ROSARIO, SIN.",0,2,2,0,0,0,
03-oct-16,MEX.,"NICOLAS ROMERO, MEX.",1,1,2,0,8,0,
03-oct-16,MEX.,"TEOLOYUCAN, MEX.",1,1,2,1,0,0,
04-oct-16,COAH.,"TORREÓN, COAH.",1,1,2,0,0,0,
04-oct-16,COAH.,"MONCLOVA, COAH.",2,0,2,0,0,4,
04-oct-16,COAH.,"SABINAS, COAH.",2,0,2,0,0,0,
04-oct-16,MEX.,"TEOLOYUCAN, MEX.",2,0,2,1,0,0,
04-oct-16,MEX.,"OCOYOACAC, MEX.",2,0,2,0,0,0,
05-oct-16,SON.,"HERMOSILLO, SON.",1,1,2,56,0,0,
05-oct-16,SIN.,"SALVADOR ALVARADO, SIN.",1,1,2,0,0,0,
05-oct-16,HGO.,"PACHUCA DE SOTO, HGO.",0,2,2,0,0,0,
06-oct-16,COAH.,"SALTILLO, COAH.",2,0,2,8,0,184,
06-oct-16,SIN.,"SALVADOR ALVARADO, SIN.",1,1,2,0,0,9,
06-oct-16,MOR.,"XOCHITEPEC, MOR.",1,1,2,0,6,270,
06-oct-16,TAB.,"JONUTA, TAB.",2,0,2,1,0,0,
06-oct-16,MEX.,"NICOLAS ROMERO, MEX.",2,0,2,0,0,0,
07-oct-16,SIN.,"ROSARIO, SIN.",2,0,2,0,7,0,
08-oct-16,MEX.,"TEOLOYUCAN, MEX.",1,1,2,0,0,0,
10-oct-16,B.C.,"TIJUANA, B.C.",2,0,2,0,0,0,
10-oct-16,MEX.,"TEQUIXQUIAC, MEX.",2,0,2,0,0,0,
11-oct-16,HGO.,"MOLANGO DE ESCAMILLA, HGO.",2,0,2,0,0,0,
11-oct-16,CHIS.,"TAPACHULA, CHIS.",0,2,2,0,0,50,
11-oct-16,PUE.,"PUE., PUE.",1,1,2,0,0,0,
12-oct-16,B.C.,"TIJUANA, B.C.",1,1,2,0,0,0,
12-oct-16,COAH.,"ACUÑA, COAH.",1,1,2,3,0,0,
12-oct-16,HGO.,"TEPEJI DEL RIO DE OCAMPO, HGO.",1,1,2,0,0,0,
12-oct-16,B.C.,"MEXICALI, B.C.",1,1,2,0,0,0,
13-oct-16,CHIS.,"TAPACHULA, CHIS.",2,0,2,0,0,14,
13-oct-16,MEX.,"ECATEPEC DE MOR., MEX.",2,0,2,0,1,0,
13-oct-16,MOR.,"XOCHITEPEC, MOR.",1,1,2,1,0,0,
14-oct-16,TAB.,"CENTRO, TAB.",2,0,2,0,0,0,
15-oct-16,COAH.,"FRANCISCO I. MADERO, COAH.",1,1,2,0,0,0,
15-oct-16,MEX.,"IXTAPALUCA, MEX.",1,1,2,0,0,69,
16-oct-16,MEX.,"TONATICO, MEX.",2,0,2,1,0,0,
17-oct-16,MEX.,"NEXTLALPAN, MEX., MEX.",2,0,2,1,0,0,
17-oct-16,MEX.,"AYAPANGO, MEX.",1,1,2,0,0,0,
17-oct-16,MEX.,"POLOTITLAN, MEX.",2,0,2,0,0,0,
17-oct-16,MEX.,"POLOTITLAN, MEX.",2,0,2,0,0,0,
19-oct-16,SON.,"HERMOSILLO, SON.",1,1,2,0,0,0,
20-oct-16,COAH.,"SALTILLO, COAH.",2,0,2,0,0,0,
20-oct-16,B.C.,"MEXICALI, B.C.",1,1,2,0,0,0,
21-oct-16,SON.,"HERMOSILLO, SON.",1,1,2,1,0,0,
21-oct-16,MEX.,"JILOTEPEC, MEX.",2,0,2,1,0,0,
21-oct-16,MEX.,"POLOTITLAN, MEX.",1,1,2,1,0,0,
21-oct-16,MEX.,"AYAPANGO, MEX.",2,0,2,1,7,0,
24-oct-16,MEX.,"TEXCALTITLAN, MEX.",1,1,2,1,0,0,
25-oct-16,COAH.,"SALTILLO, COAH.",1,1,2,0,0,0,
25-oct-16,B.C.,"MEXICALI, B.C.",1,1,2,0,0,0,
26-oct-16,TAB.,"CENTLA, TAB.",1,1,2,0,0,0,
26-oct-16,B.C.,"MEXICALI, B.C.",1,1,2,0,0,0,
27-oct-16,MOR.,"XOCHITEPEC, MOR.",2,0,2,0,0,0,
28-oct-16,MOR.,"XOCHITEPEC, MOR.",1,1,2,0,0,24,
28-oct-16,SON.,"HERMOSILLO, SON.",2,0,2,21,0,0,
29-oct-16,SON.,"HERMOSILLO, SON.",2,0,2,10,0,43,
31-oct-16,MEX.,"CALIMAYA, MEX.",2,0,2,1,0,0,
31-oct-16,MEX.,"MELCHOR OCAMPO, MEX.",2,0,2,1,0,0,
02-nov-16,SON.,"HERMOSILLO, SON.",2,0,2,10,0,43,
03-nov-16,SON.,"CAJEME, SON.",2,0,2,43,0,0,
03-nov-16,MEX.,"TEXCALYACAC, MEX.",1,1,2,0,0,54,
03-nov-16,MEX.,"COCOTITLAN, MEX.",1,1,2,0,0,0,
04-nov-16,MEX.,"CALIMAYA, MEX.",2,0,2,1,0,0,
04-nov-16,MOR.,"YAUTEPEC, MOR.",0,2,2,0,1,120,
04-nov-16,B.C.,"MEXICALI, B.C.",0,2,2,0,0,0,
04-nov-16,COAH.,"TORREÓN, COAH.",0,2,2,0,0,0,
04-nov-16,MOR.,"YAUTEPEC, MOR.",0,2,2,0,1,120,
05-nov-16,SON.,"HERMOSILLO, SON.",2,0,2,29,0,613,
05-nov-16,MEX.,"COCOTITLAN, MEX.",2,0,2,0,0,0,
07-nov-16,MEX.,"LUVIANOS, MEX.",1,1,2,1,0,16,
08-nov-16,MEX.,"TEJUPILCO, MEX.",1,1,2,1,0,0,
08-nov-16,SON.,"EMPALME, SON.",1,1,2,0,0,0,
08-nov-16,B.C.,"TIJUANA, B.C.",0,2,2,0,0,0,
08-nov-16,SIN.,"ANGOSTURA, SIN.",2,0,2,0,0,0,
09-nov-16,SON.,"HUATABAMPO, SON.",2,0,2,2,0,0,
09-nov-16,SON.,"ALAMOS, SON.",2,0,2,5,0,0,
09-nov-16,MEX.,"LUVIANOS, MEX.",1,1,2,1,0,0,
09-nov-16,MEX.,"LUVIANOS, MEX.",2,0,2,0,3,0,
10-nov-16,SON.,"CABORCA, SON.",0,2,2,0,0,0,
10-nov-16,MEX.,"TEMAMATLA, MEX.",1,1,2,0,0,0,
11-nov-16,VER.,"COATEPEC, VER.",2,0,2,0,1,0,
11-nov-16,MEX.,"TEJUPILCO, MEX.",2,0,2,1,0,92,
12-nov-16,COAH.,"ACUÑA, COAH.",0,2,2,0,0,0,
12-nov-16,MEX.,"TEMAMATLA, MEX.",2,0,2,1,0,0,
12-nov-16,MEX.,"PAPALOTLA, MEX.",2,0,2,0,0,0,
14-nov-16,OAX.,"OAX. DE JUAREZ, OAX.",0,2,2,0,0,0,
14-nov-16,SON.,"NAVOJOA, SON.",2,0,2,0,0,0,
14-nov-16,SON.,"CANANEA, SON.",1,1,2,1,0,0,
14-nov-16,MEX.,"JALTENCO, MEX.",0,2,2,0,0,0,
15-nov-16,SON.,"NOGALES, SON.",2,0,2,2,0,110,
15-nov-16,SON.,"CABORCA, SON.",1,1,2,2,0,0,
17-nov-16,B.C.,"MEXICALI, B.C.",0,2,2,0,0,0,
17-nov-16,SON.,"BENITO JUAREZ, SON.",2,0,2,0,0,0,
17-nov-16,SON.,"CABORCA, SON.",0,2,2,0,0,0,
18-nov-16,SON.,"NOGALES, SON.",1,1,2,10,0,40,
19-nov-16,SON.,"NOGALES, SON.",2,0,2,0,0,0,
20-nov-16,MEX.,"LA PAZ, MEX.",1,1,2,1,0,0,
22-nov-16,MEX.,"XALATLACO, MEX.",2,0,2,0,0,4,
23-nov-16,SON.,"HUATABAMPO, SON.",1,1,2,0,0,0,
23-nov-16,MEX.,"RAYON, MEX.",2,0,2,0,0,0,
24-nov-16,COAH.,"TORREÓN, COAH.",2,0,2,0,0,0,
24-nov-16,SON.,"SAN LUIS RIO COLORADO, SON.",0,2,2,1,0,18,
25-nov-16,MEX.,"NOPALTEPEC, MEX.",2,0,2,0,0,0,
26-nov-16,SON.,"ETCHOJOA, SON.",1,1,2,0,0,0,
26-nov-16,MEX.,"JUCHITEPEC, MEX.",1,1,2,0,0,0,
26-nov-16,MEX.,"RAYON, MEX.",0,2,2,0,0,0,
28-nov-16,SON.,"NOGALES, SON.",2,0,2,1,0,20,
28-nov-16,SON.,"CABORCA, SON.",1,1,2,0,0,0,
29-nov-16,SON.,"HERMOSILLO, SON.",2,0,2,32,0,165,
29-nov-16,SON.,"CAJEME, SON.",0,2,2,0,0,0,
29-nov-16,N.L.,"SAN NICOLAS DE LOS GARZA, N.L.",2,0,2,3,0,50,
29-nov-16,SON.,"SAN LUIS RIO COLORADO, SON.",2,0,2,4,0,75,
29-nov-16,MEX.,"ACAMBAY, MEX.",2,0,2,0,1,0,
30-nov-16,SON.,"NOGALES, SON.",0,2,2,1,0,0,
30-nov-16,YUC.,"KANTUNIL, YUC.",0,2,2,0,0,0,
30-nov-16,COAH.,"SALTILLO, COAH.",2,0,2,0,0,0,
01-dic-16,D.F.,"AZCAPOTZALCO, D.F.",2,0,2,0,0,96,
01-dic-16,MEX.,"COATEPEC HARINAS, MEX.",1,1,2,0,0,0,
03-dic-16,MEX.,"ACAMBAY, MEX.",1,1,2,1,12,0,
03-dic-16,MEX.,"TEMASCALAPA, MEX.",2,0,2,0,0,0,
04-dic-16,S.L.P.,"SAN LUIS POTOSI, S.L.P.",2,0,2,0,0,0,
05-dic-16,COAH.,"TORREÓN, COAH.",2,0,2,0,0,0,
05-dic-16,S.L.P.,"CIUDAD VALLES, S.L.P.",2,0,2,1,0,0,
06-dic-16,S.L.P.,"CIUDAD VALLES, S.L.P.",2,0,2,1,0,99,
07-dic-16,S.L.P.,"CIUDAD VALLES, S.L.P.",1,1,2,1,0,19,
07-dic-16,GTO.,"IRAPUATO, GTO.",1,1,2,0,0,0,
08-dic-16,N.L.,"APODACA, N.L.",0,2,2,0,0,0,
10-dic-16,TAMPS.,"ALTAMIRA, TAMPS.",2,0,2,2,0,210,
10-dic-16,S.L.P.,"SAN LUIS POTOSI, S.L.P.",2,0,2,1,0,0,
16-dic-16,HGO.,"IXMIQUILPAN, HGO.",2,0,2,0,0,500,
19-dic-16,CHIH.,"HGO. DEL PARRAL, CHIH.",2,0,2,0,0,0,
13-ene-17,B.C.,"MEXICALI, B.C.",0,2,2,0,0,0,
14-ene-17,B.C.,"ENSENADA, B.C.",0,2,2,0,0,0,
19-ene-17,D.F.,"COYOACAN, D.F.",1,1,2,0,0,0,
20-ene-17,DGO.,"SANTIAGO PAPASQUIARO, DGO.",2,0,2,2,0,0,
21-ene-17,DGO.,"PUEBLO NUEVO, DGO.",1,1,2,0,0,0,
23-ene-17,ZAC.,"TLALTENANGO DE SANCHEZ ROMAN, ZAC.",1,1,2,1,0,3,
23-ene-17,ZAC.,"JEREZ, ZAC.",2,0,2,0,0,0,
25-ene-17,D.F.,"COYOACAN, D.F.",2,0,2,0,0,0,
27-ene-17,D.F.,"COYOACAN, D.F.",2,0,2,0,0,8,
27-ene-17,ZAC.,"JEREZ, ZAC.",2,0,2,0,0,0,
28-ene-17,DGO.,"DGO., DGO.",2,0,2,0,0,0,
28-ene-17,ZAC.,"JEREZ, ZAC.",2,0,2,0,0,0,
28-ene-17,TAMPS.,"MATAMOROS, TAMPS.",1,1,2,0,0,40,
30-ene-17,DGO.,"SANTIAGO PAPASQUIARO, DGO.",1,1,2,4,0,0,
02-feb-17,GRO.,"COAHUAYUTLA DE JOSE MARIA IZAZAGA, GRO.",0,2,2,0,0,0,
02-feb-17,D.F.,"COYOACAN, D.F.",2,0,2,0,0,0,
02-feb-17,COAH.,"MONCLOVA, COAH.",2,0,2,0,0,0,
03-feb-17,MICH.,"LAZARO CARDENAS, MICH.",1,1,2,0,0,0,
04-feb-17,DGO.,"PUEBLO NUEVO, DGO.",2,0,2,1,0,26,
08-feb-17,COAH.,"FRANCISCO I. MADERO, COAH.",2,0,2,0,0,0,
08-feb-17,DGO.,"GOMEZ PALACIO, DGO.",2,0,2,0,0,0,
08-feb-17,COAH.,"FRANCISCO I. MADERO, COAH.",2,0,2,0,0,0,
09-feb-17,DGO.,"DGO., DGO.",2,0,2,0,1,0,
09-feb-17,CHIH.,"ALDAMA, CHIH.",1,1,2,0,0,0,
10-feb-17,SIN.,"CULIACAN, SIN.",1,1,2,0,4,0,
11-feb-17,TAMPS.,"MATAMOROS, TAMPS.",1,1,2,2,0,220,
11-feb-17,COAH.,"MONCLOVA, COAH.",0,2,2,0,0,0,
12-feb-17,MICH.,"LAZARO CARDENAS, MICH.",2,0,2,0,0,0,
13-feb-17,B.C.,"MEXICALI, B.C.",0,2,2,0,0,0,
14-feb-17,B.C.,"ENSENADA, B.C.",0,2,2,0,0,0,
14-feb-17,DGO.,"GOMEZ PALACIO, DGO.",2,0,2,0,0,0,
15-feb-17,CHIH.,"GUADALUPE, CHIH.",2,0,2,4,0,295,
15-feb-17,COAH.,"TORREÓN, COAH.",2,0,2,0,0,0,
15-feb-17,DGO.,"DGO., DGO.",1,1,2,0,10,43,
16-feb-17,SIN.,"CULIACAN, SIN.",1,1,2,0,13,0,
16-feb-17,SIN.,"MAZATLAN, SIN.",1,1,2,0,3,0,
17-feb-17,CHIH.,"GUADALUPE, CHIH.",1,1,2,0,0,70,
17-feb-17,GRO.,"COAHUAYUTLA DE JOSE MARIA IZAZAGA, GRO.",1,1,2,0,0,0,
18-feb-17,COAH.,"FRANCISCO I. MADERO, COAH.",1,1,2,0,0,0,
20-feb-17,GRO.,"COYUCA DE BENITEZ, GRO.",1,1,2,0,0,0,
21-feb-17,SIN.,"CULIACAN, SIN.",1,1,2,0,17,0,
21-feb-17,VER.,"POZA RICA DE HGO., VER.",1,1,2,0,0,0,
22-feb-17,COAH.,"TORREÓN, COAH.",0,2,2,0,0,0,
23-feb-17,CHIH.,"NUEVO CASAS GRANDES, CHIH.",1,1,2,0,0,130,
24-feb-17,VER.,"POZA RICA DE HGO., VER.",2,0,2,0,0,47,
24-feb-17,GRO.,"LA UNION DE ISIDORO MONTES DE OCA, GRO.",1,1,2,0,0,0,
25-feb-17,TAMPS.,"MATAMOROS, TAMPS.",2,0,2,3,0,1146,
27-feb-17,D.F.,"IZTAPALAPA, D.F.",1,1,2,0,0,0,
27-feb-17,VER.,"POZA RICA DE HGO., VER.",1,1,2,0,0,118,
28-feb-17,OAX.,"MIAHUATLAN DE PORFIRIO DIAZ, OAX.",0,2,2,0,0,0,
28-feb-17,COAH.,"SALTILLO, COAH.",2,0,2,0,0,0,
28-feb-17,COAH.,"PIEDRAS NEGRAS, COAH.",1,1,2,1,0,150,
07-mar-17,D.F.,"IZTAPALAPA, D.F.",1,1,2,0,0,0,
07-mar-17,ZAC.,"GENERAL FRANCISCO R. MURGUIA, ZAC.",0,2,2,0,0,20,
07-mar-17,VER.,"COSOLEACAQUE, VER.",2,0,2,0,0,51,
07-mar-17,MEX.,"CHALCO, MEX.",1,1,2,0,0,14,
07-mar-17,COAH.,"SALTILLO, COAH.",0,2,2,0,1,0,
08-mar-17,VER.,"COSOLEACAQUE, VER.",1,1,2,0,0,84,
09-mar-17,TAMPS.,"NUEVO LAREDO, TAMPS.",2,0,2,1,0,370,
10-mar-17,D.F.,"IZTAPALAPA, D.F.",1,1,2,0,0,0,
10-mar-17,MEX.,"CHALCO, MEX.",2,0,2,0,0,0,
11-mar-17,COAH.,"SALTILLO, COAH.",1,1,2,0,0,0,
11-mar-17,MEX.,"VALLE DE CHALCO SOLIDARIDAD, MEX.",1,1,2,0,0,0,
13-mar-17,QRO.,"QUERETARO, QRO.",1,1,2,0,0,103,
13-mar-17,CHIH.,"HGO. DEL PARRAL, CHIH.",2,0,2,0,0,0,
13-mar-17,N.L.,"MONTERREY, N.L.",0,2,2,0,0,0,
14-mar-17,MEX.,"IXTLAHUACA, MEX.",2,0,2,1,0,0,
15-mar-17,DGO.,"DGO., DGO.",1,1,2,1,0,0,
15-mar-17,VER.,"COSOLEACAQUE, VER.",1,1,2,0,0,318,
16-mar-17,DGO.,"GOMEZ PALACIO, DGO.",2,0,2,0,0,0,
17-mar-17,VER.,"COSOLEACAQUE, VER.",2,0,2,0,0,216,
17-mar-17,OAX.,"CIUDAD IXTEPEC, OAX.",2,0,2,1,10,0,
18-mar-17,TAMPS.,"MATAMOROS, TAMPS.",2,0,2,1,0,27,
19-mar-17,MEX.,"VALLE DE CHALCO SOLIDARIDAD, MEX.",2,0,2,1,0,145,
19-mar-17,MEX.,"TEMOAYA, MEX.",1,1,2,0,0,8,
21-mar-17,TAMPS.,"NUEVO LAREDO, TAMPS.",1,1,2,0,0,19,
22-mar-17,N.L.,"SALINAS VICTORIA, N.L.",2,0,2,0,0,0,
22-mar-17,QRO.,"QUERETARO, QRO.",1,1,2,0,0,0,
23-mar-17,N.L.,"MONTERREY, N.L.",1,1,2,1,0,0,
23-mar-17,COAH.,"SAN PEDRO, COAH.",2,0,2,2,0,0,
23-mar-17,CHIH.,"NUEVO CASAS GRANDES, CHIH.",0,2,2,0,0,480,
23-mar-17,TAMPS.,"NUEVO LAREDO, TAMPS.",2,0,2,4,0,70,
25-mar-17,MEX.,"SULTEPEC, MEX.",0,2,2,0,0,0,
26-mar-17,MEX.,"SULTEPEC, MEX.",2,0,2,0,0,0,
27-mar-17,COAH.,"TORREÓN, COAH.",2,0,2,0,0,0,
27-mar-17,OAX.,"MIAHUATLAN DE PORFIRIO DIAZ, OAX.",1,1,2,0,0,100,
27-mar-17,COAH.,"TORREÓN, COAH.",2,0,2,0,0,0,
29-mar-17,GRO.,"COYUCA DE BENITEZ, GRO.",2,0,2,0,0,0,
29-mar-17,OAX.,"MIAHUATLAN DE PORFIRIO DIAZ, OAX.",0,2,2,0,0,0,
29-mar-17,N.L.,"CIENEGA DE FLORES, N.L.",2,0,2,0,0,70,
30-mar-17,TAMPS.,"NUEVO LAREDO, TAMPS.",2,0,2,0,0,12,
31-mar-17,COAH.,"PIEDRAS NEGRAS, COAH.",0,2,2,0,0,0,
31-mar-17,TAMPS.,"NUEVO LAREDO, TAMPS.",2,0,2,0,0,0,
03-abr-17,N.L.,"CIENEGA DE FLORES, N.L.",0,2,2,0,0,0,
04-abr-17,OAX.,"MIAHUATLAN DE PORFIRIO DIAZ, OAX.",0,2,2,0,0,100,
04-abr-17,MICH.,"LAZARO CARDENAS, MICH.",2,0,2,2,0,307,
06-abr-17,OAX.,"MIAHUATLAN DE PORFIRIO DIAZ, OAX.",0,2,2,0,0,0,
06-abr-17,DGO.,"CUENCAME, DGO.",2,0,2,1,0,0,
07-abr-17,MICH.,"SALVADOR ESCALANTE, MICH.",0,2,2,0,0,0,
09-abr-17,DGO.,"DGO., DGO.",1,1,2,0,0,0,
11-abr-17,DGO.,"DGO., DGO.",1,1,2,0,0,0,
13-abr-17,D.F.,"TLALPAN, D.F.",2,0,2,0,2,0,
14-abr-17,D.F.,"COYOACAN, D.F.",2,0,2,0,0,0,
15-abr-17,DGO.,"DGO., DGO.",2,0,2,0,0,0,
15-abr-17,TAMPS.,"MATAMOROS, TAMPS.",2,0,2,1,0,8,
17-abr-17,CHIH.,"HGO. DEL PARRAL, CHIH.",1,1,2,0,0,0,
19-abr-17,DGO.,"DGO., DGO.",1,1,2,1,0,0,
19-abr-17,DGO.,"DGO., DGO.",1,1,2,1,0,0,
20-abr-17,DGO.,"DGO., DGO.",1,1,2,0,0,0,
20-abr-17,VER.,"PANUCO, VER.",2,0,2,0,0,0,
20-abr-17,DGO.,"DGO., DGO.",1,1,2,0,0,0,
21-abr-17,SIN.,"NAVOLATO, SIN.",0,2,2,0,16,0,
21-abr-17,SIN.,"MAZATLAN, SIN.",1,1,2,0,0,0,
21-abr-17,DGO.,"CUENCAME, DGO.",2,0,2,0,0,0,
22-abr-17,DGO.,"CUENCAME, DGO.",2,0,2,0,0,0,
22-abr-17,TAMPS.,"MATAMOROS, TAMPS.",0,2,2,0,0,0,
24-abr-17,DGO.,"DGO., DGO.",1,1,2,0,4,0,
24-abr-17,JAL.,"ZAPOPAN, JAL.",2,0,2,0,0,40,
25-abr-17,JAL.,"TLAQUEPAQUE, JAL.",2,0,2,0,0,0,
26-abr-17,SIN.,"MAZATLAN, SIN.",1,1,2,0,7,0,
27-abr-17,JAL.,"TONALA, JAL.",1,1,2,0,0,0,
27-abr-17,D.F.,"XOCHIMILCO, D.F.",2,0,2,0,0,44,
28-abr-17,N.L.,"MONTERREY, N.L.",2,0,2,2,0,300,
28-abr-17,JAL.,"TLAJOMULCO DE ZUÑIGA, JAL.",2,0,2,0,0,0,
28-abr-17,MICH.,"PANINDICUARO, MICH.",0,2,2,0,0,0,
29-abr-17,TAMPS.,"MATAMOROS, TAMPS.",2,0,2,0,0,113,
29-abr-17,VER.,"PANUCO, VER.",2,0,2,0,0,0,
30-abr-17,JAL.,"GUADALAJARA, JAL.",2,0,2,0,0,8,
30-abr-17,JAL.,"TLAQUEPAQUE, JAL.",0,2,2,0,0,0,
01-may-17,DGO.,"DGO., DGO.",2,0,2,1,0,0,
01-may-17,JAL.,"ZAPOPAN, JAL.",0,2,2,0,0,0,
02-may-17,DGO.,"DGO., DGO.",1,1,2,0,0,0,
03-may-17,D.F.,"XOCHIMILCO, D.F.",2,0,2,0,2,0,
03-may-17,JAL.,"GUADALAJARA, JAL.",2,0,2,0,0,0,
03-may-17,JAL.,"TLAJOMULCO DE ZUÑIGA, JAL.",2,0,2,0,0,0,
03-may-17,JAL.,"TLAQUEPAQUE, JAL.",2,0,2,1,0,138,
04-may-17,JAL.,"TLAQUEPAQUE, JAL.",2,0,2,0,0,0,
05-may-17,TAMPS.,"MATAMOROS, TAMPS.",1,1,2,1,0,67,
06-may-17,JAL.,"TLAQUEPAQUE, JAL.",1,1,2,0,0,0,
06-may-17,DGO.,"DGO., DGO.",1,1,2,2,1,0,
07-may-17,JAL.,"ZAPOPAN, JAL.",2,0,2,0,0,15,
07-may-17,JAL.,"TLAQUEPAQUE, JAL.",1,1,2,0,0,100,
08-may-17,JAL.,"TLAJOMULCO DE ZUÑIGA, JAL.",1,1,2,0,0,0,
08-may-17,SIN.,"BADIRAGUATO, SIN.",1,1,2,0,1,0,
08-may-17,TAMPS.,"NUEVO LAREDO, TAMPS.",2,0,2,0,0,121,
09-may-17,JAL.,"GUADALAJARA, JAL.",0,2,2,0,0,0,
09-may-17,JAL.,"ZAPOPAN, JAL.",2,0,2,1,0,0,
09-may-17,GTO.,"ROMITA, GTO.",1,1,2,0,0,0,
10-may-17,TAMPS.,"NUEVO LAREDO, TAMPS.",1,1,2,0,0,39,
10-may-17,JAL.,"ZAPOPAN, JAL.",2,0,2,0,0,0,
10-may-17,GTO.,"ROMITA, GTO.",0,2,2,0,0,0,
12-may-17,JAL.,"ZAPOPAN, JAL.",2,0,2,0,0,197,
12-may-17,JAL.,"TLAQUEPAQUE, JAL.",0,2,2,0,0,0,
12-may-17,GTO.,"SALAMANCA, GTO.",2,0,2,0,0,0,
12-may-17,PUE.,"TEHUACAN, PUE.",2,0,2,2,0,10,
13-may-17,DGO.,"DGO., DGO.",2,0,2,3,0,0,
13-may-17,JAL.,"TLAQUEPAQUE, JAL.",2,0,2,0,0,32,
15-may-17,JAL.,"TONALA, JAL.",1,1,2,1,0,0,
15-may-17,SIN.,"BADIRAGUATO, SIN.",1,1,2,0,3,0,
16-may-17,GRO.,"ATOYAC DE ALVAREZ, GRO.",2,0,2,1,0,12,
16-may-17,PUE.,"TEHUACAN, PUE.",1,1,2,0,0,183,
16-may-17,D.F.,"AZCAPOTZALCO, D.F.",2,0,2,0,0,0,
18-may-17,JAL.,"GUADALAJARA, JAL.",2,0,2,0,0,0,
18-may-17,SIN.,"BADIRAGUATO, SIN.",1,1,2,0,0,0,
18-may-17,N.L.,"MONTERREY, N.L.",0,2,2,0,0,0,
19-may-17,JAL.,"TLAQUEPAQUE, JAL.",2,0,2,0,0,111,
19-may-17,SIN.,"SAN IGNACIO, SIN.",1,1,2,0,0,0,
19-may-17,D.F.,"AZCAPOTZALCO, D.F.",2,0,2,0,0,11,
20-may-17,DGO.,"DGO., DGO.",1,1,2,0,0,0,
20-may-17,JAL.,"TLAQUEPAQUE, JAL.",1,1,2,0,0,0,
20-may-17,TAMPS.,"MATAMOROS, TAMPS.",1,1,2,0,0,99,
21-may-17,JAL.,"TLAQUEPAQUE, JAL.",2,0,2,0,0,117,
22-may-17,JAL.,"TLAQUEPAQUE, JAL.",0,2,2,0,0,0,
22-may-17,PUE.,"TEHUACAN, PUE.",2,0,2,1,0,0,
22-may-17,SON.,"NAVOLATO, SIN.",1,1,2,0,0,42,
23-may-17,GRO.,"COYUCA DE BENITEZ, GRO.",1,1,2,0,0,0,
23-may-17,N.L.,"MINA, N.L.",1,1,2,0,0,0,
23-may-17,JAL.,"GUADALAJARA, JAL.",2,0,2,0,0,0,
23-may-17,JAL.,"ZAPOPAN, JAL.",1,1,2,0,0,0,
23-may-17,JAL.,"TONALA, JAL.",1,1,2,0,0,0,
24-may-17,JAL.,"TONALA, JAL.",1,1,2,0,0,0,
24-may-17,AGS.,"AGS., AGS.",1,1,2,0,0,52,
25-may-17,AGS.,"AGS., AGS.",1,1,2,0,0,0,
25-may-17,SON.,"GUAYMAS, SON.",0,2,2,0,0,0,
25-may-17,JAL.,"TONALA, JAL.",1,1,2,0,0,0,
25-may-17,JAL.,"TLAQUEPAQUE, JAL.",2,0,2,0,0,169,
25-may-17,OAX.,"SAN PEDRO TAPANATEPEC, OAX.",1,1,2,0,0,0,
26-may-17,TAMPS.,"MATAMOROS, TAMPS.",0,2,2,3,0,21,
26-may-17,SON.,"GUAYMAS, SON.",2,0,2,0,0,0,
26-may-17,SIN.,"CONCORDIA, SIN.",1,1,2,0,0,0,
26-may-17,TAMPS.,"NUEVO LAREDO, TAMPS.",0,2,2,3,0,21,
27-may-17,SON.,"GUAYMAS, SON.",2,0,2,1,0,0,
27-may-17,JAL.,"TLAQUEPAQUE, JAL.",2,0,2,0,0,0,
28-may-17,DGO.,"DGO., DGO.",1,1,2,1,0,0,
29-may-17,JAL.,"TONALA, JAL.",1,1,2,0,0,0,
30-may-17,D.F.,"BENITO JUAREZ, D.F.",0,2,2,0,3,54,
30-may-17,JAL.,"GUADALAJARA, JAL.",1,1,2,0,1,0,
30-may-17,JAL.,"TLAJOMULCO DE ZUÑIGA, JAL.",1,1,2,2,1,22,
30-may-17,JAL.,"TONALA, JAL.",0,2,2,0,0,0,
30-may-17,JAL.,"ZAPOPAN, JAL.",0,2,2,0,1,0,
31-may-17,SIN.,"CONCORDIA, SIN.",2,0,2,0,2,0,
31-may-17,JAL.,"GUADALAJARA, JAL.",2,0,2,0,0,0,
31-may-17,JAL.,"TLAQUEPAQUE, JAL.",1,1,2,0,0,150,
01-jun-17,JAL.,"ZAPOPAN, JAL.",2,0,2,0,0,0,
01-jun-17,TAB.,"TENOSIQUE, TAB.",1,1,2,0,0,0,
01-jun-17,TLAX.,"PANOTLA, TLAX.",1,1,2,0,0,0,
02-jun-17,GRO.,"ATOYAC DE ALVAREZ, GRO.",1,1,2,1,0,0,
02-jun-17,D.F.,"BENITO JUAREZ, D.F.",0,2,2,0,0,10000,
02-jun-17,DGO.,"DGO., DGO.",0,2,2,3,0,0,
03-jun-17,MOR.,"CUERNAVACA, MOR.",2,0,2,0,2,335,
03-jun-17,JAL.,"TLAQUEPAQUE, JAL.",0,2,2,0,0,335,
04-jun-17,GRO.,"ATOYAC DE ALVAREZ, GRO.",2,0,2,2,0,0,
04-jun-17,TAMPS.,"MATAMOROS, TAMPS.",0,2,2,0,0,0,
06-jun-17,TAB.,"CENTRO, TAB.",2,0,2,0,0,0,
06-jun-17,DGO.,"DGO., DGO.",2,0,2,2,0,0,
06-jun-17,JAL.,"TONALA, JAL.",0,2,2,0,0,0,
06-jun-17,TAMPS.,"MIER, TAMPS.",1,1,2,0,0,0,
06-jun-17,CHIS.,"TAPACHULA, CHIS.",1,1,2,2,2,415,
06-jun-17,CHIS.,"PALENQUE, CHIS.",1,1,2,0,0,17,
07-jun-17,DGO.,"DGO., DGO.",1,1,2,1,0,0,
07-jun-17,N.L.,"SANTA CATARINA, N.L.",2,0,2,2,0,100,
07-jun-17,N.L.,"MONTERREY, N.L.",0,2,2,0,0,0,
07-jun-17,TAB.,"CENTRO, TAB.",2,0,2,1,0,0,
07-jun-17,SON.,"CAJEME, SON.",2,0,2,0,0,253,
07-jun-17,SON.,"NAVOJOA, SON.",2,0,2,0,0,0,
08-jun-17,TAB.,"CENTRO, TAB.",2,0,2,0,0,0,
08-jun-17,JAL.,"TLAJOMULCO DE ZUÑIGA, JAL.",0,2,2,0,0,0,
08-jun-17,GRO.,"ATOYAC DE ALVAREZ, GRO.",0,2,2,2,0,0,
08-jun-17,CHIS.,"CHIAPA DE CORZO, CHIS.",2,0,2,16,0,100,
09-jun-17,CHIS.,"PALENQUE, CHIS.",1,1,2,3,0,120,
09-jun-17,JAL.,"ZAPOPAN, JAL.",2,0,2,0,0,0,
09-jun-17,CHIS.,"TONALÁ, CHIS.",1,1,2,28,1,620,
09-jun-17,TAMPS.,"MIER, TAMPS.",2,0,2,4,0,69,
09-jun-17,SIN.,"CONCORDIA, SIN.",2,0,2,0,0,0,
09-jun-17,DGO.,"DGO., DGO.",1,1,2,0,0,0,
10-jun-17,TAB.,"CENTRO, TAB.",2,0,2,0,0,0,
11-jun-17,TLAX.,"CHIAUTEMPAN, TLAX.",0,2,2,0,0,0,
12-jun-17,SIN.,"CHOIX, SIN.",1,1,2,0,0,0,
12-jun-17,JAL.,"TONALA, JAL.",0,2,2,0,0,0,
12-jun-17,JAL.,"TLAJOMULCO DE ZUÑIGA, JAL.",1,1,2,1,0,125,
13-jun-17,SIN.,"CHOIX, SIN.",2,0,2,0,0,0,
14-jun-17,N.L.,"SANTA CATARINA, N.L.",2,0,2,0,0,134,
14-jun-17,JAL.,"TLAQUEPAQUE, JAL.",0,2,2,0,0,0,
14-jun-17,CHIH.,"HGO. DEL PARRAL, CHIH.",1,1,2,0,0,0,
15-jun-17,D.F.,"GUSTAVO A. MADERO, D.F.",2,0,2,0,0,106,
15-jun-17,SIN.,"ROSARIO, SIN.",1,1,2,0,0,0,
15-jun-17,B.C.,"TIJUANA, B.C.",0,2,2,0,3,0,
15-jun-17,JAL.,"GUADALAJARA, JAL.",2,0,2,0,0,0,
15-jun-17,JAL.,"TLAJOMULCO DE ZUÑIGA, JAL.",2,0,2,0,0,0,
15-jun-17,DGO.,"DGO., DGO.",1,1,2,6,0,0,
16-jun-17,JAL.,"TLAQUEPAQUE, JAL.",0,2,2,0,0,0,
16-jun-17,B.C.,"TIJUANA, B.C.",1,1,2,0,0,0,
16-jun-17,COAH.,"FRANCISCO I. MADERO, COAH.",1,1,2,0,0,0,
16-jun-17,COAH.,"PIEDRAS NEGRAS, COAH.",1,1,2,0,0,0,
16-jun-17,MEX.,"CUAUTITLAN IZCALLI, MEX.",2,0,2,1,2,7,
16-jun-17,SIN.,"CHOIX, SIN.",2,0,2,0,0,0,
16-jun-17,N.L.,"MONTERREY, N.L.",1,1,2,1,3,104,
16-jun-17,COAH.,"SAN PEDRO, COAH.",1,1,2,0,0,0,
17-jun-17,SON.,"NAVOJOA, SON.",2,0,2,0,0,0,
18-jun-17,B.C.,"ENSENADA, B.C.",0,2,2,0,0,0,
18-jun-17,MEX.,"NEZAHUALCOYOTL, MEX.",1,1,2,0,0,178,
18-jun-17,JAL.,"TLAJOMULCO DE ZUÑIGA, JAL.",1,1,2,6,1,169,
19-jun-17,B.C.,"ENSENADA, B.C.",0,2,2,0,0,0,
19-jun-17,DGO.,"DGO., DGO.",0,2,2,0,1,0,
19-jun-17,N.L.,"SANTA CATARINA, N.L.",1,1,2,0,0,0,
20-jun-17,JAL.,"TLAQUEPAQUE, JAL.",1,1,2,0,0,0,
20-jun-17,JAL.,"TONALA, JAL.",0,2,2,0,0,0,
20-jun-17,COAH.,"ACUÑA, COAH.",2,0,2,0,0,0,
20-jun-17,CHIH.,"NUEVO CASAS GRANDES, CHIH.",0,2,2,0,0,191,
20-jun-17,SIN.,"SALVADOR ALVARADO, SIN.",2,0,2,0,0,0,
21-jun-17,MEX.,"JIQUIPILCO, MEX.",1,1,2,0,0,367,
21-jun-17,JAL.,"GUADALAJARA, JAL.",2,0,2,0,0,0,
21-jun-17,JAL.,"TLAQUEPAQUE, JAL.",1,1,2,0,0,0,
21-jun-17,COAH.,"SALTILLO, COAH.",2,0,2,0,0,0,
21-jun-17,SIN.,"SALVADOR ALVARADO, SIN.",2,0,2,0,0,0,
21-jun-17,DGO.,"DGO., DGO.",0,2,2,0,0,0,
21-jun-17,TLAX.,"TLAXCO, TLAX.",1,1,2,0,0,0,
22-jun-17,TLAX.,"TLAXCO, TLAX.",0,2,2,0,0,0,
22-jun-17,COAH.,"MONCLOVA, COAH.",2,0,2,0,0,115,
23-jun-17,GRO.,"PUNGARABATO, GRO.",1,1,2,0,0,0,
23-jun-17,COAH.,"SALTILLO, COAH.",2,0,2,0,0,0,
23-jun-17,JAL.,"ZAPOPAN, JAL.",2,0,2,0,0,100,
24-jun-17,JAL.,"TLAJOMULCO DE ZUÑIGA, JAL.",2,0,2,1,0,46,
24-jun-17,COAH.,"MONCLOVA, COAH.",2,0,2,0,0,0,
25-jun-17,MEX.,"ISIDRO FABELA, MEX.",0,2,2,0,0,0,
26-jun-17,COAH.,"SALTILLO, COAH.",1,1,2,0,0,0,
26-jun-17,COAH.,"MONCLOVA, COAH.",1,1,2,0,0,0,
26-jun-17,JAL.,"IXTLAHUACAN DE LOS MEMBRILLOS, JAL.",0,2,2,0,0,125,
26-jun-17,SIN.,"SALVADOR ALVARADO, SIN.",1,1,2,0,6,0,
26-jun-17,D.F.,"IZTAPALAPA, D.F.",2,0,2,0,2,0,
27-jun-17,COAH.,"PIEDRAS NEGRAS, COAH.",2,0,2,2,0,5,
27-jun-17,JAL.,"IXTLAHUACAN DE LOS MEMBRILLOS, JAL.",1,1,2,0,0,0,
28-jun-17,MEX.,"JOCOTITLAN, MEX.",1,1,2,0,2,0,
28-jun-17,COAH.,"SALTILLO, COAH.",2,0,2,0,0,0,
28-jun-17,MICH.,"BUENAVISTA, MICH.",1,1,2,0,0,0,
29-jun-17,MICH.,"BUENAVISTA, MICH.",1,1,2,0,0,0,
29-jun-17,MEX.,"ATLAUTLA, MEX.",2,0,2,0,0,122,
29-jun-17,COAH.,"PIEDRAS NEGRAS, COAH.",1,1,2,4,0,104,
29-jun-17,SIN.,"SALVADOR ALVARADO, SIN.",2,0,2,0,0,0,
29-jun-17,JAL.,"IXTLAHUACAN DE LOS MEMBRILLOS, JAL.",0,2,2,0,0,100,
29-jun-17,JAL.,"EL SALTO, JAL.",0,2,2,0,0,0,
30-jun-17,JAL.,"IXTLAHUACAN DE LOS MEMBRILLOS, JAL.",0,2,2,0,0,200,
30-jun-17,SIN.,"ROSARIO, SIN.",2,0,2,0,0,0,
01-jul-17,COAH.,"SABINAS, COAH.",2,0,2,0,0,142,
01-jul-17,COAH.,"SABINAS, COAH.",2,0,2,0,0,142,
02-jul-17,MEX.,"MEXICALTZINGO, MEX.",0,2,2,0,0,0,
02-jul-17,MEX.,"ACULCO, MEX.",1,1,2,0,1,19,
02-jul-17,GTO.,"MANUEL DOBLADO, GTO.",2,0,2,0,0,0,
03-jul-17,JAL.,"IXTLAHUACAN DE LOS MEMBRILLOS, JAL.",1,1,2,0,0,0,
03-jul-17,SON.,"CAJEME, SON.",2,0,2,1,0,0,
04-jul-17,MEX.,"COCOTITLAN, MEX.",2,0,2,0,0,50,
04-jul-17,GRO.,"PUNGARABATO, GRO.",0,2,2,0,0,0,
04-jul-17,JAL.,"IXTLAHUACAN DE LOS MEMBRILLOS, JAL.",0,2,2,0,0,0,
04-jul-17,D.F.,"IZTAPALAPA, D.F.",2,0,2,0,0,43,
04-jul-17,MICH.,"BUENAVISTA, MICH.",0,2,2,0,0,1331,
04-jul-17,COAH.,"TORREÓN, COAH.",2,0,2,0,0,0,
04-jul-17,COAH.,"SALTILLO, COAH.",0,2,2,8,0,275,
04-jul-17,COAH.,"MONCLOVA, COAH.",2,0,2,0,0,0,
05-jul-17,MEX.,"NOPALTEPEC, MEX.",0,2,2,0,0,0,
05-jul-17,AGS.,"PABELLÓN DE ARTEAGA, AGS.",0,2,2,0,0,0,
05-jul-17,JAL.,"IXTLAHUACAN DE LOS MEMBRILLOS, JAL.",2,0,2,0,0,0,
05-jul-17,OAX.,"PINOTEPA DE DON LUIS, OAX.",2,0,2,0,0,0,
06-jul-17,MEX.,"NOPALTEPEC, MEX.",2,0,2,0,0,0,
06-jul-17,COAH.,"SALTILLO, COAH.",2,0,2,0,0,469,
06-jul-17,SIN.,"EL FUERTE, SIN.",1,1,2,0,0,0,
06-jul-17,JAL.,"IXTLAHUACAN DE LOS MEMBRILLOS, JAL.",2,0,2,0,0,0,
07-jul-17,COAH.,"FRANCISCO I. MADERO, COAH.",2,0,2,0,0,0,
07-jul-17,COAH.,"SALTILLO, COAH.",0,2,2,1,0,173,
07-jul-17,COAH.,"SABINAS, COAH.",2,0,2,0,0,0,
07-jul-17,B.C.,"TIJUANA, B.C.",0,2,2,0,0,0,
07-jul-17,TAMPS.,"MATAMOROS, TAMPS.",2,0,2,0,0,170,
07-jul-17,PUE.,"SAN MATIAS TLALANCALECA, PUE.",0,2,2,0,0,0,
08-jul-17,COAH.,"SABINAS, COAH.",2,0,2,0,0,0,
08-jul-17,TLAX.,"NATIVITAS, TLAX.",0,2,2,0,0,0,
08-jul-17,OAX.,"ASUNCION IXTALTEPEC, OAX.",2,0,2,0,0,0,
08-jul-17,TAMPS.,"MATAMOROS, TAMPS.",2,0,2,0,0,8,
09-jul-17,JAL.,"EL SALTO, JAL.",0,2,2,0,0,0,
10-jul-17,COAH.,"SALTILLO, COAH.",1,1,2,0,0,0,
10-jul-17,MOR.,"TEPOZTLAN, MOR.",1,1,2,1,0,0,
10-jul-17,GRO.,"XOCHIHUEHUETLAN, GRO.",2,0,2,0,0,0,
11-jul-17,COAH.,"MÚZQUIZ, COAH.",2,0,2,0,0,13,
11-jul-17,CHIH.,"HGO. DEL PARRAL, CHIH.",2,0,2,0,0,0,
11-jul-17,N.L.,"HIGUERAS, N.L.",2,0,2,0,0,0,
11-jul-17,GRO.,"LA UNION DE ISIDORO MONTES DE OCA, GRO.",2,0,2,0,0,0,
12-jul-17,JAL.,"EL SALTO, JAL.",1,1,2,0,0,0,
12-jul-17,MEX.,"OZUMBA, MEX.",1,1,2,0,0,0,
13-jul-17,TLAX.,"TLAX., TLAX.",1,1,2,0,0,0,
13-jul-17,JAL.,"EL SALTO, JAL.",2,0,2,3,0,35,
13-jul-17,MEX.,"MOR., MEX.",2,0,2,0,0,0,
13-jul-17,MEX.,"ATLACOMULCO, MEX.",0,2,2,0,0,18,
13-jul-17,COAH.,"NUEVA ROSITA, COAH.",0,2,2,0,0,0,
13-jul-17,MOR.,"TEPOZTLAN, MOR.",2,0,2,0,0,569,
14-jul-17,MOR.,"TEPOZTLAN, MOR.",1,1,2,9,0,589,
15-jul-17,HGO.,"TULA DE ALLENDE, HGO.",1,1,2,0,0,0,
15-jul-17,COAH.,"SABINAS, COAH.",1,1,2,0,0,0,
17-jul-17,COAH.,"SALTILLO, COAH.",2,0,2,0,0,548,
18-jul-17,COAH.,"SALTILLO, COAH.",1,1,2,0,0,0,
18-jul-17,COAH.,"SABINAS, COAH.",1,1,2,0,0,0,
19-jul-17,COAH.,"TORREÓN, COAH.",2,0,2,0,1,0,
19-jul-17,TLAX.,"SANTA ANA NOPALUCAN, TLAX.",0,2,2,0,0,0,
20-jul-17,D.F.,"MIGUEL HGO., D.F.",2,0,2,0,0,0,
20-jul-17,N.L.,"MONTERREY, N.L.",2,0,2,1,0,33,
20-jul-17,B.C.,"TIJUANA, B.C.",0,2,2,0,2,0,
20-jul-17,TLAX.,"TLAX., TLAX.",0,2,2,0,0,0,
21-jul-17,JAL.,"ZAPOTLANEJO, JAL.",1,1,2,0,0,0,
21-jul-17,COAH.,"SABINAS, COAH.",0,2,2,0,0,0,
21-jul-17,MOR.,"TEPOZTLAN, MOR.",2,0,2,1,0,50,
21-jul-17,B.C.,"TIJUANA, B.C.",0,2,2,0,1,0,
22-jul-17,COAH.,"FRANCISCO I. MADERO, COAH.",1,1,2,0,0,3,
22-jul-17,TAMPS.,"TAMPICO, TAMPS.",1,1,2,3,0,166,
22-jul-17,MEX.,"ATENCO, MEX.",2,0,2,0,0,0,
22-jul-17,MEX.,"CUAUTITLAN IZCALLI, MEX.",2,0,2,0,0,0,
22-jul-17,VER.,"JESUS CARRANZA, VER.",2,0,2,1,0,0,
22-jul-17,TLAX.,"SANTA ANA NOPALUCAN, TLAX.",0,2,2,0,0,0,
24-jul-17,JAL.,"IXTLAHUACAN DE LOS MEMBRILLOS, JAL.",2,0,2,0,0,0,
25-jul-17,AGS.,"AGS., AGS.",2,0,2,0,0,0,
26-jul-17,COAH.,"SALTILLO, COAH.",1,1,2,0,4,395,
26-jul-17,MEX.,"CHAPA DE MOTA, MEX.",2,0,2,0,0,0,
27-jul-17,COAH.,"SALTILLO, COAH.",2,0,2,0,0,100,
27-jul-17,COAH.,"ACUÑA, COAH.",0,2,2,2,0,0,
27-jul-17,MEX.,"CHAPA DE MOTA, MEX.",1,1,2,1,0,0,
28-jul-17,MEX.,"ALMOLOYA DEL RIO, MEX.",2,0,2,0,0,0,
28-jul-17,MEX.,"TEPETLAOXTOC, MEX.",1,1,2,0,0,5,
31-jul-17,CHIS.,"TUXTLA GUTIÉRREZ, CHIS.",2,0,2,0,0,107,
01-ago-17,MEX.,"TLALMANALCO, MEX.",2,0,2,2,0,80,
01-ago-17,MEX.,"TEZOYUCA, MEX.",1,1,2,0,0,0,
01-ago-17,CHIS.,"TUXTLA GUTIÉRREZ, CHIS.",1,1,2,0,0,207,
01-ago-17,HGO.,"ZACUALTIPAN DE ANGELES, HGO.",0,2,2,0,0,0,
02-ago-17,MEX.,"SAN SIMON DE GRO., MEX.",0,2,2,0,0,0,
02-ago-17,MEX.,"TLALMANALCO, MEX.",0,2,2,0,3,0,
02-ago-17,AGS.,"AGS., AGS.",2,0,2,9,0,7,
03-ago-17,MEX.,"TLALMANALCO, MEX.",1,1,2,0,2,0,
03-ago-17,MOR.,"EMILIANO ZAPATA, MOR.",2,0,2,0,0,0,
03-ago-17,B.C.,"MEXICALI, B.C.",1,1,2,0,0,0,
05-ago-17,MEX.,"SOYANIQUILPAN DE JUAREZ, MEX.",1,1,2,0,0,0,
06-ago-17,MEX.,"TEZOYUCA, MEX.",2,0,2,0,0,3,
07-ago-17,SIN.,"EL FUERTE, SIN.",2,0,2,0,3,0,
07-ago-17,DGO.,"DGO., DGO.",1,1,2,0,0,0,
08-ago-17,D.F.,"MIGUEL HGO., D.F.",1,1,2,0,0,0,
08-ago-17,MEX.,"SANTO TOMAS, MEX.",0,2,2,0,0,0,
08-ago-17,S.L.P.,"CIUDAD VALLES, S.L.P.",2,0,2,0,0,0,
09-ago-17,N.L.,"APODACA, N.L.",1,1,2,0,0,33,
09-ago-17,D.F.,"MIGUEL HGO., D.F.",1,1,2,0,0,400,
09-ago-17,MEX.,"TONANITLA, MEX.",1,1,2,0,0,0,
10-ago-17,MEX.,"TONANITLA, MEX.",1,1,2,0,0,28,
10-ago-17,MEX.,"AMECAMECA, MEX.",2,0,2,0,0,19,
10-ago-17,S.L.P.,"SAN LUIS POTOSI, S.L.P.",2,0,2,17,1,0,
11-ago-17,Q. ROO,"OTHON P. BLANCO, Q. ROO",1,1,2,0,0,22,
12-ago-17,TAMPS.,"MATAMOROS, TAMPS.",2,0,2,1,0,23,
13-ago-17,B.C.,"MEXICALI, B.C.",1,1,2,0,0,0,
14-ago-17,COAH.,"SALTILLO, COAH.",2,0,2,1,4,415,
15-ago-17,COAH.,"SALTILLO, COAH.",0,2,2,0,2,0,
15-ago-17,SIN.,"COSALA, SIN.",1,1,2,0,3,0,
16-ago-17,S.L.P.,"CIUDAD VALLES, S.L.P.",2,0,2,0,0,0,
16-ago-17,B.C.,"TIJUANA, B.C.",0,2,2,0,0,0,
16-ago-17,N.L.,"APODACA, N.L.",2,0,2,0,0,0,
16-ago-17,S.L.P.,"CIUDAD VALLES, S.L.P.",2,0,2,0,0,0,
16-ago-17,MEX.,"TEXCOCO, MEX.",1,1,2,0,0,0,
16-ago-17,CHIS.,"TUXTLA GUTIÉRREZ, CHIS.",1,1,2,0,0,0,
17-ago-17,N.L.,"MONTERREY, N.L.",2,0,2,0,0,0,
17-ago-17,D.F.,"VENUSTIANO CARRANZA, D.F.",2,0,2,0,0,0,
17-ago-17,DGO.,"DGO., DGO.",2,0,2,0,0,0,
18-ago-17,QRO.,"EL MARQUES, QRO.",1,1,2,0,0,494,
18-ago-17,DGO.,"DGO., DGO.",1,1,2,0,0,0,
18-ago-17,COAH.,"SALTILLO, COAH.",1,1,2,2,0,80,
18-ago-17,SIN.,"COSALA, SIN.",2,0,2,0,5,0,
19-ago-17,B.C.,"TIJUANA, B.C.",1,1,2,0,0,0,
21-ago-17,SIN.,"COSALA, SIN.",1,1,2,0,0,0,
22-ago-17,DGO.,"DGO., DGO.",0,2,2,0,0,0,
23-ago-17,S.L.P.,"SAN LUIS POTOSI, S.L.P.",2,0,2,1,0,0,
23-ago-17,TAMPS.,"REYNOSA, TAMPS.",1,1,2,0,0,12,
25-ago-17,COAH.,"TORREÓN, COAH.",2,0,2,0,0,0,
25-ago-17,MOR.,"EMILIANO ZAPATA, MOR.",2,0,2,9,0,153,
26-ago-17,MEX.,"VILLA DE ALLENDE, MEX.",1,1,2,2,0,0,
26-ago-17,S.L.P.,"CIUDAD VALLES, S.L.P.",2,0,2,0,0,0,
27-ago-17,MEX.,"SAN MARTIN DE LAS PIRAMIDES, MEX.",1,1,2,0,0,0,
27-ago-17,COAH.,"TORREÓN, COAH.",2,0,2,0,0,0,
28-ago-17,D.F.,"TLALPAN, D.F.",0,2,2,0,1,14,
28-ago-17,COAH.,"TORREÓN, COAH.",2,0,2,0,0,0,
29-ago-17,COAH.,"RAMOS ARIZPE, COAH.",2,0,2,2,0,400,
29-ago-17,COAH.,"MÚZQUIZ, COAH.",0,2,2,0,0,0,
29-ago-17,B.C.,"MEXICALI, B.C.",1,1,2,0,0,0,
29-ago-17,S.L.P.,"SAN LUIS POTOSI, S.L.P.",2,0,2,0,1,0,
30-ago-17,SIN.,"ANGOSTURA, SIN.",1,1,2,0,0,0,
30-ago-17,TAMPS.,"NUEVO LAREDO, TAMPS.",2,0,2,5,0,370,
30-ago-17,COAH.,"TORREÓN, COAH.",2,0,2,0,0,0,
31-ago-17,COAH.,"NUEVA ROSITA, COAH.",2,0,2,0,0,300,
31-ago-17,B.C.,"TIJUANA, B.C.",1,1,2,0,0,0,
31-ago-17,S.L.P.,"CIUDAD VALLES, S.L.P.",2,0,2,0,0,0,
31-ago-17,MEX.,"ZACAZONAPAN, MEX.",1,1,2,0,0,0,
31-ago-17,MEX.,"CHICOLOAPAN, MEX.",2,0,2,1,2,181,
31-ago-17,MEX.,"LA PAZ, MEX.",1,1,2,0,0,0,
01-sep-17,CHIH.,"HGO. DEL PARRAL, CHIH.",2,0,2,0,0,0,
01-sep-17,N.L.,"MONTERREY, N.L.",1,1,2,2,0,150,
02-sep-17,GRO.,"ATOYAC DE ALVAREZ, GRO.",1,1,2,1,0,34,
03-sep-17,VER.,"ISLA, VER.",1,1,2,0,0,0,
05-sep-17,MEX.,"ZACUALPAN, MEX.",0,2,2,0,0,0,
05-sep-17,VER.,"UXPANAPA, VER.",2,0,2,1,0,0,
05-sep-17,TAMPS.,"TAMPICO, TAMPS.",1,1,2,0,0,594,
06-sep-17,N.L.,"MONTERREY, N.L.",1,1,2,0,0,0,
07-sep-17,COAH.,"SALTILLO, COAH.",2,0,2,0,0,175,
07-sep-17,MEX.,"APAXCO, MEX.",2,0,2,0,0,954,
07-sep-17,N.L.,"MONTERREY, N.L.",0,2,2,0,0,0,
07-sep-17,MEX.,"ZACUALPAN, MEX.",0,2,2,1,0,0,
08-sep-17,QRO.,"JALPAN DE SERRA, QRO.",1,1,2,0,0,0,
08-sep-17,TAMPS.,"MATAMOROS, TAMPS.",1,1,2,1,0,28,
09-sep-17,TAMPS.,"MATAMOROS, TAMPS.",1,1,2,1,0,28,
10-sep-17,MEX.,"CHIAUTLA, MEX.",1,1,2,0,0,796,
11-sep-17,AGS.,"AGS., AGS.",2,0,2,0,0,0,
12-sep-17,B.C.,"TIJUANA, B.C.",2,0,2,0,0,0,
12-sep-17,AGS.,"AGS., AGS.",1,1,2,0,0,0,
12-sep-17,ZAC.,"TRANCOSO, ZAC.",2,0,2,0,0,0,
13-sep-17,B.C.,"MEXICALI, B.C.",0,2,2,0,0,0,
14-sep-17,ZAC.,"GUADALUPE, ZAC.",2,0,2,0,0,450,
15-sep-17,DGO.,"DGO., DGO.",1,1,2,0,0,0,
15-sep-17,AGS.,"AGS., AGS.",1,1,2,0,0,0,
15-sep-17,ZAC.,"TLALTENANGO DE SANCHEZ ROMAN, ZAC.",2,0,2,0,0,351,
15-sep-17,ZAC.,"TAB., ZAC.",1,1,2,0,0,361,
20-sep-17,ZAC.,"FRESNILLO, ZAC.",1,1,2,13,0,506,
21-sep-17,DGO.,"DGO., DGO.",0,2,2,0,0,0,
21-sep-17,ZAC.,"GUADALUPE, ZAC.",2,0,2,0,0,915,
21-sep-17,SIN.,"MOCORITO, SIN.",1,1,2,0,4,0,
22-sep-17,SON.,"HERMOSILLO, SON.",2,0,2,1,0,32,
22-sep-17,COL.,"COL., COL.",0,2,2,0,0,0,
22-sep-17,ZAC.,"JALPA, ZAC.",1,1,2,0,0,242,
22-sep-17,B.C.,"ENSENADA, B.C.",1,1,2,0,0,0,
22-sep-17,B.C.,"MEXICALI, B.C.",1,1,2,0,0,0,
22-sep-17,MEX.,"COYOTEPEC, MEX.",2,0,2,2,0,18,
24-sep-17,MEX.,"COYOTEPEC, MEX.",0,2,2,0,0,197,
24-sep-17,MEX.,"AMANALCO, MEX.",0,2,2,0,0,0,
25-sep-17,AGS.,"AGS., AGS.",2,0,2,0,0,0,
26-sep-17,DGO.,"DGO., DGO.",2,0,2,2,0,0,
27-sep-17,B.C.,"MEXICALI, B.C.",2,0,2,0,0,0,
27-sep-17,MEX.,"PAPALOTLA, MEX.",1,1,2,0,0,0,
28-sep-17,COAH.,"SALTILLO, COAH.",2,0,2,0,0,0,
28-sep-17,COAH.,"RAMOS ARIZPE, COAH.",1,1,2,0,0,149,
28-sep-17,MEX.,"ATIZAPAN, MEX.",1,1,2,0,0,0,
29-sep-17,ZAC.,"EL PLATEADO DE JOAQUIN AMARO, ZAC.",1,1,2,0,0,0,
29-sep-17,COAH.,"SALTILLO, COAH.",1,1,2,0,0,0,
29-sep-17,COAH.,"RAMOS ARIZPE, COAH.",2,0,2,0,0,0,
29-sep-17,MEX.,"TIANGUISTENCO, MEX.",2,0,2,0,0,0,
29-sep-17,SIN.,"AHOME, SIN.",2,0,2,0,7,0,
29-sep-17,GRO.,"COYUCA DE BENITEZ, GRO.",1,1,2,0,0,0,
30-sep-17,MEX.,"ATIZAPAN, MEX.",2,0,2,0,0,0,
30-sep-17,TAMPS.,"MATAMOROS, TAMPS.",0,2,2,0,0,0,
01-oct-17,B.C.,"TIJUANA, B.C.",2,0,2,0,1,0,
02-oct-17,ZAC.,"GUADALUPE, ZAC.",2,0,2,0,0,14,
03-oct-17,COAH.,"SALTILLO, COAH.",2,0,2,0,0,0,
03-oct-17,SON.,"HERMOSILLO, SON.",1,1,2,0,0,54,
04-oct-17,SON.,"HERMOSILLO, SON.",0,2,2,0,0,84,
05-oct-17,SIN.,"AHOME, SIN.",2,0,2,0,0,0,
05-oct-17,CHIS.,"OCOSINGO, CHIS.",0,2,2,0,0,0,
06-oct-17,N.L.,"GALEANA, N.L.",2,0,2,0,0,0,
07-oct-17,SON.,"HERMOSILLO, SON.",1,1,2,0,0,7,
11-oct-17,AGS.,"AGS., AGS.",2,0,2,1,0,0,
15-oct-17,TAMPS.,"MATAMOROS, TAMPS.",2,0,2,1,0,37,
16-oct-17,DGO.,"DGO., DGO.",1,1,2,0,0,0,
18-oct-17,B.C.,"MEXICALI, B.C.",0,2,2,0,0,0,
18-oct-17,SIN.,"GUASAVE, SIN.",1,1,2,0,0,0,
19-oct-17,COL.,"COL., COL.",1,1,2,0,0,0,
20-oct-17,DGO.,"GOMEZ PALACIO, DGO.",1,1,2,0,0,0,
20-oct-17,ZAC.,"MOMAX, ZAC.",2,0,2,2,0,325,
20-oct-17,SON.,"HERMOSILLO, SON.",2,0,2,17,1,130,
20-oct-17,GRO.,"ATOYAC DE ALVAREZ, GRO.",0,2,2,1,0,0,
21-oct-17,TAMPS.,"MATAMOROS, TAMPS.",0,2,2,2,0,1,
23-oct-17,SIN.,"CULIACAN, SIN.",1,1,2,0,10,0,
25-oct-17,B.C.,"TIJUANA, B.C.",1,1,2,0,0,0,
25-oct-17,SON.,"ALAMOS, SON.",2,0,2,1,0,0,
25-oct-17,N.L.,"MONTERREY, N.L.",0,2,2,2,0,0,
26-oct-17,N.L.,"MONTERREY, N.L.",0,2,2,2,0,40,
27-oct-17,COAH.,"ACUÑA, COAH.",2,0,2,0,0,0,
27-oct-17,CHIS.,"OCOSINGO, CHIS.",1,1,2,0,0,0,
29-oct-17,N.L.,"MONTERREY, N.L.",0,2,2,2,0,0,
31-oct-17,CHIH.,"NUEVO CASAS GRANDES, CHIH.",2,0,2,0,0,97,
03-nov-17,TAMPS.,"MATAMOROS, TAMPS.",1,1,2,5,0,34,
04-nov-17,S.L.P.,"SAN LUIS POTOSI, S.L.P.",2,0,2,0,0,0,
04-nov-17,TAMPS.,"MATAMOROS, TAMPS.",1,1,2,0,0,0,
07-nov-17,SIN.,"MAZATLAN, SIN.",2,0,2,0,0,0,
07-nov-17,S.L.P.,"SAN LUIS POTOSI, S.L.P.",2,0,2,1,0,0,
08-nov-17,S.L.P.,"SAN LUIS POTOSI, S.L.P.",2,0,2,0,0,0,
09-nov-17,ZAC.,"GUADALUPE, ZAC.",1,1,2,0,0,120,
09-nov-17,S.L.P.,"CIUDAD VALLES, S.L.P.",2,0,2,0,0,0,
09-nov-17,S.L.P.,"SAN LUIS POTOSI, S.L.P.",1,1,2,0,0,0,
10-nov-17,SIN.,"MAZATLAN, SIN.",2,0,2,0,0,0,
10-nov-17,B.C.,"TIJUANA, B.C.",0,2,2,0,0,0,
10-nov-17,S.L.P.,"CIUDAD VALLES, S.L.P.",2,0,2,0,0,0,
11-nov-17,S.L.P.,"SAN LUIS POTOSI, S.L.P.",2,0,2,6,0,0,
13-nov-17,SON.,"HERMOSILLO, SON.",2,0,2,0,0,0,
14-nov-17,N.L.,"MONTERREY, N.L.",1,1,2,0,0,57,
14-nov-17,GRO.,"ATOYAC DE ALVAREZ, GRO.",0,2,2,0,0,0,
15-nov-17,S.L.P.,"CIUDAD VALLES, S.L.P.",2,0,2,2,0,27,
15-nov-17,D.F.,"COYOACAN, D.F.",2,0,2,0,3,0,
15-nov-17,N.L.,"MONTERREY, N.L.",2,0,2,2,0,30,
16-nov-17,N.L.,"MONTERREY, N.L.",1,1,2,8,0,0,
16-nov-17,SIN.,"MAZATLAN, SIN.",1,1,2,0,3,0,
16-nov-17,S.L.P.,"CIUDAD VALLES, S.L.P.",2,0,2,0,0,4,
17-nov-17,B.C.,"MEXICALI, B.C.",1,1,2,0,1,0,
18-nov-17,TAMPS.,"MATAMOROS, TAMPS.",2,0,2,2,0,6,
22-nov-17,GTO.,"CELAYA, GTO.",2,0,2,0,0,0,
24-nov-17,S.L.P.,"SAN LUIS POTOSI, S.L.P.",0,2,2,0,0,0,
25-nov-17,DGO.,"DGO., DGO.",2,0,2,2,0,0,
26-nov-17,TAMPS.,"MATAMOROS, TAMPS.",1,1,2,1,0,0,
28-nov-17,N.L.,"MONTERREY, N.L.",2,0,2,0,0,0,
29-nov-17,N.L.,"MONTERREY, N.L.",1,1,2,0,0,0,
30-nov-17,B.C.,"MEXICALI, B.C.",1,1,2,0,0,0,
30-nov-17,GTO.,"CELAYA, GTO.",2,0,2,0,0,0,
01-dic-17,ZAC.,"ZAC., ZAC.",1,1,2,0,0,0,
01-dic-17,ZAC.,"FRESNILLO, ZAC.",1,1,2,8,0,0,
01-dic-17,S.L.P.,"SAN LUIS POTOSI, S.L.P.",2,0,2,15,0,0,
02-dic-17,ZAC.,"ZAC., ZAC.",1,1,2,0,0,0,
02-dic-17,ZAC.,"FRESNILLO, ZAC.",1,1,2,8,0,0,
04-dic-17,ZAC.,"GUADALUPE, ZAC.",2,0,2,35,0,1350,
05-dic-17,B.C.,"ENSENADA, B.C.",1,1,2,0,0,0,
06-dic-17,N.L.,"MONTERREY, N.L.",1,1,2,0,0,35,
06-dic-17,N.L.,"MONTERREY, N.L.",1,1,2,7,0,13,
08-dic-17,ZAC.,"GUADALUPE, ZAC.",2,0,2,6,0,108,
08-dic-17,JAL.,"PUERTO VALLARTA, JAL.",1,1,2,0,0,0,
09-dic-17,JAL.,"PUERTO VALLARTA, JAL.",1,1,2,0,0,0,
11-dic-17,N.L.,"AGUALEGUAS, N.L.",1,1,2,1,0,0,
11-dic-17,S.L.P.,"CIUDAD VALLES, S.L.P.",2,0,2,8,0,0,
13-dic-17,DGO.,"GOMEZ PALACIO, DGO.",2,0,2,0,0,0,
13-dic-17,ZAC.,"GUADALUPE, ZAC.",2,0,2,33,0,298,
14-dic-17,B.C.,"TIJUANA, B.C.",0,2,2,0,0,0,
14-dic-17,N.L.,"MONTERREY, N.L.",2,0,2,0,0,0,
15-dic-17,B.C.,"TIJUANA, B.C.",1,1,2,0,0,0,
15-dic-17,DGO.,"GOMEZ PALACIO, DGO.",2,0,2,2,0,0,
18-dic-17,HGO.,"TULANCINGO DE BRAVO, HGO.",0,2,2,0,0,182,
18-dic-17,N.L.,"APODACA, N.L.",1,1,2,2,0,66,
19-dic-17,N.L.,"MONTERREY, N.L.",2,0,2,0,0,1730,
21-dic-17,B.C.,"ENSENADA, B.C.",1,1,2,0,0,0,
21-dic-17,N.L.,"AGUALEGUAS, N.L.",2,0,2,1,1,876,
22-dic-17,D.F.,"CUAUHTEMOC, D.F.",1,1,2,0,0,0,
02-ene-18,B.C.,"ENSENADA, B.C.",0,2,2,0,0,0,
07-ene-18,B.C.,"TIJUANA, B.C.",2,0,2,0,0,0,
08-ene-18,COAH.,"SALTILLO, COAH.",1,1,2,0,0,22,
08-ene-18,B.C.,"TIJUANA, B.C.",2,0,2,0,0,0,
09-ene-18,COAH.,"SALTILLO, COAH.",0,2,2,1,0,0,
10-ene-18,B.C.,"TIJUANA, B.C.",2,0,2,0,0,0,
10-ene-18,COAH.,"MONCLOVA, COAH.",2,0,2,1,0,2,
10-ene-18,COAH.,"MÚZQUIZ, COAH.",0,2,2,0,0,0,
11-ene-18,B.C.,"TIJUANA, B.C.",0,2,2,3,0,160,
12-ene-18,COAH.,"TORREÓN, COAH.",0,2,2,0,0,0,
12-ene-18,COAH.,"RAMOS ARIZPE, COAH.",2,0,2,1,0,0,
13-ene-18,COAH.,"MONCLOVA, COAH.",2,0,2,1,0,3,
15-ene-18,COAH.,"TORREÓN, COAH.",1,1,2,1,0,20,
15-ene-18,COAH.,"FRANCISCO I. MADERO, COAH.",1,1,2,1,0,0,
15-ene-18,COAH.,"PIEDRAS NEGRAS, COAH.",1,1,2,0,0,0,
15-ene-18,B.C.,"ENSENADA, B.C.",0,2,2,0,0,0,
16-ene-18,COAH.,"TORREÓN, COAH.",2,0,2,1,0,185,
18-ene-18,COAH.,"TORREÓN, COAH.",2,0,2,0,0,0,
19-ene-18,COAH.,"SAN PEDRO, COAH.",2,0,2,0,0,0,
22-ene-18,COAH.,"TORREÓN, COAH.",2,0,2,0,0,0,
22-ene-18,COAH.,"MÚZQUIZ, COAH.",1,1,2,0,0,0,
23-ene-18,COAH.,"RAMOS ARIZPE, COAH.",2,0,2,1,0,0,
23-ene-18,B.C.,"TIJUANA, B.C.",2,0,2,0,0,0,
23-ene-18,GTO.,"IRAPUATO, GTO.",1,1,2,0,0,1,
24-ene-18,COAH.,"FRANCISCO I. MADERO, COAH.",2,0,2,0,0,0,
24-ene-18,COAH.,"RAMOS ARIZPE, COAH.",1,1,2,0,0,21,
24-ene-18,COAH.,"PIEDRAS NEGRAS, COAH.",1,1,2,0,0,0,
25-ene-18,COAH.,"TORREÓN, COAH.",2,0,2,0,0,0,
25-ene-18,COAH.,"ACUÑA, COAH.",0,2,2,0,0,0,
26-ene-18,COAH.,"TORREÓN, COAH.",1,1,2,1,0,0,
27-ene-18,TAMPS.,"MATAMOROS, TAMPS.",2,0,2,1,0,0,
29-ene-18,ZAC.,"GUADALUPE, ZAC.",2,0,2,29,0,33,
30-ene-18,ZAC.,"ZAC., ZAC.",2,0,2,0,0,0,
30-ene-18,COAH.,"TORREÓN, COAH.",2,0,2,0,1,0,
30-ene-18,COAH.,"SAN PEDRO, COAH.",1,1,2,0,0,0,
30-ene-18,COAH.,"ACUÑA, COAH.",1,1,2,2,0,0,
31-ene-18,ZAC.,"FRESNILLO, ZAC.",2,0,2,36,0,293,
01-feb-18,COAH.,"PIEDRAS NEGRAS, COAH.",2,0,2,1,0,0,
02-feb-18,COAH.,"TORREÓN, COAH.",2,0,2,0,0,0,
02-feb-18,COAH.,"PIEDRAS NEGRAS, COAH.",2,0,2,1,0,0,
03-feb-18,COAH.,"ACUÑA, COAH.",1,1,2,0,0,0,
06-feb-18,COAH.,"TORREÓN, COAH.",2,0,2,1,0,18,
07-feb-18,TAMPS.,"REYNOSA, TAMPS.",0,2,2,0,0,0,
07-feb-18,B.C.,"TIJUANA, B.C.",2,0,2,0,0,0,
08-feb-18,COAH.,"TORREÓN, COAH.",2,0,2,0,0,0,
08-feb-18,COAH.,"PIEDRAS NEGRAS, COAH.",0,2,2,11,0,993,
08-feb-18,COAH.,"NUEVA ROSITA, COAH.",0,2,2,0,1,0,
10-feb-18,DGO.,"GOMEZ PALACIO, DGO.",2,0,2,0,1,0,
12-feb-18,VER.,"SAN RAFAEL, VER.",2,0,2,0,0,20,
12-feb-18,D.F.,"TLAHUAC, D.F.",0,2,2,0,0,0,
12-feb-18,COAH.,"MONCLOVA, COAH.",2,0,2,5,1,69,
13-feb-18,ZAC.,"ZAC., ZAC.",2,0,2,20,0,250,
14-feb-18,SIN.,"CULIACAN, SIN.",2,0,2,0,0,0,
15-feb-18,COAH.,"MONCLOVA, COAH.",2,0,2,1,0,50,
15-feb-18,COAH.,"MÚZQUIZ, COAH.",1,1,2,0,0,0,
15-feb-18,SIN.,"CULIACAN, SIN.",2,0,2,0,0,0,
16-feb-18,COAH.,"PIEDRAS NEGRAS, COAH.",0,2,2,5,0,1156,
17-feb-18,DGO.,"GOMEZ PALACIO, DGO.",2,0,2,0,1,0,
19-feb-18,COAH.,"PIEDRAS NEGRAS, COAH.",1,1,2,3,0,313,
21-feb-18,COAH.,"TORREÓN, COAH.",2,0,2,0,0,0,
21-feb-18,COAH.,"MONCLOVA, COAH.",0,2,2,0,0,0,
21-feb-18,COAH.,"PIEDRAS NEGRAS, COAH.",2,0,2,0,0,230,
21-feb-18,SIN.,"CULIACAN, SIN.",2,0,2,0,0,0,
22-feb-18,COAH.,"TORREÓN, COAH.",2,0,2,0,0,0,
23-feb-18,COAH.,"ACUÑA, COAH.",1,1,2,0,0,0,
24-feb-18,TAMPS.,"MATAMOROS, TAMPS.",2,0,2,4,0,30,
28-feb-18,COAH.,"PIEDRAS NEGRAS, COAH.",1,1,2,0,0,0,
28-feb-18,COAH.,"MÚZQUIZ, COAH.",1,1,2,6,0,0,
28-feb-18,COAH.,"ACUÑA, COAH.",0,2,2,1,0,0,
02-mar-18,DGO.,"GOMEZ PALACIO, DGO.",1,1,2,0,0,0,
05-mar-18,DGO.,"GOMEZ PALACIO, DGO.",2,0,2,0,0,0,
06-mar-18,S.L.P.,"SAN LUIS POTOSI, S.L.P.",2,0,2,1,0,0,
07-mar-18,COAH.,"SALTILLO, COAH.",2,0,2,1,0,24,
07-mar-18,TAMPS.,"NUEVO LAREDO, TAMPS.",0,2,2,0,0,0,
08-mar-18,DGO.,"GOMEZ PALACIO, DGO.",1,1,2,0,0,0,
10-mar-18,DGO.,"GOMEZ PALACIO, DGO.",1,1,2,0,0,0,
12-mar-18,ZAC.,"GUADALUPE, ZAC.",2,0,2,0,0,5,
13-mar-18,COAH.,"TORREÓN, COAH.",2,0,2,0,0,0,
13-mar-18,ZAC.,"ZAC., ZAC.",1,1,2,0,0,14,
14-mar-18,SIN.,"MAZATLAN, SIN.",0,2,2,0,0,0,
14-mar-18,ZAC.,"GUADALUPE, ZAC.",2,0,2,0,0,1,
15-mar-18,QRO.,"EZEQUIEL MONTES, QRO.",1,1,2,0,0,0,
15-mar-18,QRO.,"QUERETARO, QRO.",2,0,2,0,0,23,
16-mar-18,ZAC.,"GUADALUPE, ZAC.",1,1,2,0,0,190,
20-mar-18,QRO.,"QUERETARO, QRO.",2,0,2,0,1,0,
21-mar-18,QRO.,"QUERETARO, QRO.",1,1,2,0,0,0,
21-mar-18,GRO.,"TECPAN DE GALEANA, GRO.",0,2,2,1,0,2,
22-mar-18,COAH.,"ACUÑA, COAH.",0,2,2,0,0,0,
22-mar-18,QRO.,"QUERETARO, QRO.",1,1,2,2,1,0,
23-mar-18,COAH.,"SALTILLO, COAH.",2,0,2,0,0,15,
23-mar-18,COAH.,"ACUÑA, COAH.",0,2,2,0,0,0,
23-mar-18,SIN.,"MAZATLAN, SIN.",2,0,2,0,0,0,
23-mar-18,VER.,"RIO BLANCO, VER.",2,0,2,0,0,12,
26-mar-18,S.L.P.,"SAN LUIS POTOSI, S.L.P.",2,0,2,9,0,0,
27-mar-18,COAH.,"SALTILLO, COAH.",2,0,2,5,1,182,
27-mar-18,COAH.,"MONCLOVA, COAH.",1,1,2,1,0,16,
28-mar-18,VER.,"MARTINEZ DE LA TORRE, VER.",2,0,2,0,0,0,
29-mar-18,S.L.P.,"SAN LUIS POTOSI, S.L.P.",1,1,2,5,0,0,
05-abr-18,TAMPS.,"REYNOSA, TAMPS.",1,1,2,0,0,350,
09-jul-18,SIN.,"SALVADOR ALVARADO, SIN.",2,0,2,0,0,0,
11-jul-18,B.C.,"MEXICALI, B.C.",0,2,2,0,0,0,
18-jul-18,N.L.,"MONTERREY, N.L.",0,2,2,1,0,20,
19-jul-18,GTO.,"IRAPUATO, GTO.",1,1,2,0,0,0,
24-jul-18,GTO.,"IRAPUATO, GTO.",2,0,2,0,2,20,
24-jul-18,GTO.,"CELAYA, GTO.",2,0,2,0,1,108,
25-jul-18,GTO.,"CELAYA, GTO.",1,1,2,0,0,0,
27-jul-18,TLAX.,"TLAX., TLAX.",1,1,2,0,0,0,
29-jul-18,TAB.,"EMILIANO ZAPATA, TAB.",2,0,2,1,0,0,
31-jul-18,B.C.,"TIJUANA, B.C.",2,0,2,0,0,0,
01-ago-18,GTO.,"IRAPUATO, GTO.",2,0,2,0,0,0,
01-ago-18,GTO.,"CELAYA, GTO.",2,0,2,0,0,0,
06-ago-18,MEX.,"ZUMPANGO, MEX.",1,1,2,0,0,0,
07-ago-18,MEX.,"ZUMPANGO, MEX.",2,0,2,0,0,29,
08-ago-18,N.L.,"MONTERREY, N.L.",0,2,2,38,0,185,
08-ago-18,DGO.,"DGO., DGO.",1,1,2,0,0,0,
08-ago-18,GTO.,"CELAYA, GTO.",1,1,2,1,1,1,
08-ago-18,TLAX.,"HUAMANTLA, TLAX.",0,2,2,0,0,0,
08-ago-18,TLAX.,"EL CARMEN TEQUEXQUITLA, TLAX.",2,0,2,0,0,0,
09-ago-18,TLAX.,"EL CARMEN TEQUEXQUITLA, TLAX.",1,1,2,0,0,0,
09-ago-18,COAH.,"SALTILLO, COAH.",2,0,2,1,0,55,
09-ago-18,TAMPS.,"EL MANTE, TAMPS.",2,0,2,0,0,0,
09-ago-18,GTO.,"CELAYA, GTO.",1,1,2,0,0,103,
10-ago-18,TAMPS.,"VICTORIA, TAMPS.",2,0,2,0,0,1039,
10-ago-18,TAMPS.,"TAMPICO, TAMPS.",2,0,2,0,0,0,
10-ago-18,GTO.,"IRAPUATO, GTO.",2,0,2,0,0,0,
10-ago-18,GTO.,"CELAYA, GTO.",1,1,2,0,0,0,
10-ago-18,CHIS.,"TAPACHULA, CHIS.",0,2,2,0,0,193,
10-ago-18,COAH.,"NUEVA ROSITA, COAH.",1,1,2,1,0,0,
10-ago-18,MEX.,"CHALCO, MEX.",0,2,2,0,0,73,
11-ago-18,TAMPS.,"MIER, TAMPS.",1,1,2,0,0,700,
11-ago-18,TLAX.,"HUAMANTLA, TLAX.",1,1,2,0,0,0,
11-ago-18,TAMPS.,"CIUDAD MADERO, TAMPS.",1,1,2,0,0,0,
11-ago-18,TAMPS.,"MIER, TAMPS.",1,1,2,0,0,0,
13-ago-18,CHIS.,"TUXTLA GUTIÉRREZ, CHIS.",1,1,2,1,0,99,
13-ago-18,CHIS.,"TAPACHULA, CHIS.",1,1,2,0,0,95,
14-ago-18,SIN.,"NAVOLATO, SIN.",1,1,2,0,0,0,
14-ago-18,TAMPS.,"CIUDAD MADERO, TAMPS.",1,1,2,0,0,648,
14-ago-18,COAH.,"MONCLOVA, COAH.",2,0,2,0,0,100,
14-ago-18,D.F.,"BENITO JUAREZ, D.F.",0,2,2,0,11,112,
14-ago-18,MEX.,"CHALCO, MEX.",2,0,2,0,0,233,
14-ago-18,CHIS.,"TUXTLA GUTIÉRREZ, CHIS.",1,1,2,0,0,63,
14-ago-18,CHIS.,"TAPACHULA, CHIS.",1,1,2,0,0,0,
15-ago-18,MEX.,"CHALCO, MEX.",2,0,2,0,0,31,
15-ago-18,MEX.,"CUAUTITLAN IZCALLI, MEX.",2,0,2,0,0,0,
16-ago-18,COAH.,"MATAMOROS, COAH.",1,1,2,0,0,0,
16-ago-18,COAH.,"TORREÓN, COAH.",2,0,2,0,0,0,
16-ago-18,COAH.,"TORREÓN, COAH.",1,1,2,0,0,0,
16-ago-18,N.L.,"MONTERREY, N.L.",2,0,2,2,0,0,
16-ago-18,TAMPS.,"MATAMOROS, TAMPS.",2,0,2,0,0,433,
16-ago-18,MEX.,"SAN MATEO ATENCO, MEX.",2,0,2,0,0,0,
16-ago-18,CHIS.,"TAPACHULA, CHIS.",2,0,2,9,1,131,
16-ago-18,TAMPS.,"MAINERO, TAMPS.",2,0,2,0,0,559,
16-ago-18,TAMPS.,"TAMPICO, TAMPS.",2,0,2,0,0,6,
17-ago-18,GTO.,"CELAYA, GTO.",2,0,2,0,0,18,
17-ago-18,TAMPS.,"TAMPICO, TAMPS.",2,0,2,0,0,160,
17-ago-18,TAMPS.,"VICTORIA, TAMPS.",2,0,2,0,0,18,
17-ago-18,TAMPS.,"REYNOSA, TAMPS.",2,0,2,2,0,175,
18-ago-18,VER.,"TUXPAM, VER.",2,0,2,0,0,0,
20-ago-18,COAH.,"SALTILLO, COAH.",1,1,2,1,1,192,
20-ago-18,DGO.,"DGO., DGO.",2,0,2,0,0,0,
20-ago-18,MEX.,"ZACUALPAN, MEX.",1,1,2,0,0,0,
20-ago-18,TAMPS.,"CIUDAD MADERO, TAMPS.",1,1,2,1,0,150,
20-ago-18,TAMPS.,"NUEVO LAREDO, TAMPS.",2,0,2,0,0,122,
21-ago-18,TLAX.,"NATIVITAS, TLAX.",2,0,2,0,0,0,
21-ago-18,B.C.,"TIJUANA, B.C.",0,2,2,0,1,0,
21-ago-18,B.C.,"TIJUANA, B.C.",1,1,2,0,1,0,
22-ago-18,COAH.,"TORREÓN, COAH.",2,0,2,1,0,7,
22-ago-18,MEX.,"TLALNEPANTLA DE BAZ, MEX.",1,1,2,0,0,144,
22-ago-18,TLAX.,"NATIVITAS, TLAX.",1,1,2,0,0,0,
23-ago-18,N.L.,"MONTERREY, N.L.",1,1,2,2,0,363,
23-ago-18,TAMPS.,"MATAMOROS, TAMPS.",2,0,2,0,0,0,
23-ago-18,Q. ROO,"OTHON P. BLANCO, Q. ROO",2,0,2,3,0,403,
24-ago-18,TAMPS.,"TAMPICO, TAMPS.",1,1,2,1,1,35,
25-ago-18,MEX.,"ZACUALPAN, MEX.",1,1,2,0,0,1,
27-ago-18,B.C.,"TIJUANA, B.C.",2,0,2,0,0,0,
27-ago-18,COAH.,"PIEDRAS NEGRAS, COAH.",1,1,2,0,0,0,
27-ago-18,MEX.,"CHICOLOAPAN, MEX.",2,0,2,0,0,0,
28-ago-18,TAMPS.,"VICTORIA, TAMPS.",2,0,2,2,0,0,
28-ago-18,TAMPS.,"NUEVO LAREDO, TAMPS.",2,0,2,2,0,25,
28-ago-18,SIN.,"CHOIX, SIN.",2,0,2,0,0,0,
28-ago-18,VER.,"ALAMO, VER.",2,0,2,0,0,0,
28-ago-18,MEX.,"TLALNEPANTLA DE BAZ, MEX.",2,0,2,1,0,0,
28-ago-18,MEX.,"IXTAPAN DE LA SAL, MEX.",0,2,2,0,0,0,
28-ago-18,TLAX.,"SAN PABLO DEL MONTE, TLAX.",2,0,2,0,0,0,
28-ago-18,MOR.,"TEPOZTLAN, MOR.",2,0,2,45,0,6,
29-ago-18,COAH.,"TORREÓN, COAH.",2,0,2,0,0,16,
29-ago-18,N.L.,"SANTA CATARINA, N.L.",1,1,2,0,0,0,
29-ago-18,TLAX.,"SAN PABLO DEL MONTE, TLAX.",1,1,2,0,0,0,
29-ago-18,COAH.,"PIEDRAS NEGRAS, COAH.",0,2,2,0,0,0,
30-ago-18,TLAX.,"SAN PABLO DEL MONTE, TLAX.",2,0,2,0,0,0,
31-ago-18,TAMPS.,"TAMPICO, TAMPS.",1,1,2,1,0,0,
02-sep-18,TAMPS.,"REYNOSA, TAMPS.",1,1,2,1,0,5,
03-sep-18,TAMPS.,"REYNOSA, TAMPS.",1,1,2,1,0,5,
03-sep-18,AGS.,"AGS., AGS.",2,0,2,0,0,0,
04-sep-18,B.C.,"MEXICALI, B.C.",1,1,2,0,0,0,
04-sep-18,VER.,"BOCA DEL RIO, VER.",2,0,2,0,0,93,
05-sep-18,MEX.,"NEZAHUALCOYOTL, MEX.",2,0,2,0,0,14,
05-sep-18,MEX.,"TOLUCA, MEX.",1,1,2,0,1,382,
05-sep-18,VER.,"XALAPA, VER.",0,2,2,0,0,0,
06-sep-18,COAH.,"PIEDRAS NEGRAS, COAH.",0,2,2,0,0,0,
06-sep-18,AGS.,"AGS., AGS.",1,1,2,1,0,0,
07-sep-18,TAMPS.,"VICTORIA, TAMPS.",2,0,2,2,0,10,
07-sep-18,MEX.,"TOLUCA, MEX.",1,1,2,0,0,3855,
07-sep-18,VER.,"VER., VER.",1,1,2,10,0,279,
07-sep-18,MEX.,"AMECAMECA, MEX.",2,0,2,0,0,49,
08-sep-18,VER.,"XALAPA, VER.",2,0,2,12,0,35,
08-sep-18,B.C.,"TIJUANA, B.C.",2,0,2,0,0,0,
10-sep-18,MOR.,"CUERNAVACA, MOR.",2,0,2,0,0,172,
11-sep-18,MOR.,"CUERNAVACA, MOR.",2,0,2,2,0,0,
11-sep-18,COAH.,"TORREÓN, COAH.",1,1,2,0,0,0,
11-sep-18,ZAC.,"FRESNILLO, ZAC.",2,0,2,0,0,239,
12-sep-18,MOR.,"TEPOZTLAN, MOR.",1,1,2,0,0,21,
12-sep-18,MOR.,"CUERNAVACA, MOR.",2,0,2,0,7,751,
13-sep-18,TAMPS.,"VICTORIA, TAMPS.",2,0,2,0,0,0,
14-sep-18,D.F.,"XOCHIMILCO, D.F.",1,1,2,0,0,0,
14-sep-18,B.C.,"TIJUANA, B.C.",0,2,2,0,0,0,
14-sep-18,ZAC.,"GUADALUPE, ZAC.",0,2,2,0,0,0,
17-sep-18,MEX.,"TOLUCA, MEX.",2,0,2,1,0,3546,
17-sep-18,CHIH.,"DELICIAS, CHIH.",1,1,2,0,0,50,
18-sep-18,MEX.,"TOLUCA, MEX.",2,0,2,0,0,5,
20-sep-18,ZAC.,"GUADALUPE, ZAC.",2,0,2,2,0,14,
20-sep-18,MOR.,"TETELA DEL VOLCAN, MOR.",0,2,2,0,0,0,
21-sep-18,MOR.,"TETELA DEL VOLCAN, MOR.",1,1,2,0,0,0,
22-sep-18,B.C.,"MEXICALI, B.C.",1,1,2,0,0,0,
22-sep-18,S.L.P.,"SAN LUIS POTOSI, S.L.P.",2,0,2,0,0,0,
23-sep-18,N.L.,"MELCHOR OCAMPO, N.L.",2,0,2,0,0,0,
24-sep-18,MOR.,"CUERNAVACA, MOR.",1,1,2,0,0,1472,
25-sep-18,MEX.,"RAYON, MEX.",2,0,2,1,0,0,
25-sep-18,MEX.,"ECATEPEC DE MOR., MEX.",2,0,2,0,1,5058,
26-sep-18,VER.,"POZA RICA DE HGO., VER.",0,2,2,0,0,92,
27-sep-18,MEX.,"RAYON, MEX.",1,1,2,0,0,0,
28-sep-18,VER.,"POZA RICA DE HGO., VER.",0,2,2,0,0,92,
01-oct-18,AGS.,"AGS., AGS.",2,0,2,0,0,0,
03-oct-18,DGO.,"GOMEZ PALACIO, DGO.",1,1,2,0,0,0,
03-oct-18,GTO.,"LEON, GTO.",2,0,2,0,0,0,
04-oct-18,AGS.,"AGS., AGS.",2,0,2,0,0,3,
05-oct-18,MEX.,"LERMA, MEX.",1,1,2,0,0,4124,
05-oct-18,AGS.,"AGS., AGS.",1,1,2,0,0,513,
06-oct-18,S.L.P.,"SAN LUIS POTOSI, S.L.P.",2,0,2,0,0,0,
06-oct-18,MEX.,"LERMA, MEX.",1,1,2,1,0,0,
06-oct-18,MEX.,"IXTAPALUCA, MEX.",2,0,2,2,0,50,
08-oct-18,COAH.,"SAN PEDRO, COAH.",1,1,2,0,0,0,
08-oct-18,MEX.,"VILLA VICTORIA, MEX.",2,0,2,0,0,2,
08-oct-18,S.L.P.,"SAN LUIS POTOSI, S.L.P.",2,0,2,0,0,0,
09-oct-18,COAH.,"PIEDRAS NEGRAS, COAH.",1,1,2,0,0,0,
09-oct-18,S.L.P.,"SAN LUIS POTOSI, S.L.P.",1,1,2,5,0,919,
10-oct-18,B.C.,"TIJUANA, B.C.",0,2,2,0,0,0,
10-oct-18,COAH.,"PIEDRAS NEGRAS, COAH.",0,2,2,0,0,300,
11-oct-18,MEX.,"TEPOTZOTLAN, MEX.",1,1,2,1,0,1818,
12-oct-18,MEX.,"TEPOTZOTLAN, MEX.",2,0,2,1,0,3763,
15-oct-18,B.C.,"TIJUANA, B.C.",0,2,2,0,0,0,
15-oct-18,S.L.P.,"SAN LUIS POTOSI, S.L.P.",1,1,2,0,0,0,
15-oct-18,S.L.P.,"MATEHUALA, S.L.P.",2,0,2,0,0,0,
16-oct-18,MEX.,"NAUCALPAN DE JUAREZ, MEX.",1,1,2,0,0,25,
16-oct-18,DGO.,"GOMEZ PALACIO, DGO.",2,0,2,0,0,0,
16-oct-18,COAH.,"PIEDRAS NEGRAS, COAH.",2,0,2,0,0,0,
17-oct-18,MEX.,"NAUCALPAN DE JUAREZ, MEX.",2,0,2,10,0,10,
17-oct-18,MEX.,"ATIZAPAN, MEX.",2,0,2,141,0,0,
17-oct-18,SIN.,"ROSARIO, SIN.",2,0,2,0,0,0,
18-oct-18,MEX.,"HUEHUETOCA, MEX.",1,1,2,0,11,0,
18-oct-18,S.L.P.,"MATEHUALA, S.L.P.",1,1,2,0,0,0,
18-oct-18,SIN.,"ROSARIO, SIN.",0,2,2,0,0,0,
19-oct-18,B.C.,"TIJUANA, B.C.",0,2,2,0,0,0,
22-oct-18,GTO.,"LEON, GTO.",1,1,2,0,4,0,
22-oct-18,ZAC.,"FRESNILLO, ZAC.",1,1,2,0,0,1006,
22-oct-18,B.C.,"TIJUANA, B.C.",0,2,2,0,0,0,
22-oct-18,D.F.,"VENUSTIANO CARRANZA, D.F.",2,0,2,0,0,0,
22-oct-18,B.C.,"TIJUANA, B.C.",0,2,2,0,0,0,
23-oct-18,B.C.,"TIJUANA, B.C.",0,2,2,0,0,0,
23-oct-18,B.C.,"TIJUANA, B.C.",0,2,2,0,0,0,
23-oct-18,COAH.,"ACUÑA, COAH.",0,2,2,0,0,0,
23-oct-18,ZAC.,"GUADALUPE, ZAC.",1,1,2,2,0,0,
24-oct-18,COAH.,"PIEDRAS NEGRAS, COAH.",0,2,2,0,0,0,
25-oct-18,S.L.P.,"SAN LUIS POTOSI, S.L.P.",2,0,2,0,0,0,
25-oct-18,MEX.,"TECAMAC, MEX.",2,0,2,0,0,115,
25-oct-18,MEX.,"LA PAZ, MEX.",1,1,2,0,0,0,
26-oct-18,ZAC.,"GUADALUPE, ZAC.",2,0,2,8,0,50,
26-oct-18,MEX.,"LA PAZ, MEX.",2,0,2,2,12,163,
27-oct-18,COAH.,"MÚZQUIZ, COAH.",1,1,2,0,0,315,
30-oct-18,COAH.,"PIEDRAS NEGRAS, COAH.",0,2,2,0,0,0,
30-oct-18,D.F.,"COYOACAN, D.F.",2,0,2,0,0,1087,
31-oct-18,MEX.,"XONACATLAN, MEX.",2,0,2,0,0,0,
01-nov-18,CHIH.,"JUÁREZ, CHIH.",1,1,2,1,0,263,
01-nov-18,MEX.,"XONACATLAN, MEX.",0,2,2,0,0,56,
01-nov-18,MEX.,"TECAMAC, MEX.",2,0,2,0,0,0,
02-nov-18,MEX.,"TECAMAC, MEX.",2,0,2,1,0,50,
07-nov-18,CHIH.,"JUÁREZ, CHIH.",1,1,2,0,0,339,
08-nov-18,CHIH.,"JUÁREZ, CHIH.",2,0,2,5,0,240,
08-nov-18,COAH.,"TORREÓN, COAH.",1,1,2,0,0,0,
10-nov-18,COAH.,"MÚZQUIZ, COAH.",2,0,2,0,0,0,
12-nov-18,MEX.,"EL ORO, MEX.",0,2,2,0,0,0,
14-nov-18,MEX.,"EL ORO, MEX.",0,2,2,1,0,0,
15-nov-18,D.F.,"CUAJIMALPA DE MOR., D.F.",2,0,2,0,0,0,
16-nov-18,MEX.,"TEPETLAOXTOC, MEX.",2,0,2,0,0,1277,
16-nov-18,S.L.P.,"SAN LUIS POTOSI, S.L.P.",2,0,2,0,0,0,
17-nov-18,MEX.,"EL ORO, MEX.",2,0,2,1,0,0,
19-nov-18,CHIH.,"JUÁREZ, CHIH.",1,1,2,5,0,658,
20-nov-18,MEX.,"TENANGO DEL VALLE, MEX.",2,0,2,0,0,0,
21-nov-18,MEX.,"TENANGO DEL VALLE, MEX.",2,0,2,0,15,0,
21-nov-18,COAH.,"PIEDRAS NEGRAS, COAH.",1,1,2,0,0,150,
23-nov-18,TAMPS.,"ALTAMIRA, TAMPS.",2,0,2,1,0,0,
23-nov-18,MEX.,"TENANGO DEL VALLE, MEX.",2,0,2,1,0,0,
24-nov-18,COAH.,"PIEDRAS NEGRAS, COAH.",1,1,2,1,0,0,
03-dic-18,SIN.,"ANGOSTURA, SIN.",2,0,2,0,5,0,
05-dic-18,SIN.,"MAZATLAN, SIN.",2,0,2,0,0,0,
07-dic-18,B.C.,"MEXICALI, B.C.",1,1,2,0,0,0,
10-dic-18,SIN.,"CULIACAN, SIN.",1,1,2,0,0,0,
13-dic-18,S.L.P.,"SAN LUIS POTOSI, S.L.P.",1,1,2,0,0,0,
13-dic-18,SIN.,"MAZATLAN, SIN.",2,0,2,0,0,0,
13-dic-18,SIN.,"BADIRAGUATO, SIN.",2,0,2,0,0,0,
17-dic-18,SIN.,"BADIRAGUATO, SIN.",1,1,2,0,1,0,
18-dic-18,SIN.,"MAZATLAN, SIN.",2,0,2,0,0,0,
18-dic-18,TAMPS.,"TAMPICO, TAMPS.",2,0,2,0,0,0,
19-dic-18,SIN.,"MAZATLAN, SIN.",1,1,2,0,0,0,
19-dic-18,B.C.,"TIJUANA, B.C.",1,1,2,0,0,0,
22-dic-18,TAB.,"EMILIANO ZAPATA, TAB.",1,1,2,0,0,0,
25-ene-19,CAMP.,"ESCÁRCEGA, CAMP.",1,1,2,0,0,0,
27-ene-19,HGO.,"TEZONTEPEC DE ALDAMA, HGO.",0,2,2,0,0,0,
28-ene-19,COAH.,"PIEDRAS NEGRAS, COAH.",0,2,2,0,0,67,
01-feb-19,COAH.,"PIEDRAS NEGRAS, COAH.",0,2,2,0,0,256,
11-feb-19,GRO.,"COYUCA DE CATALAN, GRO.",0,2,2,0,0,2396,
20-feb-19,ZAC.,"ZAC., ZAC.",1,1,2,0,1,0,
22-feb-19,COAH.,"PIEDRAS NEGRAS, COAH.",2,0,2,0,0,0,
25-feb-19,ZAC.,"GUADALUPE, ZAC.",2,0,2,16,1,335,
26-feb-19,ZAC.,"ZAC., ZAC.",0,2,2,0,0,0,
27-feb-19,ZAC.,"GUADALUPE, ZAC.",2,0,2,7,0,80,
27-feb-19,COAH.,"PIEDRAS NEGRAS, COAH.",0,2,2,0,0,300,
27-feb-19,DGO.,"GOMEZ PALACIO, DGO.",2,0,2,0,0,0,
28-feb-19,GTO.,"SAN LUIS DE LA PAZ, GTO.",1,1,2,0,0,0,
01-mar-19,DGO.,"GOMEZ PALACIO, DGO.",2,0,2,0,0,0,
03-mar-19,CHIS.,"TAPACHULA, CHIS.",2,0,2,0,0,114,
07-mar-19,GTO.,"SAN LUIS DE LA PAZ, GTO.",2,0,2,0,0,0,
08-mar-19,GTO.,"SAN LUIS DE LA PAZ, GTO.",1,1,2,0,0,0,
08-mar-19,ZAC.,"FRESNILLO, ZAC.",1,1,2,3,0,3000,
09-mar-19,CHIS.,"TAPACHULA, CHIS.",2,0,2,0,0,300,
12-mar-19,COAH.,"MATAMOROS, COAH.",1,1,2,4,0,0,
12-mar-19,COAH.,"TORREÓN, COAH.",2,0,2,0,0,0,
12-mar-19,ZAC.,"GUADALUPE, ZAC.",2,0,2,29,0,960,
13-mar-19,ZAC.,"ZAC., ZAC.",2,0,2,3,0,0,
14-mar-19,COAH.,"FRANCISCO I. MADERO, COAH.",2,0,2,0,0,0,
15-mar-19,ZAC.,"ZAC., ZAC.",0,2,2,0,0,0,
19-mar-19,S.L.P.,"SOLEDAD DE GRACIANO SANCHEZ, S.L.P.",2,0,2,4,0,0,
19-mar-19,COAH.,"FRANCISCO I. MADERO, COAH.",1,1,2,0,0,0,
20-mar-19,S.L.P.,"SOLEDAD DE GRACIANO SANCHEZ, S.L.P.",0,2,2,0,0,0,
20-mar-19,S.L.P.,"SAN LUIS POTOSI, S.L.P.",2,0,2,2,9,0,
21-mar-19,COAH.,"MATAMOROS, COAH.",0,2,2,0,0,0,
21-mar-19,S.L.P.,"SAN LUIS POTOSI, S.L.P.",1,1,2,4,0,0,
22-mar-19,S.L.P.,"SOLEDAD DE GRACIANO SANCHEZ, S.L.P.",1,1,2,0,4,0,
23-mar-19,COAH.,"ACUÑA, COAH.",0,2,2,0,0,150,
26-mar-19,S.L.P.,"SAN LUIS POTOSI, S.L.P.",1,1,2,0,1,0,
27-mar-19,S.L.P.,"CIUDAD VALLES, S.L.P.",2,0,2,4,0,0,
28-mar-19,COAH.,"SALTILLO, COAH.",1,1,2,0,0,253,
28-mar-19,COAH.,"MONCLOVA, COAH.",1,1,2,0,0,88,
29-mar-19,JAL.,"CIHUATLAN, JAL.",1,1,2,0,1,0,
31-mar-19,S.L.P.,"SAN LUIS POTOSI, S.L.P.",1,1,2,0,3,0,
01-abr-19,S.L.P.,"SAN LUIS POTOSI, S.L.P.",2,0,2,5,0,0,
02-abr-19,CD. MÉX.,"XOCHIMILCO, CD. MÉX.",1,1,2,0,0,32,
03-abr-19,CD. MÉX.,"IZTAPALAPA, CD. MÉX.",2,0,2,0,0,23,
08-abr-19,CD. MÉX.,"IZTAPALAPA, CD. MÉX.",1,1,2,0,0,100,
10-abr-19,ZAC.,"GUADALUPE, ZAC.",1,1,2,0,0,0,
11-abr-19,CD. MÉX.,"IZTAPALAPA, CD. MÉX.",2,0,2,0,0,50,
15-abr-19,CD. MÉX.,"ALVARO OBREGON, CD. MÉX.",1,1,2,0,0,89,
22-abr-19,S.L.P.,"CIUDAD VALLES, S.L.P.",2,0,2,3,0,0,
30-abr-19,CD. MÉX.,"ALVARO OBREGON, CD. MÉX.",1,1,2,0,1,47,
30-abr-19,COAH.,"ACUÑA, COAH.",0,2,2,0,0,0,
09-may-19,CD. MÉX.,"AZCAPOTZALCO, CD. MÉX.",1,1,2,0,0,158,
10-may-19,CD. MÉX.,"TLALPAN, CD. MÉX.",2,0,2,0,0,672,
13-may-19,CD. MÉX.,"IZTAPALAPA, CD. MÉX.",2,0,2,0,0,84,
14-may-19,CD. MÉX.,"AZCAPOTZALCO, CD. MÉX.",0,2,2,0,0,1113,
15-may-19,ZAC.,"GUADALUPE, ZAC.",2,0,2,3,0,33,
16-may-19,CHIH.,"JUÁREZ, CHIH.",2,0,2,23,0,270,
17-may-19,CD. MÉX.,"AZCAPOTZALCO, CD. MÉX.",2,0,2,0,0,375,
21-may-19,ZAC.,"FRESNILLO, ZAC.",2,0,2,2,0,0,
24-may-19,CD. MÉX.,"MILPA ALTA, CD. MÉX.",2,0,2,0,1,25,
27-may-19,CD. MÉX.,"MILPA ALTA, CD. MÉX.",0,2,2,0,0,70,
27-may-19,COAH.,"SALTILLO, COAH.",0,2,2,4,0,397,
27-may-19,COAH.,"RAMOS ARIZPE, COAH.",1,1,2,1,0,18,
28-may-19,COAH.,"PIEDRAS NEGRAS, COAH.",0,2,2,0,0,0,
30-may-19,CD. MÉX.,"MILPA ALTA, CD. MÉX.",2,0,2,0,0,45,
31-may-19,MÉX.,"ECATEPEC DE MOR., MEX.",2,0,2,0,0,0,
03-jun-19,CD. MÉX.,"IZTAPALAPA, CD. MÉX.",1,1,2,0,0,60,
07-jun-19,ZAC.,"FRESNILLO, ZAC.",2,0,2,0,0,0,
07-jun-19,DGO.,"GOMEZ PALACIO, DGO.",2,0,2,0,0,0,
08-jun-19,QRO.,"SAN JUAN DEL RIO, QRO.",0,2,2,0,0,0,
10-jun-19,ZAC.,"FRESNILLO, ZAC.",1,1,2,1,0,6,
13-jun-19,DGO.,"DGO., DGO.",2,0,2,0,0,0,
15-jun-19,QRO.,"JALPAN DE SERRA, QRO.",1,1,2,0,0,0,
19-jun-19,DGO.,"DGO., DGO.",1,1,2,0,0,0,
20-jun-19,VER.,"MINATITLAN, VER.",1,1,2,1,0,24,
21-jun-19,COAH.,"PIEDRAS NEGRAS, COAH.",2,0,2,0,0,0,
23-jun-19,QRO.,"PINAL DE AMOLES, QRO.",2,0,2,0,0,0,
25-jun-19,CD. MÉX.,"IZTAPALAPA, CD. MÉX.",2,0,2,0,0,682,
26-jun-19,CD. MÉX.,"IZTAPALAPA, CD. MÉX.",0,2,2,0,0,11,
26-jun-19,CD. MÉX.,"TLAHUAC, CD. MÉX.",1,1,2,0,0,1631,
27-jun-19,CD. MÉX.,"XOCHIMILCO, CD. MÉX.",1,1,2,0,0,0,
01-jul-19,CD. MÉX.,"XOCHIMILCO, CD. MÉX.",1,1,2,0,0,177,
02-jul-19,CD. MÉX.,"MILPA ALTA, CD. MÉX.",0,2,2,0,0,1272,
02-jul-19,COAH.,"SAN PEDRO, COAH.",0,2,2,1,0,6,
03-jul-19,CD. MÉX.,"XOCHIMILCO, CD. MÉX.",2,0,2,0,1,68,
03-jul-19,CD. MÉX.,"MILPA ALTA, CD. MÉX.",0,2,2,0,0,0,
03-jul-19,DGO.,"DGO., DGO.",1,1,2,0,0,0,
04-jul-19,AGS.,"AGS., AGS.",2,0,2,3,0,39,
04-jul-19,ZAC.,"FRESNILLO, ZAC.",0,2,2,0,0,0,
05-jul-19,ZAC.,"FRESNILLO, ZAC.",2,0,2,0,0,0,
05-jul-19,CD. MÉX.,"IZTAPALAPA, CD. MÉX.",2,0,2,0,0,118,
05-jul-19,CD. MÉX.,"MILPA ALTA, CD. MÉX.",1,1,2,0,0,0,
08-jul-19,AGS.,"AGS., AGS.",1,1,2,3,0,178,
09-jul-19,ZAC.,"FRESNILLO, ZAC.",2,0,2,0,0,0,
09-jul-19,CD. MÉX.,"IZTAPALAPA, CD. MÉX.",2,0,2,0,0,0,
10-jul-19,COAH.,"FRANCISCO I. MADERO, COAH.",1,1,2,0,0,0,
10-jul-19,AGS.,"AGS., AGS.",2,0,2,0,0,0,
11-jul-19,ZAC.,"FRESNILLO, ZAC.",2,0,2,1,0,161,
11-jul-19,CD. MÉX.,"TLAHUAC, CD. MÉX.",2,0,2,0,0,0,
15-jul-19,AGS.,"AGS., AGS.",0,2,2,0,0,0,
15-jul-19,CD. MÉX.,"IZTAPALAPA, CD. MÉX.",2,0,2,0,0,0,
15-jul-19,CD. MÉX.,"CUAJIMALPA DE MOR., CD. MÉX.",2,0,2,0,1,7,
16-jul-19,NAY.,"TEPIC, NAY.",2,0,2,0,0,0,
17-jul-19,CD. MÉX.,"IZTAPALAPA, CD. MÉX.",2,0,2,0,0,64,
18-jul-19,ZAC.,"GUADALUPE, ZAC.",2,0,2,5,0,140,
18-jul-19,CD. MÉX.,"TLAHUAC, CD. MÉX.",1,1,2,0,0,0,
22-jul-19,CD. MÉX.,"CUAJIMALPA DE MOR., CD. MÉX.",2,0,2,0,0,0,
23-jul-19,CD. MÉX.,"TLAHUAC, CD. MÉX.",2,0,2,0,0,20,
24-jul-19,CD. MÉX.,"IZTAPALAPA, CD. MÉX.",1,1,2,0,0,2,
24-jul-19,JAL.,"SAYULA, JAL.",2,0,2,0,0,0,
25-jul-19,NAY.,"XALISCO, NAY.",2,0,2,0,0,0,
26-jul-19,CD. MÉX.,"IZTAPALAPA, CD. MÉX.",2,0,2,0,0,100,
29-jul-19,CD. MÉX.,"BENITO JUAREZ, CD. MÉX.",1,1,2,0,0,50,
30-jul-19,COAH.,"FRANCISCO I. MADERO, COAH.",2,0,2,0,0,0,
30-jul-19,MOR.,"CUERNAVACA, MOR.",1,1,2,0,0,364,
30-jul-19,CHIH.,"NUEVO CASAS GRANDES, CHIH.",2,0,2,0,0,707,
01-ago-19,COAH.,"FRANCISCO I. MADERO, COAH.",2,0,2,0,0,0,
01-ago-19,CD. MÉX.,"BENITO JUAREZ, CD. MÉX.",1,1,2,0,0,1000,
01-ago-19,NAY.,"COMPOSTELA, NAY.",2,0,2,0,0,0,
02-ago-19,JAL.,"SAYULA, JAL.",2,0,2,0,0,0,
06-ago-19,QRO.,"QUERETARO, QRO.",2,0,2,0,1,0,
07-ago-19,MOR.,"CUERNAVACA, MOR.",2,0,2,0,0,1785,
08-ago-19,MOR.,"CUERNAVACA, MOR.",2,0,2,0,0,706,
08-ago-19,MÉX.,"COACALCO DE BERRIOZABAL, MEX.",2,0,2,0,0,18,
08-ago-19,CHIH.,"NUEVO CASAS GRANDES, CHIH.",1,1,2,0,0,47,
09-ago-19,QRO.,"QUERETARO, QRO.",1,1,2,0,0,0,
09-ago-19,AGS.,"ASIENTOS, AGS.",1,1,2,4,1,250,
09-ago-19,MOR.,"CUERNAVACA, MOR.",2,0,2,5,0,1246,
09-ago-19,CHIH.,"NUEVO CASAS GRANDES, CHIH.",2,0,2,0,0,707,
14-ago-19,MOR.,"CUERNAVACA, MOR.",2,0,2,1,0,1013,
14-ago-19,CD. MÉX.,"GUSTAVO A. MADERO, CD. MÉX.",2,0,2,0,0,152,
15-ago-19,MÉX.,"COACALCO DE BERRIOZABAL, MEX.",2,0,2,0,0,2,
15-ago-19,MOR.,"CUERNAVACA, MOR.",2,0,2,19,1,0,
15-ago-19,NAY.,"ACAPONETA, NAY.",2,0,2,0,0,0,
15-ago-19,NAY.,"TEPIC, NAY.",0,2,2,0,0,0,
15-ago-19,ZAC.,"FRESNILLO, ZAC.",2,0,2,0,0,30,
16-ago-19,AGS.,"TEPEZALÁ, AGS.",2,0,2,11,0,0,
16-ago-19,MOR.,"CUERNAVACA, MOR.",1,1,2,25,1,444,
16-ago-19,CD. MÉX.,"ALVARO OBREGON, CD. MÉX.",1,1,2,0,0,36,
17-ago-19,S.L.P.,"SAN LUIS POTOSI, S.L.P.",2,0,2,0,2,41,
17-ago-19,MÉX.,"AMECAMECA, MEX.",2,0,2,0,0,0,
19-ago-19,S.L.P.,"SAN LUIS POTOSI, S.L.P.",2,0,2,0,0,0,
19-ago-19,MOR.,"TEPOZTLAN, MOR.",2,0,2,0,0,0,
19-ago-19,MÉX.,"AXAPUSCO, MEX.",0,2,2,0,0,44,
20-ago-19,MOR.,"CUERNAVACA, MOR.",2,0,2,0,0,19,
20-ago-19,CD. MÉX.,"ALVARO OBREGON, CD. MÉX.",2,0,2,0,0,323,
20-ago-19,CHIH.,"NUEVO CASAS GRANDES, CHIH.",1,1,2,1,0,0,
20-ago-19,VER.,"LAS CHOAPAS, VER.",0,2,2,0,0,0,
20-ago-19,TLAX.,"TLAX., TLAX.",1,1,2,1,0,0,
21-ago-19,VER.,"LAS CHOAPAS, VER.",2,0,2,1,0,0,
22-ago-19,TLAX.,"TLAX., TLAX.",1,1,2,0,0,0,
22-ago-19,GTO.,"IRAPUATO, GTO.",2,0,2,0,1,0,
22-ago-19,TAMPS.,"VICTORIA, TAMPS.",1,1,2,0,0,0,
23-ago-19,JAL.,"SAYULA, JAL.",1,1,2,2,0,25,
23-ago-19,GTO.,"IRAPUATO, GTO.",1,1,2,0,0,0,
23-ago-19,MOR.,"CUERNAVACA, MOR.",2,0,2,2,0,1200,
23-ago-19,MÉX.,"AXAPUSCO, MEX.",0,2,2,0,0,0,
24-ago-19,TAMPS.,"VICTORIA, TAMPS.",2,0,2,0,0,0,
24-ago-19,TAMPS.,"MATAMOROS, TAMPS.",1,1,2,0,0,0,
25-ago-19,S.L.P.,"SAN LUIS POTOSI, S.L.P.",2,0,2,0,0,0,
26-ago-19,MÉX.,"TECAMAC, MEX.",2,0,2,0,24,228,
26-ago-19,S.L.P.,"SAN LUIS POTOSI, S.L.P.",2,0,2,0,0,0,
26-ago-19,QRO.,"QUERETARO, QRO.",1,1,2,0,0,0,
26-ago-19,TAMPS.,"MATAMOROS, TAMPS.",0,2,2,0,0,197,
26-ago-19,TLAX.,"HUAMANTLA, TLAX.",2,0,2,0,0,0,
26-ago-19,MÉX.,"TLALNEPANTLA DE BAZ, MEX.",2,0,2,0,0,0,
27-ago-19,CD. MÉX.,"IZTAPALAPA, CD. MÉX.",2,0,2,0,0,25,
27-ago-19,QRO.,"QUERETARO, QRO.",1,1,2,0,0,0,
27-ago-19,MÉX.,"TECAMAC, MEX.",0,2,2,0,29,173,
28-ago-19,TLAX.,"APIZACO, TLAX.",1,1,2,0,0,0,
28-ago-19,CD. MÉX.,"MIGUEL HGO., CD. MÉX.",1,1,2,0,0,18,
28-ago-19,TAMPS.,"MATAMOROS, TAMPS.",1,1,2,0,0,0,
28-ago-19,MÉX.,"TECAMAC, MEX.",2,0,2,2,0,0,
29-ago-19,MÉX.,"ATLACOMULCO, MEX.",1,1,2,0,0,0,
29-ago-19,MÉX.,"JUCHITEPEC, MEX.",2,0,2,0,10,0,
29-ago-19,TAMPS.,"REYNOSA, TAMPS.",1,1,2,34,0,41,
30-ago-19,S.L.P.,"TANQUIAN DE ESCOBEDO, S.L.P.",2,0,2,0,0,0,
31-ago-19,MÉX.,"TLALNEPANTLA DE BAZ, MEX.",2,0,2,1,0,11,
31-ago-19,MÉX.,"JUCHITEPEC, MEX.",2,0,2,1,30,0,
02-sep-19,GTO.,"IRAPUATO, GTO.",1,1,2,0,0,0,
03-sep-19,TAMPS.,"MATAMOROS, TAMPS.",1,1,2,5,0,1,
04-sep-19,GTO.,"IRAPUATO, GTO.",2,0,2,0,0,0,
05-sep-19,TAMPS.,"REYNOSA, TAMPS.",1,1,2,2,0,21,
05-sep-19,GTO.,"IRAPUATO, GTO.",2,0,2,0,0,0,
09-sep-19,TAMPS.,"MATAMOROS, TAMPS.",0,2,2,1,1,52,
11-sep-19,MOR.,"CUERNAVACA, MOR.",2,0,2,13,0,0,
12-sep-19,TAMPS.,"REYNOSA, TAMPS.",2,0,2,0,0,0,
13-sep-19,CD. MÉX.,"LA MAGDALENA CONTRERAS, CD. MÉX.",1,1,2,0,0,0,
13-sep-19,MOR.,"CUERNAVACA, MOR.",2,0,2,4,0,11,
14-sep-19,MÉX.,"NEZAHUALCOYOTL, MEX.",2,0,2,2,0,4,
18-sep-19,CD. MÉX.,"COYOACAN, CD. MÉX.",2,0,2,0,0,4361,
18-sep-19,CD. MÉX.,"IZTAPALAPA, CD. MÉX.",0,2,2,0,0,20,
18-sep-19,MÉX.,"CHICOLOAPAN, MEX.",2,0,2,0,0,13,
19-sep-19,TLAX.,"TLAXCO, TLAX.",2,0,2,0,0,0,
20-sep-19,MÉX.,"CHICOLOAPAN, MEX.",2,0,2,0,0,17,
21-sep-19,MÉX.,"TIANGUISTENCO, MEX.",2,0,2,0,0,1947,
21-sep-19,MÉX.,"NEZAHUALCOYOTL, MEX.",2,0,2,1,1,1017,
21-sep-19,MÉX.,"TENANGO DEL VALLE, MEX.",1,1,2,0,0,0,
23-sep-19,COL.,"COL., COL.",0,2,2,0,0,0,
23-sep-19,MOR.,"EMILIANO ZAPATA, MOR.",1,1,2,2,0,345,
24-sep-19,CD. MÉX.,"TLALPAN, CD. MÉX.",2,0,2,0,0,35,
24-sep-19,CD. MÉX.,"LA MAGDALENA CONTRERAS, CD. MÉX.",2,0,2,0,0,200,
24-sep-19,COL.,"COL., COL.",0,2,2,0,0,0,
25-sep-19,CD. MÉX.,"LA MAGDALENA CONTRERAS, CD. MÉX.",2,0,2,0,0,116,
25-sep-19,COL.,"COL., COL.",0,2,2,0,0,0,
26-sep-19,MÉX.,"HUEHUETOCA, MEX.",2,0,2,0,3,153,
26-sep-19,CHIS.,"TAPACHULA, CHIS.",2,0,2,2,0,295,
27-sep-19,COL.,"COL., COL.",1,1,2,0,0,37,
27-sep-19,MÉX.,"HUEHUETOCA, MEX.",2,0,2,0,0,43,
27-sep-19,CHIS.,"SAN CRISTOBAL DE LAS CASAS, CHIS.",1,1,2,1,0,616,
30-sep-19,MÉX.,"ZUMPANGO, MEX.",2,0,2,2,0,13,
01-oct-19,MÉX.,"METEPEC, MEX.",2,0,2,2,0,5,
03-oct-19,MÉX.,"ZUMPANGO, MEX.",2,0,2,0,0,3,
03-oct-19,TAMPS.,"MATAMOROS, TAMPS.",0,2,2,0,0,0,
04-oct-19,TAMPS.,"TAMPICO, TAMPS.",2,0,2,0,0,0,
04-oct-19,CD. MÉX.,"TLALPAN, CD. MÉX.",0,2,2,0,0,0,
05-oct-19,TAMPS.,"REYNOSA, TAMPS.",2,0,2,1,0,21,
07-oct-19,TAMPS.,"REYNOSA, TAMPS.",1,1,2,0,0,81,
09-oct-19,CD. MÉX.,"IZTAPALAPA, CD. MÉX.",2,0,2,0,0,341,
10-oct-19,MOR.,"EMILIANO ZAPATA, MOR.",2,0,2,2,0,0,
11-oct-19,ZAC.,"FRESNILLO, ZAC.",2,0,2,0,0,0,
11-oct-19,TLAX.,"PAPALOTLA DE XICOHTENCATL, TLAX.",2,0,2,0,0,0,
14-oct-19,MÉX.,"TEMOAYA, MEX.",1,1,2,0,0,0,
16-oct-19,CD. MÉX.,"CUAJIMALPA DE MOR., CD. MÉX.",2,0,2,0,0,153,
16-oct-19,CD. MÉX.,"IZTACALCO, CD. MÉX.",2,0,2,0,5,0,
16-oct-19,MÉX.,"TEMOAYA, MEX.",1,1,2,0,0,0,
16-oct-19,MÉX.,"ZINACANTEPEC, MEX.",0,2,2,0,0,34,
17-oct-19,CD. MÉX.,"IZTAPALAPA, CD. MÉX.",2,0,2,0,1,50,
19-oct-19,MÉX.,"TEMOAYA, MEX.",2,0,2,0,0,0,
19-oct-19,MÉX.,"ZINACANTEPEC, MEX.",1,1,2,0,10,2316,
19-oct-19,MÉX.,"IXTAPALUCA, MEX.",2,0,2,0,0,45,
19-oct-19,MÉX.,"TENANGO DEL AIRE, MEX.",0,2,2,0,0,0,
21-oct-19,MÉX.,"CHALCO, MEX.",2,0,2,0,0,86,
22-oct-19,ZAC.,"ZAC., ZAC.",1,1,2,0,0,101,
22-oct-19,CHIS.,"JIQUIPILAS, CHIS.",1,1,2,2,0,202,
22-oct-19,MÉX.,"IXTAPALUCA, MEX.",2,0,2,2,0,39,
23-oct-19,ZAC.,"GUADALUPE, ZAC.",2,0,2,6,0,875,
23-oct-19,MÉX.,"CHALCO, MEX.",2,0,2,0,0,116,
23-oct-19,TLAX.,"ALTZAYANCA, TLAX.",1,1,2,0,0,0,
24-oct-19,MÉX.,"CHALCO, MEX.",2,0,2,0,0,64,
24-oct-19,MÉX.,"IXTAPALUCA, MEX.",1,1,2,0,0,139,
28-oct-19,CD. MÉX.,"IZTAPALAPA, CD. MÉX.",1,1,2,0,0,2,
29-oct-19,MÉX.,"TEXCOCO, MEX.",1,1,2,0,0,113,
30-oct-19,MÉX.,"TEXCOCO, MEX.",2,0,2,1,0,100,
30-oct-19,MÉX.,"CHALCO, MEX.",1,1,2,0,0,530,
30-oct-19,CD. MÉX.,"TLAHUAC, CD. MÉX.",1,1,2,0,0,13,
30-oct-19,VER.,"COSOLEACAQUE, VER.",2,0,2,0,0,100,
01-nov-19,MÉX.,"TEXCOCO, MEX.",2,0,2,0,0,200,
01-nov-19,MÉX.,"CHALCO, MEX.",1,1,2,0,0,58,
05-nov-19,CD. MÉX.,"TLAHUAC, CD. MÉX.",2,0,2,0,0,103,
06-nov-19,ZAC.,"GUADALUPE, ZAC.",2,0,2,0,0,0,
06-nov-19,CD. MÉX.,"AZCAPOTZALCO, CD. MÉX.",2,0,2,0,0,10,
07-nov-19,MÉX.,"TEXCOCO, MEX.",1,1,2,0,0,7,
08-nov-19,CD. MÉX.,"BENITO JUAREZ, CD. MÉX.",1,1,2,0,0,25,
08-nov-19,CD. MÉX.,"IZTAPALAPA, CD. MÉX.",1,1,2,0,1,0,
09-nov-19,MÉX.,"SAN MATEO ATENCO, MEX.",2,0,2,1,20,22,
12-nov-19,MÉX.,"EL ORO, MEX.",1,1,2,0,0,0,
12-nov-19,MÉX.,"TEPETLAOXTOC, MEX.",1,1,2,0,0,0,
12-nov-19,MÉX.,"CUAUTITLAN IZCALLI, MEX.",2,0,2,0,1,0,
13-nov-19,TLAX.,"TEOLOCHOLCO, TLAX.",2,0,2,0,0,0,
13-nov-19,CHIS.,"VILLAFLORES, CHIS.",0,2,2,0,0,198,
13-nov-19,MÉX.,"CUAUTITLAN IZCALLI, MEX.",0,2,2,0,0,20,
13-nov-19,TLAX.,"TEOLOCHOLCO, TLAX.",2,0,2,0,0,0,
14-nov-19,CHIS.,"TAPACHULA, CHIS.",1,1,2,0,0,6,
14-nov-19,CD. MÉX.,"BENITO JUAREZ, CD. MÉX.",2,0,2,0,0,31,
14-nov-19,CD. MÉX.,"IZTAPALAPA, CD. MÉX.",2,0,2,0,0,1555,
15-nov-19,CHIS.,"VILLAFLORES, CHIS.",1,1,2,0,0,667,
15-nov-19,VER.,"VILLA ALDAMA, VER.",0,2,2,0,0,0,
16-nov-19,CHIS.,"TUXTLA GUTIÉRREZ, CHIS.",2,0,2,1,0,50,
16-nov-19,MÉX.,"TEPETLAOXTOC, MEX.",1,1,2,0,0,0,
19-nov-19,CD. MÉX.,"CUAUHTEMOC, CD. MÉX.",2,0,2,0,0,9,
19-nov-19,MOR.,"JIUTEPEC, MOR.",2,0,2,50,0,29,
19-nov-19,MÉX.,"COYOTEPEC, MEX.",2,0,2,0,0,321,
20-nov-19,CD. MÉX.,"CUAUHTEMOC, CD. MÉX.",2,0,2,0,0,41,
21-nov-19,MÉX.,"COYOTEPEC, MEX.",2,0,2,0,0,26,
23-nov-19,MÉX.,"VALLE DE CHALCO SOLIDARIDAD, MEX.",1,1,2,0,0,96,
25-nov-19,CD. MÉX.,"COYOACAN, CD. MÉX.",2,0,2,0,2,2028,
26-nov-19,CD. MÉX.,"XOCHIMILCO, CD. MÉX.",2,0,2,0,0,0,
26-nov-19,CD. MÉX.,"COYOACAN, CD. MÉX.",2,0,2,0,0,111,
28-nov-19,TLAX.,"TLAX., TLAX.",2,0,2,0,0,0,
28-nov-19,CD. MÉX.,"IZTAPALAPA, CD. MÉX.",1,1,2,0,1,43,
29-nov-19,ZAC.,"ZAC., ZAC.",2,0,2,0,0,62,
29-nov-19,ZAC.,"FRESNILLO, ZAC.",2,0,2,4,0,0,
29-nov-19,HGO.,"YAHUALICA, HGO.",1,1,2,0,0,0,
01-dic-19,CD. MÉX.,"MIGUEL HGO., CD. MÉX.",2,0,2,0,0,0,
02-dic-19,N.L.,"GUADALUPE, N.L.",1,1,2,2,0,133,
03-dic-19,ZAC.,"FRESNILLO, ZAC.",2,0,2,1,0,0,
03-dic-19,N.L.,"GUADALUPE, N.L.",2,0,2,0,0,352,
03-dic-19,CD. MÉX.,"MIGUEL HGO., CD. MÉX.",1,1,2,0,0,7,
03-dic-19,CD. MÉX.,"IZTAPALAPA, CD. MÉX.",2,0,2,0,0,90,
04-dic-19,N.L.,"GUADALUPE, N.L.",2,0,2,3,0,0,
05-dic-19,ZAC.,"FRESNILLO, ZAC.",2,0,2,1,2,3,
05-dic-19,N.L.,"GUADALUPE, N.L.",2,0,2,0,0,0,
05-dic-19,CD. MÉX.,"IZTAPALAPA, CD. MÉX.",1,1,2,0,0,1,
05-dic-19,MOR.,"JIUTEPEC, MOR.",1,1,2,55,2,594,
09-dic-19,SON.,"HERMOSILLO, SON.",2,0,2,0,0,0,
09-dic-19,ZAC.,"GUADALUPE, ZAC.",2,0,2,1,0,417,
09-dic-19,CD. MÉX.,"IZTAPALAPA, CD. MÉX.",1,1,2,0,0,243,
09-dic-19,S.L.P.,"SAN LUIS POTOSI, S.L.P.",2,0,2,2,0,0,
10-dic-19,ZAC.,"GUADALUPE, ZAC.",0,2,2,13,0,4,
11-dic-19,JAL.,"GUADALAJARA, JAL.",2,0,2,0,0,0,
11-dic-19,CD. MÉX.,"IZTAPALAPA, CD. MÉX.",2,0,2,0,0,3388,
12-dic-19,S.L.P.,"SAN LUIS POTOSI, S.L.P.",1,1,2,7,0,23,
20-dic-19,S.L.P.,"SOLEDAD DE GRACIANO SANCHEZ, S.L.P.",2,0,2,0,0,0,
21-dic-19,S.L.P.,"SAN LUIS POTOSI, S.L.P.",2,0,2,0,0,0,
19-ene-20,CHIS.,"TAPACHULA, CHIS.",2,0,2,0,0,47,
20-ene-20,CHIS.,"TAPACHULA, CHIS.",2,0,2,3,0,57,
21-ene-20,ZAC.,"GUADALUPE, ZAC.",1,1,2,3,0,530,
24-ene-20,CD. MÉX.,"MILPA ALTA, CD. MÉX.",2,0,2,0,0,0,
30-ene-20,CD. MÉX.,"MILPA ALTA, CD. MÉX.",0,2,2,0,0,0,
31-ene-20,COAH.,"SABINAS, COAH.",2,0,2,0,0,0,
05-feb-20,CD. MÉX.,"MILPA ALTA, CD. MÉX.",2,0,2,0,4,114,
05-feb-20,COAH.,"MÚZQUIZ, COAH.",2,0,2,0,0,0,
06-feb-20,CD. MÉX.,"GUSTAVO A. MADERO, CD. MÉX.",2,0,2,0,0,637,
07-feb-20,ZAC.,"ZAC., ZAC.",1,1,2,5,0,34,
07-feb-20,CD. MÉX.,"GUSTAVO A. MADERO, CD. MÉX.",2,0,2,0,0,234,
09-feb-20,CHIH.,"ALDAMA, CHIH.",2,0,2,0,0,60,
10-feb-20,CD. MÉX.,"IZTAPALAPA, CD. MÉX.",2,0,2,0,0,129,
11-feb-20,SON.,"HERMOSILLO, SON.",1,1,2,0,0,0,
14-feb-20,SIN.,"CULIACAN, SIN.",2,0,2,0,0,0,
19-feb-20,SIN.,"NAVOLATO, SIN.",2,0,2,0,0,0,
19-feb-20,SIN.,"MOCORITO, SIN.",0,2,2,0,0,0,
20-feb-20,COAH.,"PIEDRAS NEGRAS, COAH.",0,2,2,0,0,62,
20-feb-20,SIN.,"MOCORITO, SIN.",0,2,2,0,3,0,
20-feb-20,ZAC.,"ZAC., ZAC.",2,0,2,0,0,0,
20-feb-20,ZAC.,"JALPA, ZAC.",2,0,2,0,0,0,
21-feb-20,CD. MÉX.,"XOCHIMILCO, CD. MÉX.",2,0,2,0,1,0,
21-feb-20,SIN.,"MOCORITO, SIN.",1,1,2,0,3,0,
24-feb-20,COAH.,"PIEDRAS NEGRAS, COAH.",2,0,2,1,1,163,
25-feb-20,COAH.,"SALTILLO, COAH.",0,2,2,1,1,0,
25-feb-20,COAH.,"RAMOS ARIZPE, COAH.",2,0,2,0,0,72,
25-feb-20,COAH.,"MONCLOVA, COAH.",2,0,2,0,0,0,
25-feb-20,ZAC.,"FRESNILLO, ZAC.",2,0,2,2,0,0,
27-feb-20,CD. MÉX.,"IZTAPALAPA, CD. MÉX.",1,1,2,0,0,21,
27-feb-20,COAH.,"SAN PEDRO, COAH.",0,2,2,0,0,0,
27-feb-20,COAH.,"SAN PEDRO, COAH.",0,2,2,0,0,0,
28-feb-20,COAH.,"RAMOS ARIZPE, COAH.",1,1,2,0,0,0,
02-mar-20,SON.,"HERMOSILLO, SON.",2,0,2,0,0,0,
03-mar-20,COAH.,"SALTILLO, COAH.",2,0,2,0,0,85,
03-mar-20,CD. MÉX.,"IZTAPALAPA, CD. MÉX.",2,0,2,0,0,115,
03-mar-20,NAY.,"XALISCO, NAY.",1,1,2,0,0,0,
03-mar-20,COAH.,"TORREÓN, COAH.",2,0,2,0,0,114,
03-mar-20,COAH.,"FRANCISCO I. MADERO, COAH.",0,2,2,1,0,16,
05-mar-20,COAH.,"TORREÓN, COAH.",1,1,2,0,0,0,
06-mar-20,VER.,"COATZACOALCOS, VER.",1,1,2,0,0,0,
06-mar-20,CD. MÉX.,"BENITO JUAREZ, CD. MÉX.",2,0,2,0,0,137,
08-mar-20,VER.,"XALAPA, VER.",2,0,2,18,0,49,
09-mar-20,CD. MÉX.,"CUAJIMALPA DE MOR., CD. MÉX.",2,0,2,0,0,0,
09-mar-20,CD. MÉX.,"IZTAPALAPA, CD. MÉX.",2,0,2,0,0,186,
09-mar-20,VER.,"XALAPA, VER.",2,0,2,39,0,43,
09-mar-20,VER.,"VER., VER.",2,0,2,40,0,544,
09-mar-20,NAY.,"XALISCO, NAY.",2,0,2,0,0,0,
10-mar-20,ZAC.,"ZAC., ZAC.",1,1,2,0,0,30,
10-mar-20,COAH.,"MONCLOVA, COAH.",1,1,2,0,0,0,
11-mar-20,CD. MÉX.,"IZTAPALAPA, CD. MÉX.",2,0,2,0,0,0,
12-mar-20,COAH.,"RAMOS ARIZPE, COAH.",2,0,2,0,0,0,
12-mar-20,COAH.,"MONCLOVA, COAH.",0,2,2,0,0,0,
12-mar-20,S.L.P.,"SAN LUIS POTOSI, S.L.P.",2,0,2,5,0,0,
12-mar-20,CD. MÉX.,"CUAJIMALPA DE MOR., CD. MÉX.",2,0,2,0,0,0,
12-mar-20,CD. MÉX.,"MIGUEL HGO., CD. MÉX.",2,0,2,0,0,135,
14-mar-20,COAH.,"PIEDRAS NEGRAS, COAH.",1,1,2,0,0,0,
14-mar-20,VER.,"XALAPA, VER.",2,0,2,19,0,535,
14-mar-20,COAH.,"PIEDRAS NEGRAS, COAH.",1,1,2,0,0,0,
15-mar-20,S.L.P.,"SOLEDAD DE GRACIANO SANCHEZ, S.L.P.",0,2,2,0,0,0,
16-mar-20,VER.,"VER., VER.",2,0,2,2,0,343,
17-mar-20,VER.,"COATZACOALCOS, VER.",2,0,2,3,0,19,
19-mar-20,VER.,"XALAPA, VER.",2,0,2,51,0,425,
24-mar-20,COAH.,"MONCLOVA, COAH.",0,2,2,2,0,0,
25-mar-20,S.L.P.,"CIUDAD VALLES, S.L.P.",1,1,2,0,0,0,
13-jul-20,CD. MÉX.,"CUAUHTEMOC, CD. MÉX.",1,1,2,0,0,444,
14-jul-20,CD. MÉX.,"GUSTAVO A. MADERO, CD. MÉX.",2,0,2,0,0,0,
15-jul-20,CD. MÉX.,"GUSTAVO A. MADERO, CD. MÉX.",2,0,2,0,0,62,
15-jul-20,CD. MÉX.,"CUAUHTEMOC, CD. MÉX.",2,0,2,0,0,12,
17-jul-20,CD. MÉX.,"GUSTAVO A. MADERO, CD. MÉX.",1,1,2,0,0,0,
17-jul-20,CD. MÉX.,"CUAUHTEMOC, CD. MÉX.",2,0,2,0,0,25,
23-jul-20,CD. MÉX.,"GUSTAVO A. MADERO, CD. MÉX.",2,0,2,0,0,3,
23-jul-20,CD. MÉX.,"CUAUHTEMOC, CD. MÉX.",0,2,2,0,0,48,
24-jul-20,CD. MÉX.,"GUSTAVO A. MADERO, CD. MÉX.",2,0,2,0,0,194,
28-jul-20,CD. MÉX.,"GUSTAVO A. MADERO, CD. MÉX.",1,1,2,0,0,430,
31-jul-20,CD. MÉX.,"CUAUHTEMOC, CD. MÉX.",2,0,2,0,0,0,
04-ago-20,CD. MÉX.,"GUSTAVO A. MADERO, CD. MÉX.",1,1,2,0,0,96,
05-ago-20,CD. MÉX.,"CUAUHTEMOC, CD. MÉX.",1,1,2,0,0,0,
07-ago-20,CD. MÉX.,"GUSTAVO A. MADERO, CD. MÉX.",1,1,2,0,0,0,
19-ago-20,CD. MÉX.,"GUSTAVO A. MADERO, CD. MÉX.",2,0,2,0,0,14,
21-ago-20,CD. MÉX.,"GUSTAVO A. MADERO, CD. MÉX.",2,0,2,0,0,0,
31-ago-20,CD. MÉX.,"CUAUHTEMOC, CD. MÉX.",2,0,2,0,0,156,
09-sep-20,CD. MÉX.,"GUSTAVO A. MADERO, CD. MÉX.",2,0,2,0,0,0,
09-sep-20,CD. MÉX.,"CUAUHTEMOC, CD. MÉX.",2,0,2,0,0,20,
10-sep-20,CD. MÉX.,"GUSTAVO A. MADERO, CD. MÉX.",1,1,2,0,1,0,
11-sep-20,CD. MÉX.,"GUSTAVO A. MADERO, CD. MÉX.",1,1,2,0,0,3,
18-sep-20,CD. MÉX.,"GUSTAVO A. MADERO, CD. MÉX.",1,1,2,0,0,0,
18-sep-20,CD. MÉX.,"CUAUHTEMOC, CD. MÉX.",1,1,2,0,0,0,
19-sep-20,VER.,"CORDOBA, VER.",2,0,2,1,0,1265,
20-sep-20,VER.,"CORDOBA, VER.",2,0,2,1,0,0,
23-sep-20,CD. MÉX.,"CUAUHTEMOC, CD. MÉX.",1,1,2,0,0,0,
23-sep-20,CD. MÉX.,"GUSTAVO A. MADERO, CD. MÉX.",2,0,2,0,0,0,
23-sep-20,VER.,"CORDOBA, VER.",2,0,2,1,0,1265,
24-sep-20,VER.,"CORDOBA, VER.",2,0,2,2,0,697,
24-sep-20,VER.,"MARTINEZ DE LA TORRE, VER.",2,0,2,0,0,4,
25-sep-20,VER.,"CORDOBA, VER.",2,0,2,0,0,1757,
28-sep-20,VER.,"CORDOBA, VER.",2,0,2,0,0,8049,
28-sep-20,VER.,"MARTINEZ DE LA TORRE, VER.",2,0,2,1,0,90,
29-sep-20,CD. MÉX.,"GUSTAVO A. MADERO, CD. MÉX.",1,1,2,0,0,554,
01-oct-20,VER.,"CORDOBA, VER.",2,0,2,0,0,23,
07-oct-20,CD. MÉX.,"GUSTAVO A. MADERO, CD. MÉX.",2,0,2,0,0,0,
09-oct-20,CD. MÉX.,"CUAUHTEMOC, CD. MÉX.",1,1,2,0,1,0,
14-oct-20,CD. MÉX.,"CUAUHTEMOC, CD. MÉX.",2,0,2,0,0,0,
16-oct-20,CD. MÉX.,"CUAUHTEMOC, CD. MÉX.",2,0,2,0,0,0,
20-oct-20,CD. MÉX.,"GUSTAVO A. MADERO, CD. MÉX.",0,2,2,0,1,437,
26-oct-20,CD. MÉX.,"GUSTAVO A. MADERO, CD. MÉX.",2,0,2,0,0,0,
30-oct-20,CD. MÉX.,"TLALPAN, CD. MÉX.",2,0,2,0,0,0,
30-oct-20,VER.,"COATEPEC, VER.",1,1,2,1,0,0,
31-oct-20,VER.,"COATEPEC, VER.",1,1,2,8,0,135,
03-nov-20,CD. MÉX.,"TLALPAN, CD. MÉX.",2,0,2,0,0,0,
06-nov-20,CD. MÉX.,"TLALPAN, CD. MÉX.",2,0,2,0,0,0,
09-nov-20,CD. MÉX.,"GUSTAVO A. MADERO, CD. MÉX.",2,0,2,0,0,7364,
12-nov-20,CD. MÉX.,"GUSTAVO A. MADERO, CD. MÉX.",1,1,2,0,0,1000,
12-nov-20,VER.,"VEGA DE ALATORRE, VER.",1,1,2,0,0,798,
12-nov-20,VER.,"COATEPEC, VER.",2,0,2,15,0,5887,
13-nov-20,CD. MÉX.,"GUSTAVO A. MADERO, CD. MÉX.",1,1,2,0,0,0,
17-nov-20,CD. MÉX.,"GUSTAVO A. MADERO, CD. MÉX.",1,1,2,0,0,0,
27-nov-20,CD. MÉX.,"GUSTAVO A. MADERO, CD. MÉX.",0,2,2,0,0,200,
04-dic-20,CD. MÉX.,"BENITO JUAREZ, CD. MÉX.",1,1,2,0,1,16,
10-dic-20,CD. MÉX.,"VENUSTIANO CARRANZA, CD. MÉX.",0,2,2,0,0,0,
14-dic-20,CD. MÉX.,"GUSTAVO A. MADERO, CD. MÉX.",0,2,2,0,0,0,
15-dic-20,CD. MÉX.,"VENUSTIANO CARRANZA, CD. MÉX.",2,0,2,0,0,3385,
16-dic-20,CD. MÉX.,"GUSTAVO A. MADERO, CD. MÉX.",0,2,2,0,0,0,
16-jun-21,CD. MÉX.,"ALVARO OBREGON, CD. MÉX.",2,0,2,0,0,42,
18-jun-21,CD. MÉX.,"ALVARO OBREGON, CD. MÉX.",1,1,2,0,0,25,
10-jul-21,VER.,"MARTINEZ DE LA TORRE, VER.",2,0,2,0,0,5708,
10-jul-21,VER.,"MINATITLAN, VER.",2,0,2,0,0,927,
10-jul-21,VER.,"POZA RICA DE HGO., VER.",2,0,2,3,0,8945,
12-jul-21,VER.,"MINATITLAN, VER.",1,1,2,3,0,378,
16-jul-21,VER.,"POZA RICA DE HGO., VER.",2,0,2,1,0,91,
16-jul-21,VER.,"MINATITLAN, VER.",2,0,2,1,0,125,
16-jul-21,COAH.,"MONCLOVA, COAH.",0,2,2,0,0,97,
17-jul-21,VER.,"MINATITLAN, VER.",1,1,2,0,0,137,
19-jul-21,COAH.,"PIEDRAS NEGRAS, COAH.",2,0,2,4,0,280,
20-jul-21,COAH.,"MONCLOVA, COAH.",2,0,2,2,0,14,
20-jul-21,COAH.,"MÚZQUIZ, COAH.",1,1,2,19,0,0,
21-jul-21,VER.,"POZA RICA DE HGO., VER.",2,0,2,1,1,187,
21-jul-21,COAH.,"PIEDRAS NEGRAS, COAH.",2,0,2,1,0,0,
22-jul-21,COAH.,"PIEDRAS NEGRAS, COAH.",0,2,2,0,0,79,
23-jul-21,COAH.,"SAN PEDRO, COAH.",2,0,2,5,0,59,
14-sep-21,B.C.,"SAN QUINTÍN, B.C.",2,0,2,1,0,0,
17-sep-21,B.C.,"SAN QUINTÍN, B.C.",1,1,2,1,0,0,
21-sep-21,B.C.,"SAN QUINTÍN, B.C.",0,2,2,0,0,0,
23-sep-21,CHIH.,"CUAUHTÉMOC, CHIH.",1,1,2,0,1,100,
24-sep-21,CHIH.,"CUAUHTÉMOC, CHIH.",2,0,2,2,4,263,
25-sep-21,CHIH.,"CUAUHTÉMOC, CHIH.",2,0,2,2,4,750,
29-sep-21,CHIH.,"DELICIAS, CHIH.",2,0,2,7,0,352,
21-oct-21,CD. MÉX.,"BENITO JUAREZ, CD. MÉX.",1,1,2,0,0,37,
29-oct-21,CD. MÉX.,"TLAHUAC, CD. MÉX.",2,0,2,0,0,0,
03-nov-21,CD. MÉX.,"XOCHIMILCO, CD. MÉX.",2,0,2,0,0,25,
03-nov-21,CD. MÉX.,"XOCHIMILCO, CD. MÉX.",2,0,2,0,0,25,
04-nov-21,CD. MÉX.,"XOCHIMILCO, CD. MÉX.",0,2,2,0,0,195,
04-nov-21,CD. MÉX.,"XOCHIMILCO, CD. MÉX.",0,2,2,0,0,195,
05-nov-21,CD. MÉX.,"TLAHUAC, CD. MÉX.",2,0,2,0,0,0,
09-nov-21,TLAX.,"CONTLA DE JUAN CUAMATZI, TLAX.",1,1,2,2,0,182,
11-nov-21,CD. MÉX.,"COYOACAN, CD. MÉX.",2,0,2,0,0,0,
11-nov-21,B.C.,"TIJUANA, B.C.",1,1,2,0,0,0,
12-nov-21,VER.,"MINATITLAN, VER.",2,0,2,0,0,7,
12-nov-21,TLAX.,"TLAX., TLAX.",1,1,2,0,0,0,
12-nov-21,TLAX.,"PANOTLA, TLAX.",1,1,2,0,0,0,
13-nov-21,VER.,"NOGALES, VER.",2,0,2,0,0,90,
13-nov-21,TLAX.,"CONTLA DE JUAN CUAMATZI, TLAX.",2,0,2,0,0,0,
13-nov-21,TLAX.,"PANOTLA, TLAX.",0,2,2,0,0,0,
16-nov-21,CHIH.,"OJINAGA, CHIH.",2,0,2,0,0,0,
17-nov-21,CD. MÉX.,"MIGUEL HGO., CD. MÉX.",1,1,2,0,0,54,
17-nov-21,VER.,"ALAMO, VER.",1,1,2,0,0,0,
18-nov-21,CD. MÉX.,"CUAJIMALPA DE MOR., CD. MÉX.",2,0,2,0,0,51,
19-nov-21,TLAX.,"SAN PABLO DEL MONTE, TLAX.",2,0,2,0,0,0,
19-nov-21,CD. MÉX.,"MIGUEL HGO., CD. MÉX.",2,0,2,0,0,100,
22-nov-21,TLAX.,"ZITLALTEPEC DE TRINIDAD SANCHEZ SANTOS, TLAX.",1,1,2,0,0,0,
23-nov-21,CD. MÉX.,"ALVARO OBREGON, CD. MÉX.",1,1,2,0,0,78,
23-nov-21,CD. MÉX.,"GUSTAVO A. MADERO, CD. MÉX.",2,0,2,0,0,67,
24-nov-21,TLAX.,"ZITLALTEPEC DE TRINIDAD SANCHEZ SANTOS, TLAX.",2,0,2,0,0,0,
24-nov-21,CD. MÉX.,"CUAJIMALPA DE MOR., CD. MÉX.",2,0,2,0,0,0,
25-nov-21,TLAX.,"ALTZAYANCA, TLAX.",0,2,2,0,0,0,
25-nov-21,CD. MÉX.,"GUSTAVO A. MADERO, CD. MÉX.",2,0,2,0,0,0,
25-nov-21,CD. MÉX.,"CUAJIMALPA DE MOR., CD. MÉX.",2,0,2,0,0,0,
26-nov-21,TLAX.,"HUAMANTLA, TLAX.",2,0,2,1,0,0,
27-nov-21,TLAX.,"ALTZAYANCA, TLAX.",0,2,2,0,0,0,
27-nov-21,TLAX.,"HUAMANTLA, TLAX.",2,0,2,1,0,0,
29-nov-21,CHIS.,"MARQUÉS DE COMILLAS, CHIS.",1,1,2,1,0,0,
30-nov-21,CD. MÉX.,"ALVARO OBREGON, CD. MÉX.",2,0,2,0,0,0,
02-dic-21,CHIS.,"TUXTLA GUTIÉRREZ, CHIS.",2,0,2,0,2,483,
02-dic-21,TLAX.,"CALPULALPAN, TLAX.",2,0,2,0,0,0,
02-dic-21,CD. MÉX.,"GUSTAVO A. MADERO, CD. MÉX.",2,0,2,0,0,251,
04-dic-21,CHIH.,"CHIH., CHIH.",1,1,2,0,0,174,
05-dic-21,CHIS.,"TUXTLA GUTIÉRREZ, CHIS.",1,1,2,0,2,311,
07-dic-21,CHIS.,"TUXTLA GUTIÉRREZ, CHIS.",1,1,2,0,0,60,
07-dic-21,CHIH.,"CHIH., CHIH.",2,0,2,0,1,754,
07-dic-21,TLAX.,"HUEYOTLIPAN, TLAX.",0,2,2,0,0,0,
08-dic-21,CHIS.,"COMITAN DE DOMÍNGUEZ, CHIS.",2,0,2,0,0,8,
10-dic-21,CHIS.,"COMITAN DE DOMÍNGUEZ, CHIS.",1,1,2,0,0,139,
12-dic-21,OAX.,"OAX. DE JUAREZ, OAX.",1,1,2,0,0,171,
13-dic-21,SON.,"HERMOSILLO, SON.",2,0,2,0,0,0,
13-dic-21,CHIH.,"NUEVO CASAS GRANDES, CHIH.",2,0,2,0,0,33,
13-dic-21,CHIS.,"JUÁREZ, CHIS.",1,1,2,0,0,0,
14-dic-21,SON.,"HERMOSILLO, SON.",1,1,2,0,0,11,
14-dic-21,CHIS.,"OCOZOCOAUTLA DE ESPINOSA, CHIS.",1,1,2,0,0,95,
14-dic-21,OAX.,"SANTA LUCIA DEL CAMINO, OAX.",2,0,2,0,0,556,
15-dic-21,CHIS.,"CHENALHÓ, CHIS.",0,2,2,0,0,239,
18-dic-21,CHIS.,"LA TRINITARIA, CHIS.",0,2,2,0,0,0,
19-dic-21,CHIH.,"CHIH., CHIH.",2,0,2,0,0,1003,
20-dic-21,SON.,"HERMOSILLO, SON.",1,1,2,0,0,0,
18-ene-22,CD. MÉX.,"CUAUHTEMOC, CD. MÉX.",2,0,2,0,0,27,
19-ene-22,CD. MÉX.,"CUAUHTEMOC, CD. MÉX.",0,2,2,0,0,0,
25-ene-22,CD. MÉX.,"MIGUEL HGO., CD. MÉX.",2,0,2,0,0,38,
01-feb-22,CD. MÉX.,"IZTAPALAPA, CD. MÉX.",2,0,2,0,0,0,
03-feb-22,CD. MÉX.,"IZTACALCO, CD. MÉX.",2,0,2,0,0,0,
06-feb-22,GTO.,"PURISIMA DEL RINCON, GTO.",1,1,2,0,0,0,
08-feb-22,CD. MÉX.,"IZTACALCO, CD. MÉX.",2,0,2,0,0,514,
29-mar-22,CD. MÉX.,"CUAUHTEMOC, CD. MÉX.",2,0,2,0,0,0,
31-mar-22,CD. MÉX.,"TLAHUAC, CD. MÉX.",2,0,2,0,0,102,
01-abr-22,CD. MÉX.,"CUAUHTEMOC, CD. MÉX.",2,0,2,0,0,0,
08-abr-22,CD. MÉX.,"TLAHUAC, CD. MÉX.",1,1,2,0,0,478,
19-abr-22,CD. MÉX.,"CUAUHTEMOC, CD. MÉX.",2,0,2,0,0,0,
04-may-22,CD. MÉX.,"CUAUHTEMOC, CD. MÉX.",2,0,2,0,0,40,
10-may-22,S.L.P.,"SAN LUIS POTOSI, S.L.P.",1,1,2,0,4,0,
12-may-22,SIN.,"CHOIX, SIN.",2,0,2,0,0,0,
14-may-22,SIN.,"CHOIX, SIN.",0,2,2,0,0,0,
16-may-22,SIN.,"EL FUERTE, SIN.",2,0,2,0,0,0,
17-may-22,CD. MÉX.,"CUAUHTEMOC, CD. MÉX.",2,0,2,0,4,32,
17-may-22,S.L.P.,"SAN LUIS POTOSI, S.L.P.",2,0,2,0,0,0,
20-may-22,VER.,"COATZACOALCOS, VER.",0,2,2,0,0,258,
21-may-22,SIN.,"CHOIX, SIN.",1,1,2,0,0,0,
23-may-22,CD. MÉX.,"CUAUHTEMOC, CD. MÉX.",2,0,2,0,0,3,
24-may-22,VER.,"COATZACOALCOS, VER.",2,0,2,0,0,123,
25-may-22,CD. MÉX.,"CUAUHTEMOC, CD. MÉX.",2,0,2,0,0,3,
25-may-22,VER.,"XALAPA, VER.",2,0,2,31,0,517,
25-may-22,VER.,"COATZACOALCOS, VER.",1,1,2,15,0,65,
26-may-22,CD. MÉX.,"GUSTAVO A. MADERO, CD. MÉX.",2,0,2,0,0,35,
26-may-22,CD. MÉX.,"GUSTAVO A. MADERO, CD. MÉX.",1,1,2,0,39,0,
27-may-22,CD. MÉX.,"IZTAPALAPA, CD. MÉX.",1,1,2,0,1,24,
28-may-22,VER.,"COATZACOALCOS, VER.",2,0,2,1,0,68,
29-may-22,VER.,"XALAPA, VER.",2,0,2,45,0,0,
30-may-22,S.L.P.,"SAN LUIS POTOSI, S.L.P.",2,0,2,0,0,0,
31-may-22,VER.,"XALAPA, VER.",2,0,2,12,0,66,
01-jun-22,CD. MÉX.,"GUSTAVO A. MADERO, CD. MÉX.",1,1,2,0,6,17,
02-jun-22,VER.,"XALAPA, VER.",0,2,2,0,0,18,
02-jun-22,CD. MÉX.,"MIGUEL HGO., CD. MÉX.",2,0,2,0,0,0,
03-jun-22,CD. MÉX.,"AZCAPOTZALCO, CD. MÉX.",1,1,2,0,0,26,
06-jun-22,CD. MÉX.,"AZCAPOTZALCO, CD. MÉX.",2,0,2,0,0,11,
06-jun-22,CD. MÉX.,"IZTAPALAPA, CD. MÉX.",2,0,2,0,7,6,
06-jun-22,TLAX.,"TLAX., TLAX.",2,0,2,0,0,0,
08-jun-22,SIN.,"ANGOSTURA, SIN.",2,0,2,0,0,0,
08-jun-22,TLAX.,"TLAX., TLAX.",1,1,2,2,0,0,
09-jun-22,CD. MÉX.,"AZCAPOTZALCO, CD. MÉX.",2,0,2,0,0,626,
11-jun-22,TLAX.,"TETLA DE LA SOLIDARIDAD, TLAX.",0,2,2,0,0,0,
11-jun-22,SIN.,"AHOME, SIN.",2,0,2,0,0,0,
11-jun-22,SIN.,"GUASAVE, SIN.",2,0,2,0,0,0,
13-jun-22,SIN.,"GUASAVE, SIN.",1,1,2,0,0,0,
13-jun-22,S.L.P.,"SAN LUIS POTOSI, S.L.P.",1,1,2,0,0,0,
14-jun-22,TLAX.,"CUAPIAXTLA, TLAX.",1,1,2,0,0,0,
14-jun-22,JAL.,"TLAJOMULCO DE ZUÑIGA, JAL.",2,0,2,1,0,47,
15-jun-22,SIN.,"GUASAVE, SIN.",2,0,2,0,0,0,
15-jun-22,TLAX.,"NANACAMILPA DE MARIANO ARISTA, TLAX.",0,2,2,0,0,0,
16-jun-22,SIN.,"GUASAVE, SIN.",1,1,2,0,0,0,
18-jun-22,SIN.,"GUASAVE, SIN.",1,1,2,0,0,0,
20-jun-22,TLAX.,"TENANCINGO, TLAX.",2,0,2,0,0,0,
21-jun-22,JAL.,"GUADALAJARA, JAL.",2,0,2,1,0,43,
21-jun-22,JAL.,"TECALITLAN, JAL.",0,2,2,0,0,19,
21-jun-22,JAL.,"LA BARCA, JAL.",0,2,2,0,0,0,
22-jun-22,CD. MÉX.,"CUAUHTEMOC, CD. MÉX.",0,2,2,0,0,474,
22-jun-22,CHIH.,"JUÁREZ, CHIH.",1,1,2,22,0,184,
23-jun-22,CD. MÉX.,"BENITO JUAREZ, CD. MÉX.",2,0,2,0,0,79,
23-jun-22,GRO.,"JUAN R. ESCUDERO, GRO.",0,2,2,0,0,0,
23-jun-22,CHIH.,"JUÁREZ, CHIH.",1,1,2,0,0,92,
23-jun-22,JAL.,"LA BARCA, JAL.",2,0,2,0,0,0,
24-jun-22,TLAX.,"ZACATELCO, TLAX.",2,0,2,0,0,0,
25-jun-22,GRO.,"JUAN R. ESCUDERO, GRO.",0,2,2,0,1,0,
25-jun-22,CHIH.,"JUÁREZ, CHIH.",2,0,2,13,0,274,
26-jun-22,QRO.,"LANDA DE MATAMOROS, QRO.",1,1,2,0,0,0,
27-jun-22,TLAX.,"TEOLOCHOLCO, TLAX.",2,0,2,0,0,0,
28-jun-22,CD. MÉX.,"ALVARO OBREGON, CD. MÉX.",2,0,2,0,0,112,
29-jun-22,TLAX.,"EMILIANO ZAPATA, TLAX.",1,1,2,0,0,0,
29-jun-22,TLAX.,"SAN PABLO DEL MONTE, TLAX.",0,2,2,0,0,0,
29-jun-22,JAL.,"ZAPOPAN, JAL.",2,0,2,0,0,107,
29-jun-22,CD. MÉX.,"BENITO JUAREZ, CD. MÉX.",2,0,2,0,0,151,
04-jul-22,SIN.,"BADIRAGUATO, SIN.",1,1,2,0,1,0,
05-jul-22,TAMPS.,"VICTORIA, TAMPS.",2,0,2,0,1,0,
05-jul-22,SIN.,"BADIRAGUATO, SIN.",1,1,2,0,1,0,
05-jul-22,JAL.,"SAYULA, JAL.",1,1,2,0,0,91,
07-jul-22,TAMPS.,"VICTORIA, TAMPS.",2,0,2,0,0,50,
07-jul-22,JAL.,"TAMAZULA DE GORDIANO, JAL.",1,1,2,0,0,0,
07-jul-22,S.L.P.,"SAN LUIS POTOSI, S.L.P.",2,0,2,0,0,0,
08-jul-22,DGO.,"SANTIAGO PAPASQUIARO, DGO.",1,1,2,0,0,0,
09-jul-22,DGO.,"GOMEZ PALACIO, DGO.",2,0,2,0,0,0,
09-jul-22,SIN.,"BADIRAGUATO, SIN.",0,2,2,0,0,0,
12-jul-22,CD. MÉX.,"MIGUEL HGO., CD. MÉX.",2,0,2,0,0,284,
12-jul-22,CD. MÉX.,"AZCAPOTZALCO, CD. MÉX.",2,0,2,0,0,120,
12-jul-22,SIN.,"MOCORITO, SIN.",2,0,2,0,0,0,
13-jul-22,SIN.,"SALVADOR ALVARADO, SIN.",2,0,2,0,1,0,
13-jul-22,VER.,"VER., VER.",1,1,2,0,0,1758,
13-jul-22,CD. MÉX.,"COYOACAN, CD. MÉX.",2,0,2,0,0,0,
14-jul-22,CD. MÉX.,"BENITO JUAREZ, CD. MÉX.",2,0,2,0,0,120,
14-jul-22,CD. MÉX.,"AZCAPOTZALCO, CD. MÉX.",2,0,2,0,0,0,
14-jul-22,JAL.,"JAMAY, JAL.",2,0,2,0,0,0,
15-jul-22,CD. MÉX.,"AZCAPOTZALCO, CD. MÉX.",1,1,2,0,0,6,
15-jul-22,VER.,"TUXPAM, VER.",2,0,2,0,0,169,
17-jul-22,SIN.,"MOCORITO, SIN.",2,0,2,0,0,0,
18-jul-22,CD. MÉX.,"AZCAPOTZALCO, CD. MÉX.",1,1,2,0,0,0,
18-jul-22,TAMPS.,"CIUDAD MADERO, TAMPS.",1,1,2,0,0,0,
20-jul-22,COL.,"TECOMÁN, COL.",0,2,2,0,0,0,
20-jul-22,CD. MÉX.,"BENITO JUAREZ, CD. MÉX.",2,0,2,0,0,25,
20-jul-22,CD. MÉX.,"BENITO JUAREZ, CD. MÉX.",2,0,2,0,0,0,
20-jul-22,CD. MÉX.,"AZCAPOTZALCO, CD. MÉX.",2,0,2,0,0,0,
21-jul-22,CD. MÉX.,"AZCAPOTZALCO, CD. MÉX.",2,0,2,0,0,8,
21-jul-22,VER.,"TUXPAM, VER.",2,0,2,3,0,540,
22-jul-22,MICH.,"MORELIA, MICH.",2,0,2,0,0,0,
23-jul-22,VER.,"TUXPAM, VER.",2,0,2,16,0,0,
24-jul-22,QRO.,"ARROYO SECO, QRO.",2,0,2,0,0,6,
25-jul-22,CD. MÉX.,"AZCAPOTZALCO, CD. MÉX.",2,0,2,0,0,444,
01-ago-22,CHIS.,"CHIAPA DE CORZO, CHIS.",2,0,2,0,0,0,
01-ago-22,CHIS.,"BERRIOZÁBAL, CHIS.",2,0,2,0,0,0,
02-ago-22,TAMPS.,"ALTAMIRA, TAMPS.",1,1,2,0,0,0,
03-ago-22,COAH.,"FRONTERA, COAH.",1,1,2,0,0,0,
03-ago-22,CD. MÉX.,"BENITO JUAREZ, CD. MÉX.",2,0,2,0,0,0,
03-ago-22,TAMPS.,"ALTAMIRA, TAMPS.",2,0,2,0,0,6,
04-ago-22,CD. MÉX.,"COYOACAN, CD. MÉX.",0,2,2,0,0,0,
04-ago-22,TAMPS.,"VICTORIA, TAMPS.",2,0,2,0,0,0,
05-ago-22,CHIS.,"CHIAPA DE CORZO, CHIS.",1,1,2,0,0,534,
05-ago-22,COAH.,"MONCLOVA, COAH.",2,0,2,0,0,0,
05-ago-22,COAH.,"FRONTERA, COAH.",2,0,2,0,0,0,
05-ago-22,COAH.,"CUATROCIÉNEGAS, COAH.",2,0,2,0,0,0,
06-ago-22,CHIS.,"LA TRINITARIA, CHIS.",0,2,2,2,1,486,
07-ago-22,CHIS.,"LA TRINITARIA, CHIS.",0,2,2,0,0,207,
08-ago-22,COAH.,"MONCLOVA, COAH.",1,1,2,0,0,0,
09-ago-22,CD. MÉX.,"COYOACAN, CD. MÉX.",1,1,2,0,0,0,
09-ago-22,CHIS.,"TAPACHULA, CHIS.",1,1,2,2,0,152,
10-ago-22,CD. MÉX.,"BENITO JUAREZ, CD. MÉX.",2,0,2,0,0,50,
10-ago-22,CHIS.,"BERRIOZÁBAL, CHIS.",2,0,2,2,0,285,
10-ago-22,CHIS.,"YAJALÓN, CHIS.",1,1,2,0,0,58,
11-ago-22,CD. MÉX.,"GUSTAVO A. MADERO, CD. MÉX.",1,1,2,0,0,0,
11-ago-22,CHIS.,"BERRIOZÁBAL, CHIS.",1,1,2,0,0,0,
11-ago-22,GRO.,"ACAPULCO DE JUAREZ, GRO.",1,1,2,14,4,355,
12-ago-22,TAMPS.,"REYNOSA, TAMPS.",2,0,2,1,0,70,
13-ago-22,QRO.,"PEDRO ESCOBEDO, QRO.",1,1,2,0,0,0,
13-ago-22,GRO.,"ACAPULCO DE JUAREZ, GRO.",2,0,2,66,1,515,
15-ago-22,TAMPS.,"REYNOSA, TAMPS.",2,0,2,6,0,57,
16-ago-22,SIN.,"SIN., SIN.",2,0,2,0,0,87,
17-ago-22,PUE.,"TEHUACAN, PUE.",2,0,2,0,0,41,
17-ago-22,COAH.,"MONCLOVA, COAH.",0,2,2,1,0,0,
18-ago-22,SIN.,"SIN., SIN.",1,1,2,0,0,0,
18-ago-22,DGO.,"DGO., DGO.",2,0,2,0,0,0,
18-ago-22,DGO.,"GOMEZ PALACIO, DGO.",2,0,2,0,0,0,
18-ago-22,QRO.,"PINAL DE AMOLES, QRO.",2,0,2,0,0,5,
18-ago-22,TAMPS.,"REYNOSA, TAMPS.",0,2,2,0,0,0,
19-ago-22,COAH.,"RAMOS ARIZPE, COAH.",2,0,2,23,0,488,
19-ago-22,DGO.,"GOMEZ PALACIO, DGO.",1,1,2,0,0,0,
19-ago-22,DGO.,"CUENCAME, DGO.",2,0,2,0,0,0,
19-ago-22,QRO.,"PEDRO ESCOBEDO, QRO.",1,1,2,0,0,0,
19-ago-22,PUE.,"TEHUACAN, PUE.",2,0,2,0,0,0,
19-ago-22,TAMPS.,"REYNOSA, TAMPS.",1,1,2,4,0,0,
20-ago-22,SIN.,"ESCUINAPA, SIN.",1,1,2,0,0,0,
22-ago-22,CD. MÉX.,"IZTACALCO, CD. MÉX.",0,2,2,0,0,0,
22-ago-22,CD. MÉX.,"CUAUHTEMOC, CD. MÉX.",2,0,2,0,0,6,
22-ago-22,SIN.,"ESCUINAPA, SIN.",1,1,2,0,0,0,
22-ago-22,SIN.,"SIN., SIN.",2,0,2,0,0,0,
23-ago-22,DGO.,"GOMEZ PALACIO, DGO.",0,2,2,0,0,0,
24-ago-22,N.L.,"APODACA, N.L.",1,1,2,1,0,354,
24-ago-22,MÉX.,"AMECAMECA, MEX.",2,0,2,0,0,185,
25-ago-22,COAH.,"PIEDRAS NEGRAS, COAH.",2,0,2,1,0,125,
25-ago-22,COAH.,"NUEVA ROSITA, COAH.",2,0,2,0,0,24,
26-ago-22,MÉX.,"ATIZAPAN, MEX.",2,0,2,0,0,30,
26-ago-22,N.L.,"APODACA, N.L.",2,0,2,6,0,6,
26-ago-22,DGO.,"GOMEZ PALACIO, DGO.",1,1,2,1,0,0,
26-ago-22,CHIS.,"VILLAFLORES, CHIS.",2,0,2,0,0,804,
26-ago-22,COAH.,"PIEDRAS NEGRAS, COAH.",2,0,2,4,0,0,
26-ago-22,COAH.,"NUEVA ROSITA, COAH.",0,2,2,0,0,10,
27-ago-22,MÉX.,"AMECAMECA, MEX.",2,0,2,0,0,247,
27-ago-22,MÉX.,"NEZAHUALCOYOTL, MEX.",1,1,2,3,0,935,
29-ago-22,COAH.,"PIEDRAS NEGRAS, COAH.",2,0,2,4,0,0,
29-ago-22,COAH.,"ACUÑA, COAH.",0,2,2,0,0,0,
29-ago-22,MÉX.,"NEZAHUALCOYOTL, MEX.",2,0,2,0,0,140,
29-ago-22,COAH.,"MATAMOROS, COAH.",2,0,2,20,0,0,
30-ago-22,COAH.,"TORREÓN, COAH.",2,0,2,0,0,0,
30-ago-22,MÉX.,"TEPETLAOXTOC, MEX.",1,1,2,1,0,0,
30-ago-22,TAMPS.,"REYNOSA, TAMPS.",2,0,2,1,1,32,
31-ago-22,COAH.,"TORREÓN, COAH.",2,0,2,0,0,0,
31-ago-22,COAH.,"MATAMOROS, COAH.",2,0,2,0,0,0,
31-ago-22,MÉX.,"TEPETLAOXTOC, MEX.",2,0,2,0,50,0,
01-sep-22,MÉX.,"HUIXQUILUCAN, MEX.",0,2,2,0,0,113,
01-sep-22,N.L.,"APODACA, N.L.",1,1,2,0,0,0,
01-sep-22,MOR.,"TEMIXCO, MOR.",2,0,2,0,0,55,
02-sep-22,QRO.,"PEDRO ESCOBEDO, QRO.",1,1,2,0,0,0,
05-sep-22,CD. MÉX.,"IZTAPALAPA, CD. MÉX.",2,0,2,0,0,19,
05-sep-22,CD. MÉX.,"VENUSTIANO CARRANZA, CD. MÉX.",1,1,2,0,0,1,
05-sep-22,CD. MÉX.,"XOCHIMILCO, CD. MÉX.",0,2,2,0,0,356,
05-sep-22,MÉX.,"TOLUCA, MEX.",0,2,2,0,0,0,
05-sep-22,TAMPS.,"MATAMOROS, TAMPS.",2,0,2,0,0,139,
06-sep-22,CD. MÉX.,"COYOACAN, CD. MÉX.",2,0,2,0,0,267,
07-sep-22,COAH.,"CUATROCIÉNEGAS, COAH.",0,2,2,0,0,0,
07-sep-22,S.L.P.,"SAN LUIS POTOSI, S.L.P.",2,0,2,0,4,0,
07-sep-22,MÉX.,"CUAUTITLAN IZCALLI, MEX.",1,1,2,1,0,36,
08-sep-22,CD. MÉX.,"AZCAPOTZALCO, CD. MÉX.",2,0,2,0,0,10,
08-sep-22,PUE.,"TEZIUTLAN, PUE.",1,1,2,0,0,160,
08-sep-22,TAMPS.,"MATAMOROS, TAMPS.",2,0,2,0,0,1,
09-sep-22,PUE.,"TEZIUTLAN, PUE.",2,0,2,2,0,119,
09-sep-22,MÉX.,"CUAUTITLAN IZCALLI, MEX.",2,0,2,1,0,108,
09-sep-22,MÉX.,"TOLUCA, MEX.",2,0,2,0,0,282,
09-sep-22,TAMPS.,"JAUMAVE, TAMPS.",1,1,2,0,0,40,
12-sep-22,MÉX.,"NAUCALPAN DE JUAREZ, MEX.",2,0,2,0,0,5,
12-sep-22,MÉX.,"CUAUTITLAN IZCALLI, MEX.",2,0,2,0,0,288,
13-sep-22,MÉX.,"NAUCALPAN DE JUAREZ, MEX.",2,0,2,0,0,245,
13-sep-22,CD. MÉX.,"TLAHUAC, CD. MÉX.",2,0,2,0,0,0,
14-sep-22,MÉX.,"ECATEPEC DE MOR., MEX.",2,0,2,0,0,72,
14-sep-22,CD. MÉX.,"COYOACAN, CD. MÉX.",1,1,2,0,0,124,
15-sep-22,MÉX.,"CUAUTITLAN IZCALLI, MEX.",1,1,2,0,0,494,
15-sep-22,S.L.P.,"SAN LUIS POTOSI, S.L.P.",0,2,2,0,0,0,
15-sep-22,MÉX.,"NAUCALPAN DE JUAREZ, MEX.",1,1,2,0,0,798,
17-sep-22,MÉX.,"TOLUCA, MEX.",1,1,2,0,0,3,
19-sep-22,CD. MÉX.,"TLAHUAC, CD. MÉX.",1,1,2,0,0,0,
19-sep-22,MÉX.,"NICOLAS ROMERO, MEX.",0,2,2,0,0,0,
20-sep-22,CD. MÉX.,"AZCAPOTZALCO, CD. MÉX.",2,0,2,0,0,206,
21-sep-22,COAH.,"FRONTERA, COAH.",2,0,2,0,0,0,
22-sep-22,MÉX.,"NICOLAS ROMERO, MEX.",0,2,2,0,0,0,
22-sep-22,CD. MÉX.,"CUAUHTEMOC, CD. MÉX.",2,0,2,0,0,52,
22-sep-22,MÉX.,"NEZAHUALCOYOTL, MEX.",1,1,2,0,0,139,
24-sep-22,MÉX.,"TECAMAC, MEX.",1,1,2,0,0,0,
27-sep-22,MÉX.,"OCOYOACAC, MEX.",2,0,2,0,0,0,
27-sep-22,MÉX.,"TECAMAC, MEX.",2,0,2,0,3,400,
27-sep-22,N.L.,"APODACA, N.L.",1,1,2,0,0,43,
28-sep-22,CD. MÉX.,"VENUSTIANO CARRANZA, CD. MÉX.",2,0,2,0,0,17,
28-sep-22,CD. MÉX.,"GUSTAVO A. MADERO, CD. MÉX.",2,0,2,0,0,43,
29-sep-22,MÉX.,"TECAMAC, MEX.",2,0,2,0,0,0,
30-sep-22,COAH.,"ACUÑA, COAH.",1,1,2,0,0,0,
01-oct-22,MÉX.,"OCOYOACAC, MEX.",0,2,2,2,0,8,
03-oct-22,VER.,"POZA RICA DE HGO., VER.",0,2,2,0,0,0,
03-oct-22,MÉX.,"TULTITLAN, MEX.",0,2,2,0,0,52,
03-oct-22,CHIH.,"JUÁREZ, CHIH.",1,1,2,0,0,0,
04-oct-22,VER.,"POZA RICA DE HGO., VER.",0,2,2,0,0,0,
04-oct-22,MÉX.,"TULTITLAN, MEX.",0,2,2,0,0,41,
05-oct-22,MÉX.,"XALATLACO, MEX.",2,0,2,0,0,0,
05-oct-22,MÉX.,"TULTEPEC, MEX.",2,0,2,0,0,0,
06-oct-22,VER.,"POZA RICA DE HGO., VER.",2,0,2,0,0,1106,
06-oct-22,MÉX.,"TULTITLAN, MEX.",2,0,2,1,0,33,
07-oct-22,CD. MÉX.,"ALVARO OBREGON, CD. MÉX.",2,0,2,0,0,200,
07-oct-22,CD. MÉX.,"TLALPAN, CD. MÉX.",1,1,2,0,0,128,
07-oct-22,VER.,"POZA RICA DE HGO., VER.",2,0,2,0,0,1106,
08-oct-22,TLAX.,"ESPAÑITA, TLAX.",0,2,2,0,0,0,
08-oct-22,TLAX.,"ALTZAYANCA, TLAX.",0,2,2,0,0,0,
08-oct-22,VER.,"POZA RICA DE HGO., VER.",2,0,2,0,0,1106,
08-oct-22,MÉX.,"TULTITLAN, MEX.",1,1,2,0,0,6,
10-oct-22,MÉX.,"ATLACOMULCO, MEX.",1,1,2,0,0,0,
10-oct-22,MÉX.,"OTZOLOTEPEC, MEX.",1,1,2,0,0,14,
10-oct-22,TLAX.,"APIZACO, TLAX.",1,1,2,0,0,0,
11-oct-22,SIN.,"CONCORDIA, SIN.",1,1,2,0,1,0,
12-oct-22,MÉX.,"OTZOLOTEPEC, MEX.",2,0,2,0,0,0,
13-oct-22,QRO.,"CORREGIDORA, QRO.",1,1,2,0,0,50,
13-oct-22,CD. MÉX.,"ALVARO OBREGON, CD. MÉX.",2,0,2,0,0,10,
14-oct-22,CHIH.,"JUÁREZ, CHIH.",1,1,2,1,0,507,
14-oct-22,TLAX.,"SANCTORUM DE LAZARO CARDENAS, TLAX.",2,0,2,0,0,0,
14-oct-22,TLAX.,"TERRENATE, TLAX.",0,2,2,0,0,0,
17-oct-22,MÉX.,"EL ORO, MEX.",1,1,2,0,0,0,
17-oct-22,CD. MÉX.,"CUAUHTEMOC, CD. MÉX.",2,0,2,0,0,0,
17-oct-22,MÉX.,"HUEHUETOCA, MEX.",1,1,2,0,0,28,
18-oct-22,CD. MÉX.,"TLALPAN, CD. MÉX.",1,1,2,0,2,113,
18-oct-22,TLAX.,"APETATITLAN DE ANTONIO CARVAJAL, TLAX.",1,1,2,0,0,0,
18-oct-22,MÉX.,"HUEHUETOCA, MEX.",2,0,2,0,18,0,
18-oct-22,MOR.,"YECAPIXTLA, MOR.",2,0,2,0,0,78,
19-oct-22,CHIH.,"JUÁREZ, CHIH.",0,2,2,0,0,249,
19-oct-22,TLAX.,"HUEYOTLIPAN, TLAX.",2,0,2,0,0,0,
20-oct-22,TLAX.,"IXTACUIXTLA DE MARIANO MATAMOROS, TLAX.",0,2,2,0,0,0,
20-oct-22,MOR.,"YECAPIXTLA, MOR.",2,0,2,7,1,38,
20-oct-22,OAX.,"SAN JUAN CACAHUATEPEC, OAX.",2,0,2,0,0,0,
20-oct-22,COAH.,"CASTAÑOS, COAH.",2,0,2,0,0,0,
21-oct-22,MÉX.,"EL ORO, MEX.",2,0,2,0,0,0,
22-oct-22,MÉX.,"METEPEC, MEX.",1,1,2,0,0,13,
24-oct-22,TLAX.,"TLAX., TLAX.",0,2,2,0,0,0,
24-oct-22,MOR.,"CUAUTLA, MOR.",0,2,2,3,0,0,
25-oct-22,SIN.,"MAZATLAN, SIN.",1,1,2,0,0,106,
25-oct-22,MÉX.,"NEXTLALPAN, MEX., MEX.",1,1,2,0,0,4,
25-oct-22,N.L.,"MONTERREY, N.L.",0,2,2,0,0,11,
26-oct-22,TLAX.,"TLAX., TLAX.",0,2,2,0,0,0,
27-oct-22,SIN.,"MAZATLAN, SIN.",1,1,2,0,0,391,
27-oct-22,MÉX.,"LERMA, MEX.",1,1,2,0,0,6,
27-oct-22,TLAX.,"TLAX., TLAX.",2,0,2,0,0,0,
28-oct-22,CD. MÉX.,"GUSTAVO A. MADERO, CD. MÉX.",2,0,2,0,0,40,
28-oct-22,CD. MÉX.,"TLALPAN, CD. MÉX.",1,1,2,0,0,0,
28-oct-22,SIN.,"MAZATLAN, SIN.",1,1,2,0,0,55,
29-oct-22,TLAX.,"SAN DAMIAN TEXOLOC, TLAX.",1,1,2,0,0,0,
31-oct-22,CHIH.,"JUÁREZ, CHIH.",2,0,2,8,0,0,
31-oct-22,SIN.,"COSALA, SIN.",1,1,2,0,0,0,
01-nov-22,MÉX.,"CUAUTITLAN, MEX.",2,0,2,0,0,0,
01-nov-22,MÉX.,"SAN MATEO ATENCO, MEX.",2,0,2,0,0,49,
02-nov-22,TLAX.,"CONTLA DE JUAN CUAMATZI, TLAX.",1,1,2,0,0,0,
03-nov-22,CD. MÉX.,"TLALPAN, CD. MÉX.",2,0,2,0,0,0,
03-nov-22,MÉX.,"SAN MATEO ATENCO, MEX.",2,0,2,0,0,0,
04-nov-22,MÉX.,"SAN MATEO ATENCO, MEX.",2,0,2,0,0,107,
04-nov-22,MÉX.,"ZINACANTEPEC, MEX.",0,2,2,0,0,0,
04-nov-22,TLAX.,"CONTLA DE JUAN CUAMATZI, TLAX.",2,0,2,0,0,0,
04-nov-22,COAH.,"SAN JUAN DE SABINAS, COAH.",2,0,2,0,0,0,
05-nov-22,CHIS.,"TAPACHULA, CHIS.",0,2,2,3,0,0,
06-nov-22,VER.,"POZA RICA DE HGO., VER.",1,1,2,1,0,143,
07-nov-22,SIN.,"ELOTA, SIN.",2,0,2,0,0,0,
07-nov-22,CHIS.,"SAN CRISTOBAL DE LAS CASAS, CHIS.",2,0,2,0,0,0,
07-nov-22,JAL.,"TOMATLAN, JAL.",1,1,2,0,0,0,
07-nov-22,MÉX.,"IXTAPALUCA, MEX.",2,0,2,0,0,16,
07-nov-22,MÉX.,"COACALCO DE BERRIOZABAL, MEX.",2,0,2,0,0,101,
07-nov-22,VER.,"ACAYUCAN, VER.",2,0,2,0,0,0,
08-nov-22,JAL.,"TOMATLAN, JAL.",2,0,2,0,0,0,
08-nov-22,CHIS.,"TUXTLA GUTIÉRREZ, CHIS.",1,1,2,3,0,1062,
08-nov-22,CHIS.,"BERRIOZÁBAL, CHIS.",2,0,2,0,0,900,
09-nov-22,COAH.,"ACUÑA, COAH.",0,2,2,0,0,0,
09-nov-22,VER.,"ACAYUCAN, VER.",1,1,2,0,0,300,
10-nov-22,CD. MÉX.,"GUSTAVO A. MADERO, CD. MÉX.",2,0,2,0,0,0,
10-nov-22,CHIS.,"TUXTLA GUTIÉRREZ, CHIS.",1,1,2,8,4,692,
11-nov-22,MÉX.,"SAN MARTIN DE LAS PIRAMIDES, MEX.",2,0,2,0,0,0,
12-nov-22,VER.,"PAPANTLA, VER.",2,0,2,0,0,82,
13-nov-22,VER.,"ACAYUCAN, VER.",1,1,2,0,0,634,
14-nov-22,CD. MÉX.,"LA MAGDALENA CONTRERAS, CD. MÉX.",2,0,2,0,0,328,
14-nov-22,CD. MÉX.,"IZTAPALAPA, CD. MÉX.",2,0,2,0,0,82,
14-nov-22,HGO.,"CUAUTEPEC DE HINOJOSA, HGO.",2,0,2,1,0,0,
15-nov-22,CD. MÉX.,"CUAUHTEMOC, CD. MÉX.",1,1,2,0,1,0,
16-nov-22,VER.,"PAPANTLA, VER.",0,2,2,0,0,0,
16-nov-22,JAL.,"TOMATLAN, JAL.",1,1,2,0,0,0,
17-nov-22,JAL.,"PUERTO VALLARTA, JAL.",2,0,2,0,0,0,
17-nov-22,CD. MÉX.,"CUAUHTEMOC, CD. MÉX.",2,0,2,0,0,0,
17-nov-22,VER.,"PAPANTLA, VER.",1,1,2,11,0,0,
18-nov-22,CD. MÉX.,"MILPA ALTA, CD. MÉX.",2,0,2,0,0,0,
18-nov-22,VER.,"PAPANTLA, VER.",1,1,2,0,0,1220,
24-nov-22,CD. MÉX.,"AZCAPOTZALCO, CD. MÉX.",1,1,2,0,0,0,
24-nov-22,TAB.,"HUIMANGUILLO, TAB.",1,1,2,0,0,0,
25-nov-22,CD. MÉX.,"AZCAPOTZALCO, CD. MÉX.",0,2,2,0,0,10,
25-nov-22,N.L.,"SANTA CATARINA, N.L.",2,0,2,1,0,105,
28-nov-22,SIN.,"CULIACAN, SIN.",1,1,2,0,0,42,
30-nov-22,CD. MÉX.,"CUAUHTEMOC, CD. MÉX.",0,2,2,0,0,0,
30-nov-22,N.L.,"LINARES, N.L.",2,0,2,0,0,60,
30-nov-22,SIN.,"NAVOLATO, SIN.",2,0,2,0,0,0,
02-dic-22,SIN.,"NAVOLATO, SIN.",1,1,2,0,0,4,
06-dic-22,SON.,"HERMOSILLO, SON.",2,0,2,0,0,0,
06-dic-22,JAL.,"TOMATLAN, JAL.",1,1,2,0,0,0,
07-dic-22,JAL.,"TOMATLAN, JAL.",1,1,2,0,0,0,
08-dic-22,SIN.,"CULIACAN, SIN.",1,1,2,0,0,2,
08-dic-22,S.L.P.,"ZARAGOZA, S.L.P.",2,0,2,0,1,0,
08-dic-22,JAL.,"TOMATLAN, JAL.",1,1,2,0,0,0,
09-dic-22,SIN.,"CULIACAN, SIN.",1,1,2,0,1,721,
09-dic-22,SON.,"HERMOSILLO, SON.",1,1,2,0,1,400,
13-dic-22,CD. MÉX.,"VENUSTIANO CARRANZA, CD. MÉX.",2,0,2,0,0,10,
13-dic-22,CHIH.,"JUÁREZ, CHIH.",1,1,2,5,0,40,
14-dic-22,SON.,"HERMOSILLO, SON.",2,0,2,4,0,2000,
14-dic-22,N.L.,"ALLENDE, N.L.",2,0,2,0,0,84,
16-dic-22,MICH.,"MORELIA, MICH.",2,0,2,0,2,0,
16-dic-22,CD. MÉX.,"COYOACAN, CD. MÉX.",0,2,2,0,0,302,
16-dic-22,SIN.,"CULIACAN, SIN.",2,0,2,0,2,1971,
16-dic-22,SIN.,"CULIACAN, SIN.",2,0,2,0,2,1971,
07-feb-23,Cd. de México,"TLAHUAC, CD. MÉX.",1,1,2,0,0,0,
13-feb-23,Cd. de México,"ALVARO OBREGON, CD. MÉX.",2,0,2,0,0,0,
15-feb-23,Cd. de México,"BENITO JUAREZ, CD. MÉX.",1,1,2,0,0,0,
17-feb-23,Cd. de México,"ALVARO OBREGON, CD. MÉX.",2,0,2,0,0,0,
17-feb-23,Cd. de México,"BENITO JUAREZ, CD. MÉX.",2,0,2,0,0,38,
21-feb-23,Cd. de México,"TLALPAN, CD. MÉX.",1,1,2,0,0,102,
22-feb-23,Cd. de México,"TLALPAN, CD. MÉX.",1,1,2,0,0,0,
23-feb-23,Cd. de México,"CUAUHTEMOC, CD. MÉX.",2,0,2,0,0,120,
28-feb-23,Morelos,"ZACATEPEC, MOR.",1,1,2,1,0,6,
02-mar-23,Morelos,"ZACATEPEC, MOR.",2,0,2,0,0,0,
06-mar-23,Cd. de México,"IZTACALCO, CD. MÉX.",1,1,2,0,0,10,
06-mar-23,México,"COACALCO DE BERRIOZABAL, MEX.",2,0,2,1,0,12,
06-mar-23,México,"NEZAHUALCOYOTL, MEX.",1,1,2,0,11,0,
07-mar-23,México,"COACALCO DE BERRIOZABAL, MEX.",1,1,2,0,0,0,
09-mar-23,Cd. de México,"CUAUHTEMOC, CD. MÉX.",2,0,2,0,0,41,
09-mar-23,Veracruz,"JALTIPAN, VER.",2,0,2,3,0,"11,333",
09-mar-23,México,"ECATEPEC DE MORELOS, MEX.",2,0,2,0,0,104,
10-mar-23,Cd. de México,"CUAUHTEMOC, CD. MÉX.",2,0,2,0,0,46,
11-mar-23,Veracruz,"JALTIPAN, VER.",2,0,2,0,0,"2,107",
13-mar-23,Cd. de México,"CUAUHTEMOC, CD. MÉX.",1,1,2,0,0,50,
14-mar-23,México,"IXTAPALUCA, MEX.",1,1,2,0,0,186,
14-mar-23,México,"IXTAPALUCA, MEX.",1,1,2,0,0,186,
14-mar-23,Cd. de México,"MIGUEL HIDALGO, CD. MÉX.",0,2,2,0,0,0,
14-mar-23,Cd. de México,"IZTACALCO, CD. MÉX.",1,1,2,0,0,156,
15-mar-23,Cd. de México,"GUSTAVO A. MADERO, CD. MÉX.",2,0,2,0,0,26,
21-mar-23,Cd. de México,"LA MAGDALENA CONTRERAS, CD. MÉX.",2,0,2,0,0,0,
22-mar-23,México,"TOLUCA, MEX.",2,0,2,0,0,68,
23-mar-23,México,"CUAUTITLAN IZCALLI, MEX.",2,0,2,0,0,0,
23-mar-23,Cd. de México,"CUAUHTEMOC, CD. MÉX.",2,0,2,0,0,303,
23-mar-23,México,"TOLUCA, MEX.",0,2,2,0,0,15,
23-mar-23,Coahuila,"ACUÑA, COAH.",2,0,2,2,2,137,
23-mar-23,Chiapas,"LA TRINITARIA, CHIS.",1,1,2,4,0,102,
24-mar-23,Coahuila,"ACUÑA, COAH.",0,2,2,1,0,0,
25-mar-23,México,"CUAUTITLAN IZCALLI, MEX.",2,0,2,0,0,0,
27-mar-23,Cd. de México,"CUAUHTEMOC, CD. MÉX.",1,1,2,0,0,168,
28-mar-23,México,"CUAUTITLAN IZCALLI, MEX.",2,0,2,0,0,81,
28-mar-23,Coahuila,"PIEDRAS NEGRAS, COAH.",2,0,2,0,0,0,
28-mar-23,México,"TOLUCA, MEX.",2,0,2,0,0,9,
29-mar-23,México,"NAUCALPAN DE JUAREZ, MEX.",1,1,2,0,0,0,
30-mar-23,Coahuila,"PIEDRAS NEGRAS, COAH.",2,0,2,0,0,6,
31-mar-23,México,"NAUCALPAN DE JUAREZ, MEX.",2,0,2,0,0,137,
11-abr-23,Cd. de México,"AZCAPOTZALCO, CD. MÉX.",1,1,2,0,0,0,
13-abr-23,Guanajuato,"ACAMBARO, GTO.",2,0,2,0,0,0,
13-abr-23,Cd. de México,"TLALPAN, CD. MÉX.",1,1,2,0,0,77,
18-abr-23,Cd. de México,"BENITO JUAREZ, CD. MÉX.",2,0,2,0,0,60,
20-abr-23,Cd. de México,"IZTAPALAPA, CD. MÉX.",2,0,2,0,0,27,
20-abr-23,Cd. de México,"TLALPAN, CD. MÉX.",2,0,2,0,0,0,
22-abr-23,Querétaro,"CORREGIDORA, QRO.",1,1,2,0,1,42,
24-abr-23,Cd. de México,"COYOACAN, CD. MÉX.",2,0,2,0,0,163,
24-abr-23,Cd. de México,"CUAUHTEMOC, CD. MÉX.",0,2,2,0,0,459,
24-abr-23,Querétaro,"CORREGIDORA, QRO.",2,0,2,0,2,2,
25-abr-23,Cd. de México,"COYOACAN, CD. MÉX.",2,0,2,0,0,0,
02-may-23,Cd. de México,"XOCHIMILCO, CD. MÉX.",2,0,2,0,0,0,
09-may-23,Cd. de México,"MIGUEL HIDALGO, CD. MÉX.",2,0,2,0,0,0,
09-may-23,Cd. de México,"CUAUHTEMOC, CD. MÉX.",2,0,2,0,0,56,
09-may-23,Cd. de México,"VENUSTIANO CARRANZA, CD. MÉX.",2,0,2,0,0,218,
11-may-23,Colima,"MINATITLÁN, COL.",1,1,2,0,0,0,
18-may-23,Cd. de México,"VENUSTIANO CARRANZA, CD. MÉX.",2,0,2,0,0,30,
18-may-23,Michoacán,"JACONA, MICH.",2,0,2,5,0,364,
18-may-23,Cd. de México,"TLALPAN, CD. MÉX.",1,1,2,0,0,202,
23-may-23,Cd. de México,"TLALPAN, CD. MÉX.",1,1,2,0,0,20,
24-may-23,Cd. de México,"CUAUHTEMOC, CD. MÉX.",0,2,2,0,0,0,
25-may-23,Cd. de México,"CUAUHTEMOC, CD. MÉX.",2,0,2,0,0,377,
26-may-23,Querétaro,"SAN JUAN DEL RIO, QRO.",1,1,2,0,0,0,
01-jun-23,Querétaro,"QUERETARO, QRO.",1,1,2,0,0,0,
01-jun-23,Sinaloa,"SINALOA, SIN.",0,2,2,0,0,0,
06-jun-23,Cd. de México,"COYOACAN, CD. MÉX.",1,1,2,0,0,7,
06-jun-23,Sinaloa,"CHOIX, SIN.",2,0,2,0,0,120,
06-jun-23,Cd. de México,"VENUSTIANO CARRANZA, CD. MÉX.",1,1,2,0,0,651,
06-jun-23,Querétaro,"QUERETARO, QRO.",2,0,2,0,0,0,
07-jun-23,Sinaloa,"SINALOA, SIN.",2,0,2,0,0,0,
07-jun-23,Cd. de México,"CUAUHTEMOC, CD. MÉX.",1,1,2,0,0,267,
07-jun-23,Cd. de México,"VENUSTIANO CARRANZA, CD. MÉX.",1,1,2,0,0,651,
08-jun-23,Cd. de México,"CUAUHTEMOC, CD. MÉX.",1,1,2,0,0,0,
08-jun-23,Cd. de México,"COYOACAN, CD. MÉX.",2,0,2,0,0,36,
08-jun-23,Cd. de México,"VENUSTIANO CARRANZA, CD. MÉX.",2,0,2,0,1,0,
08-jun-23,Sinaloa,"SINALOA, SIN.",2,0,2,0,0,0,
09-jun-23,Cd. de México,"CUAUHTEMOC, CD. MÉX.",2,0,2,0,0,179,
09-jun-23,Querétaro,"SAN JOAQUIN, QRO.",2,0,2,0,0,0,
09-jun-23,Querétaro,"QUERETARO, QRO.",2,0,2,0,0,0,
12-jun-23,Cd. de México,"CUAUHTEMOC, CD. MÉX.",1,1,2,0,0,494,
12-jun-23,México,"LA PAZ, MEX.",0,2,2,0,0,54,
12-jun-23,Morelos,"CUERNAVACA, MOR.",0,2,2,11,0,393,
13-jun-23,Cd. de México,"MIGUEL HIDALGO, CD. MÉX.",1,1,2,0,0,0,
13-jun-23,Querétaro,"SAN JOAQUIN, QRO.",1,1,2,0,0,100,
14-jun-23,México,"LERMA, MEX.",2,0,2,0,0,35,
15-jun-23,Cd. de México,"CUAUHTEMOC, CD. MÉX.",1,1,2,0,0,244,
16-jun-23,Cd. de México,"CUAUHTEMOC, CD. MÉX.",2,0,2,0,0,53,
17-jun-23,Aguascalientes,"JESÚS MARÍA, AGS.",2,0,2,0,0,5,
19-jun-23,Tlaxcala,"CONTLA DE JUAN CUAMATZI, TLAX.",2,0,2,0,0,0,
19-jun-23,Cd. de México,"VENUSTIANO CARRANZA, CD. MÉX.",2,0,2,0,0,0,
20-jun-23,Tlaxcala,"APIZACO, TLAX.",2,0,2,0,0,0,
20-jun-23,Querétaro,"QUERETARO, QRO.",1,1,2,0,0,65,
21-jun-23,Tlaxcala,"TLAXCALA, TLAX.",1,1,2,0,1,0,
21-jun-23,México,"NICOLAS ROMERO, MEX.",2,0,2,1,0,68,
22-jun-23,Tlaxcala,"TLAXCALA, TLAX.",1,1,2,0,0,0,
22-jun-23,Guanajuato,"VALLE DE SANTIAGO, GTO.",0,2,2,1,17,228,
23-jun-23,Guanajuato,"SALAMANCA, GTO.",0,2,2,0,0,354,
23-jun-23,México,"ZINACANTEPEC, MEX.",2,0,2,0,0,0,
23-jun-23,Tlaxcala,"HUAMANTLA, TLAX.",0,2,2,0,0,0,
23-jun-23,Chihuahua,"NUEVO CASAS GRANDES, CHIH.",1,1,2,0,0,0,
23-jun-23,Cd. de México,"MIGUEL HIDALGO, CD. MÉX.",2,0,2,0,0,7,
24-jun-23,Tlaxcala,"HUAMANTLA, TLAX.",1,1,2,0,0,0,
24-jun-23,Tlaxcala,"APIZACO, TLAX.",2,0,2,0,0,0,
26-jun-23,Tlaxcala,"CALPULALPAN, TLAX.",2,0,2,0,0,0,
26-jun-23,Cd. de México,"CUAUHTEMOC, CD. MÉX.",2,0,2,0,0,415,
26-jun-23,Sinaloa,"ANGOSTURA, SIN.",2,0,2,0,0,0,
26-jun-23,Querétaro,"QUERETARO, QRO.",2,0,2,0,0,0,
27-jun-23,Michoacán,"ZAMORA, MICH.",2,0,2,39,0,451,
27-jun-23,México,"VILLA VICTORIA, MEX.",2,0,2,0,0,0,
27-jun-23,Sinaloa,"ANGOSTURA, SIN.",1,1,2,0,0,65,
28-jun-23,Cd. de México,"ALVARO OBREGON, CD. MÉX.",1,1,2,0,0,92,
28-jun-23,Tlaxcala,"TLAXCALA, TLAX.",1,1,2,0,0,86,
28-jun-23,Tlaxcala,"IXTACUIXTLA DE MARIANO MATAMOROS, TLAX.",1,1,2,0,0,0,
28-jun-23,Veracruz,"MISANTLA, VER.",2,0,2,0,0,0,
01-jul-23,Veracruz,"MISANTLA, VER.",1,1,2,0,0,230,
01-jul-23,Tlaxcala,"IXTACUIXTLA DE MARIANO MATAMOROS, TLAX.",1,1,2,0,0,0,
01-jul-23,México,"METEPEC, MEX.",0,2,2,0,1,0,
03-jul-23,Cd. de México,"CUAUHTEMOC, CD. MÉX.",2,0,2,0,0,497,
04-jul-23,Tlaxcala,"SANTA CRUZ TLAXCALA, TLAX.",1,1,2,0,0,0,
04-jul-23,México,"CHIMALHUACAN, MEX.",2,0,2,0,0,19,
04-jul-23,México,"OTZOLOTEPEC, MEX.",2,0,2,1,0,107,
04-jul-23,Sinaloa,"GUASAVE, SIN.",1,1,2,0,0,0,
04-jul-23,Cd. de México,"CUAUHTEMOC, CD. MÉX.",1,1,2,0,0,148,
04-jul-23,Cd. de México,"IZTAPALAPA, CD. MÉX.",1,1,2,0,0,100,
04-jul-23,México,"VALLE DE CHALCO SOLIDARIDAD, MEX.",2,0,2,0,0,18,
07-jul-23,México,"CHIMALHUACAN, MEX.",2,0,2,0,0,0,
07-jul-23,Chiapas,"SAN CRISTOBAL DE LAS CASAS, CHIS.",1,1,2,0,0,742,
07-jul-23,México,"XALATLACO, MEX.",2,0,2,1,0,10,
08-jul-23,México,"CHIMALHUACAN, MEX.",1,1,2,0,0,42,
08-jul-23,México,"OTZOLOTEPEC, MEX.",2,0,2,0,0,134,
08-jul-23,Chiapas,"TUXTLA GUTIÉRREZ, CHIS.",2,0,2,0,0,0,
09-jul-23,Tlaxcala,"SAN PABLO DEL MONTE, TLAX.",1,1,2,0,0,0,
10-jul-23,Chihuahua,"NUEVO CASAS GRANDES, CHIH.",1,1,2,11,0,402,
11-jul-23,Querétaro,"CORREGIDORA, QRO.",1,1,2,0,2,120,
11-jul-23,Tamaulipas,"VICTORIA, TAMPS.",0,2,2,0,0,0,
12-jul-23,Chiapas,"TUXTLA GUTIÉRREZ, CHIS.",1,1,2,0,0,209,
12-jul-23,Cd. de México,"CUAUHTEMOC, CD. MÉX.",2,0,2,0,0,0,
13-jul-23,Tlaxcala,"TERRENATE, TLAX.",1,1,2,0,0,0,
13-jul-23,Cd. de México,"BENITO JUAREZ, CD. MÉX.",2,0,2,0,0,32,
14-jul-23,Tlaxcala,"TETLA DE LA SOLIDARIDAD, TLAX.",0,2,2,0,0,0,
14-jul-23,Querétaro,"CORREGIDORA, QRO.",2,0,2,5,0,90,
15-jul-23,México,"COYOTEPEC, MEX.",1,1,2,0,2,0,
18-jul-23,Tlaxcala,"TLAXCALA, TLAX.",2,0,2,0,0,0,
19-jul-23,Durango,"GOMEZ PALACIO, DGO.",2,0,2,3,0,21,
19-jul-23,México,"JOCOTITLAN, MEX.",1,1,2,0,2,0,
20-jul-23,Tlaxcala,"YAUHQUEMECAN, TLAX.",0,2,2,0,0,0,
22-jul-23,México,"CAPULHUAC, MEX.",1,1,2,0,0,0,
28-jul-23,Chiapas,"VILLAFLORES, CHIS.",2,0,2,2,0,"1,888",
30-jul-23,Chiapas,"VILLAFLORES, CHIS.",1,1,2,0,0,"3,667",
01-ago-23,México,"HUIXQUILUCAN, MEX.",2,0,2,0,0,0,
02-ago-23,México,"XONACATLAN, MEX.",2,0,2,0,7,0,
02-ago-23,México,"CUAUTITLAN, MEX.",2,0,2,0,80,0,
03-ago-23,México,"CHICOLOAPAN, MEX.",2,0,2,0,0,0,
04-ago-23,México,"CHICOLOAPAN, MEX.",1,1,2,0,0,33,
05-ago-23,México,"CHICOLOAPAN, MEX.",2,0,2,0,3,50,
07-ago-23,Chiapas,"CHENALHÓ, CHIS.",0,2,2,0,0,0,
07-ago-23,Cd. de México,"CUAUHTEMOC, CD. MÉX.",2,0,2,0,0,13,
07-ago-23,Tamaulipas,"VICTORIA, TAMPS.",2,0,2,0,0,0,
09-ago-23,Michoacán,"ALVARO OBREGON, MICH.",1,1,2,64,0,7,
09-ago-23,México,"ATLACOMULCO, MEX.",2,0,2,1,0,0,
10-ago-23,Michoacán,"ALVARO OBREGON, MICH.",0,2,2,116,0,0,
10-ago-23,México,"ATLACOMULCO, MEX.",2,0,2,0,0,86,
12-ago-23,México,"ATLACOMULCO, MEX.",1,1,2,0,0,0,
14-ago-23,Cd. de México,"GUSTAVO A. MADERO, CD. MÉX.",0,2,2,0,0,49,
16-ago-23,Chihuahua,"JUÁREZ, CHIH.",1,1,2,1,0,15,
16-ago-23,Chihuahua,"JUÁREZ, CHIH.",1,1,2,1,0,15,
17-ago-23,Sinaloa,"MOCORITO, SIN.",1,1,2,0,0,0,
17-ago-23,Michoacán,"CUITZEO, MICH.",2,0,2,110,0,15,
18-ago-23,Cd. de México,"MIGUEL HIDALGO, CD. MÉX.",1,1,2,0,0,146,
18-ago-23,Sinaloa,"BADIRAGUATO, SIN.",1,1,2,0,0,0,
19-ago-23,Querétaro,"PEDRO ESCOBEDO, QRO.",1,1,2,0,0,0,
21-ago-23,Cd. de México,"MIGUEL HIDALGO, CD. MÉX.",0,2,2,0,0,7,
22-ago-23,Puebla,"CUETZALAN DEL PROGRESO, PUE.",2,0,2,0,0,0,
22-ago-23,Sinaloa,"MOCORITO, SIN.",1,1,2,0,0,0,
24-ago-23,Cd. de México,"MIGUEL HIDALGO, CD. MÉX.",2,0,2,0,0,54,
24-ago-23,Sinaloa,"BADIRAGUATO, SIN.",1,1,2,0,0,0,
24-ago-23,Sinaloa,"SALVADOR ALVARADO, SIN.",0,2,2,0,0,0,
25-ago-23,Sinaloa,"BADIRAGUATO, SIN.",0,2,2,0,0,0,
25-ago-23,Cd. de México,"BENITO JUAREZ, CD. MÉX.",2,0,2,0,0,0,
26-ago-23,Michoacán,"COPANDARO, MICH.",0,2,2,3,0,19,
30-ago-23,Querétaro,"EL MARQUES, QRO.",2,0,2,0,0,129,
30-ago-23,Cd. de México,"GUSTAVO A. MADERO, CD. MÉX.",0,2,2,0,0,"2,170",
30-ago-23,Chiapas,"TUXTLA GUTIÉRREZ, CHIS.",0,2,2,0,0,"1,000",
30-ago-23,Michoacán,"CUITZEO, MICH.",1,1,2,1,0,22,
30-ago-23,Chihuahua,"OJINAGA, CHIH.",1,1,2,1,0,40,
31-ago-23,Chiapas,"COPAINALÁ, CHIS.",0,2,2,0,0,550,
31-ago-23,Michoacán,"CUITZEO, MICH.",1,1,2,1,0,36,
31-ago-23,Tamaulipas,"REYNOSA, TAMPS.",2,0,2,60,0,693,
31-ago-23,Cd. de México,"GUSTAVO A. MADERO, CD. MÉX.",2,0,2,0,0,6,
01-sep-23,Tabasco,"CARDENAS, TAB.",1,1,2,1,0,105,
01-sep-23,Cd. de México,"GUSTAVO A. MADERO, CD. MÉX.",2,0,2,0,0,0,
01-sep-23,Morelos,"JIUTEPEC, MOR.",2,0,2,7,0,407,
06-sep-23,Tamaulipas,"NUEVO LAREDO, TAMPS.",2,0,2,0,0,0,
07-sep-23,Tamaulipas,"NUEVO LAREDO, TAMPS.",2,0,2,5,0,189,
08-sep-23,Chihuahua,"JUÁREZ, CHIH.",2,0,2,1,0,32,
14-sep-23,Cd. de México,"VENUSTIANO CARRANZA, CD. MÉX.",2,0,2,0,0,0,
19-sep-23,Chihuahua,"JUÁREZ, CHIH.",0,2,2,0,0,237,
21-sep-23,Cd. de México,"CUAUHTEMOC, CD. MÉX.",2,0,2,0,0,27,
25-sep-23,Cd. de México,"XOCHIMILCO, CD. MÉX.",2,0,2,0,0,670,
27-sep-23,Chihuahua,"JUÁREZ, CHIH.",2,0,2,30,0,132,
04-oct-23,Sinaloa,"MAZATLAN, SIN.",2,0,2,0,0,147,
05-oct-23,Chiapas,"SUCHIAPA, CHIS.",2,0,2,0,0,693,
05-oct-23,Cd. de México,"VENUSTIANO CARRANZA, CD. MÉX.",2,0,2,0,0,95,
05-oct-23,Cd. de México,"ALVARO OBREGON, CD. MÉX.",2,0,2,0,0,12,
09-oct-23,Chihuahua,"CHIHUAHUA, CHIH.",2,0,2,0,0,467,
10-oct-23,Cd. de México,"ALVARO OBREGON, CD. MÉX.",2,0,2,0,0,153,
10-oct-23,Sinaloa,"ESCUINAPA, SIN.",2,0,2,0,0,0,
12-oct-23,Chihuahua,"JUÁREZ, CHIH.",2,0,2,0,5,635,
14-oct-23,Chihuahua,"CHIHUAHUA, CHIH.",2,0,2,12,0,409,
17-oct-23,Cd. de México,"GUSTAVO A. MADERO, CD. MÉX.",1,1,2,0,0,0,
24-oct-23,Cd. de México,"CUAUHTEMOC, CD. MÉX.",2,0,2,0,0,0,
25-oct-23,Tlaxcala,"APETATITLAN DE ANTONIO CARVAJAL, TLAX.",0,2,2,0,0,0,
25-oct-23,Tlaxcala,"TOTOLAC, TLAX.",2,0,2,0,0,0,
26-oct-23,Tlaxcala,"APIZACO, TLAX.",1,1,2,0,0,0,
27-oct-23,Tlaxcala,"APIZACO, TLAX.",2,0,2,0,0,0,
30-oct-23,Sinaloa,"COSALA, SIN.",1,1,2,0,0,0,
31-oct-23,Tlaxcala,"APIZACO, TLAX.",2,0,2,0,0,0,
01-nov-23,Coahuila,"MONCLOVA, COAH.",2,0,2,1,0,20,
07-nov-23,Chiapas,"CHENALHÓ, CHIS.",0,2,2,0,0,0,
07-nov-23,Sinaloa,"SAN IGNACIO, SIN.",0,2,2,0,0,0,
09-nov-23,Sinaloa,"SAN IGNACIO, SIN.",1,1,2,0,2,0,
11-nov-23,Tlaxcala,"IXTACUIXTLA DE MARIANO MATAMOROS, TLAX.",2,0,2,0,0,0,
11-nov-23,Tlaxcala,"CHIAUTEMPAN, TLAX.",2,0,2,0,0,0,
13-nov-23,Cd. de México,"CUAUHTEMOC, CD. MÉX.",2,0,2,0,0,22,
14-nov-23,Cd. de México,"CUAJIMALPA DE MORELOS, CD. MÉX.",2,0,2,0,0,0,
17-nov-23,Tlaxcala,"TLAXCALA, TLAX.",1,1,2,0,0,0,
17-nov-23,Tlaxcala,"NATIVITAS, TLAX.",1,1,2,0,0,0,
18-nov-23,Tamaulipas,"TAMPICO, TAMPS.",2,0,2,0,0,51,
19-nov-23,San Luis Potosí,"SAN LUIS POTOSI, S.L.P.",1,1,2,23,0,22,
24-nov-23,Cd. de México,"BENITO JUAREZ, CD. MÉX.",1,1,2,0,0,136,
24-nov-23,Chihuahua,"JUÁREZ, CHIH.",2,0,2,2,1,689,
24-nov-23,Tamaulipas,"TAMPICO, TAMPS.",2,0,2,2,0,42,
25-nov-23,Morelos,"CUAUTLA, MOR.",2,0,2,2,0,304,
28-nov-23,Sinaloa,"ELOTA, SIN.",2,0,2,0,0,0,
30-nov-23,Sinaloa,"ELOTA, SIN.",1,1,2,0,0,0,
01-dic-23,Sinaloa,"CULIACAN, SIN.",1,1,2,0,0,62,
01-dic-23,Chihuahua,"JUÁREZ, CHIH.",2,0,2,1,0,96,
06-dic-23,Cd. de México,"CUAUHTEMOC, CD. MÉX.",2,0,2,0,0,0,
06-dic-23,Coahuila,"SACRAMENTO, COAH.",2,0,2,0,0,0,
07-dic-23,Cd. de México,"MILPA ALTA, CD. MÉX.",1,1,2,0,0,0,
08-dic-23,Sinaloa,"CULIACAN, SIN.",2,0,2,0,1,311,
11-dic-23,Cd. de México,"COYOACAN, CD. MÉX.",2,0,2,0,0,32,
11-dic-23,Sinaloa,"CULIACAN, SIN.",2,0,2,0,4,0,
12-dic-23,Chihuahua,"JUÁREZ, CHIH.",1,1,2,7,0,185,
12-dic-23,Sinaloa,"CULIACAN, SIN.",2,0,2,0,0,71,
13-dic-23,Chiapas,"CHENALHÓ, CHIS.",0,2,2,0,0,0,
13-dic-23,Sinaloa,"CULIACAN, SIN.",1,1,2,0,1,742,
16-dic-23,Chiapas,"CHENALHÓ, CHIS.",0,2,2,0,0,0,
21-dic-23,Zacatecas,"ZACATECAS, ZAC.",0,2,2,0,0,14,
19-ene-24,Zacatecas,"TLALTENANGO DE SANCHEZ ROMAN, ZAC.",2,0,2,0,0,0,
08-feb-24,Zacatecas,"JEREZ, ZAC.",2,0,2,15,0,123,
04-mar-24,Cd. de México,"CUAUHTEMOC, CD. MÉX.",2,0,2,0,0,0,
11-mar-24,Cd. de México,"IZTAPALAPA, CD. MÉX.",2,0,2,0,0,0,
05-mar-24,Zacatecas,"FRESNILLO, ZAC.",1,1,2,7,0,317,
12-mar-24,Cd. de México,"IZTAPALAPA, CD. MÉX.",2,0,2,0,0,8,
13-mar-24,Cd. de México,"GUSTAVO A. MADERO, CD. MÉX.",2,0,2,0,0,69,
14-mar-24,Cd. de México,"TLALPAN, CD. MÉX.",0,2,2,0,0,117,
20-mar-24,Jalisco,"PUERTO VALLARTA, JAL.",1,1,2,0,0,0,
26-mar-24,Cd. de México,"GUSTAVO A. MADERO, CD. MÉX.",0,2,2,0,0,0,
05-mar-24,Cd. de México,"GUSTAVO A. MADERO, CD. MÉX.",2,0,2,0,0,200,
05-abr-24,Cd. de México,"GUSTAVO A. MADERO, CD. MÉX.",2,0,2,0,0,200,
09-abr-24,Cd. de México,"CUAUHTEMOC, CD. MÉX.",2,0,2,0,0,0,
09-abr-24,Cd. de México,"GUSTAVO A. MADERO, CD. MÉX.",2,0,2,0,1,5,
12-abr-24,Cd. de México,"GUSTAVO A. MADERO, CD. MÉX.",2,0,2,0,0,6,
18-abr-24,Cd. de México,"TLAHUAC, CD. MÉX.",1,1,2,0,0,0,
23-abr-24,Cd. de México,"CUAUHTEMOC, CD. MÉX.",2,0,2,0,0,0,
29-abr-24,Cd. de México,"CUAUHTEMOC, CD. MÉX.",1,1,2,0,0,6,
06-may-24,Cd. de México,"IZTAPALAPA, CD. MÉX.",2,0,2,0,0,217,
08-may-24,Cd. de México,"CUAUHTEMOC, CD. MÉX.",2,0,2,0,0,217,
17-may-24,Cd. de México,"CUAUHTEMOC, CD. MÉX.",2,0,2,0,0,494,
22-may-24,Cd. de México,"CUAUHTEMOC, CD. MÉX.",1,1,2,0,0,183,
24-may-24,Cd. de México,"VENUSTIANO CARRANZA, CD. MÉX.",2,0,2,0,0,30,
04-jun-24,Cd. de México,"ALVARO OBREGON, CD. MÉX.",1,1,2,0,0,0,
10-jun-24,Cd. de México,"CUAUHTEMOC, CD. MÉX.",2,0,2,0,0,71,
11-jun-24,Cd. de México,"MIGUEL HIDALGO, CD. MÉX.",2,0,2,0,0,5,
11-jun-24,Veracruz,"BOCA DEL RIO, VER.",2,0,2,32,0,524,
12-jun-24,Veracruz,"VERACRUZ, VER.",1,1,2,91,0,"1,678",
17-jun-24,Cd. de México,"CUAUHTEMOC, CD. MÉX.",2,0,2,0,0,97,
18-jun-24,Sinaloa,"MOCORITO, SIN.",2,0,2,0,0,18,
18-jun-24,Michoacán,"BUENAVISTA, MICH.",2,0,2,4,2,500,
19-jun-24,Sinaloa,"NAVOLATO, SIN.",1,1,2,0,0,0,
19-jun-24,Sinaloa,"COSALA, SIN.",2,0,2,0,2,0,
26-jun-24,Cd. de México,"AZCAPOTZALCO, CD. MÉX.",2,0,2,0,0,153,
25-jun-24,Sinaloa,"NAVOLATO, SIN.",2,0,2,0,0,0,
28-jun-24,Sinaloa,"MOCORITO, SIN.",0,2,2,0,0,3012,
27-jun-24,Zacatecas,"ZACATECAS, ZAC.",0,2,2,6,0,"1,497",
26-jun-24,Sinaloa,"NAVOLATO, SIN.",2,0,2,0,0,0,
12-ene-13,VER.,"COATZACOALCOS, VER.",1,0,1,0,0,14,
26-ene-13,CHIH.,"CUAUHTÉMOC, CHIH.",0,1,1,0,0,0,
03-feb-13,JAL.,"PIHUAMO, JAL.",1,0,1,0,0,0,
05-feb-13,JAL.,"ATOTONILCO EL ALTO, JAL.",1,0,1,0,0,0,
05-feb-13,B.C.,"ENSENADA, B.C.",0,1,1,0,0,0,
06-feb-13,JAL.,"AYOTLAN, JAL.",1,0,1,0,0,0,
08-feb-13,CAMP.,"CALAKMUL, CAMP.",1,0,1,0,0,0,
08-feb-13,CHIH.,"JANOS, CHIH.",0,1,1,0,0,0,
08-feb-13,B.C.,"ENSENADA, B.C.",0,1,1,0,0,0,
09-feb-13,TAMPS.,"GUSTAVO DIAZ ORDAZ, TAMPS.",1,0,1,0,0,0,
12-feb-13,TAMPS.,"VICTORIA, TAMPS.",1,0,1,0,0,30,
12-feb-13,JAL.,"DEGOLLADO, JAL.",1,0,1,0,0,6,
13-feb-13,CAMP.,"CALAKMUL, CAMP.",0,1,1,0,0,0,
13-feb-13,JAL.,"ARANDAS, JAL.",1,0,1,0,0,0,
14-feb-13,TAMPS.,"VICTORIA, TAMPS.",0,1,1,0,0,0,
14-feb-13,JAL.,"DEGOLLADO, JAL.",1,0,1,0,0,0,
15-feb-13,CHIH.,"JUÁREZ, CHIH.",1,0,1,0,0,0,
15-feb-13,JAL.,"TECALITLAN, JAL.",1,0,1,0,0,0,
15-feb-13,GRO.,"TLACOACHISTLAHUACA, GRO.",0,1,1,0,0,0,
16-feb-13,TAMPS.,"NUEVO LAREDO, TAMPS.",1,0,1,11,0,128,
16-feb-13,TAMPS.,"TAMPICO, TAMPS.",1,0,1,6,0,686,
17-feb-13,JAL.,"GUADALAJARA, JAL.",1,0,1,0,0,0,
18-feb-13,GRO.,"ACAPULCO DE JUAREZ, GRO.",1,0,1,0,5,0,
18-feb-13,CHIH.,"CHIH., CHIH.",1,0,1,0,0,32,
18-feb-13,TAMPS.,"MATAMOROS, TAMPS.",1,0,1,0,0,0,
18-feb-13,TAMPS.,"VICTORIA, TAMPS.",0,1,1,0,0,0,
19-feb-13,CHIH.,"CHIH., CHIH.",1,0,1,0,0,128,
19-feb-13,CHIH.,"NUEVO CASAS GRANDES, CHIH.",0,1,1,0,0,0,
19-feb-13,CHIH.,"NUEVO CASAS GRANDES, CHIH.",1,0,1,0,0,0,
21-feb-13,CHIH.,"NUEVO CASAS GRANDES, CHIH.",0,1,1,0,0,0,
21-feb-13,GRO.,"BENITO JUAREZ, GRO.",1,0,1,0,0,0,
22-feb-13,CHIH.,"NUEVO CASAS GRANDES, CHIH.",1,0,1,0,0,0,
22-feb-13,GRO.,"BENITO JUAREZ, GRO.",1,0,1,1,0,0,
23-feb-13,TAMPS.,"ALTAMIRA, TAMPS.",1,0,1,0,0,91,
23-feb-13,HGO.,"HUEJUTLA DE REYES, HGO.",1,0,1,0,0,0,
24-feb-13,TAMPS.,"TAMPICO, TAMPS.",0,1,1,20,1,1127,
24-feb-13,TAMPS.,"ALTAMIRA, TAMPS.",0,1,1,0,0,114,
25-feb-13,CAMP.,"CALAKMUL, CAMP.",1,0,1,0,0,0,
26-feb-13,CHIH.,"ALDAMA, CHIH.",1,0,1,0,0,0,
26-feb-13,TAMPS.,"VICTORIA, TAMPS.",1,0,1,0,1,206,
26-feb-13,JAL.,"GUADALAJARA, JAL.",1,0,1,0,0,0,
26-feb-13,JAL.,"ARANDAS, JAL.",1,0,1,0,0,0,
26-feb-13,B.C.,"MEXICALI, B.C.",0,1,1,0,0,0,
27-feb-13,CAMP.,"CAMP., CAMP.",1,0,1,0,0,0,
27-feb-13,CHIH.,"CHIH., CHIH.",1,0,1,16,0,404,
01-mar-13,CHIH.,"ALDAMA, CHIH.",0,1,1,0,0,0,
02-mar-13,HGO.,"PACHUCA DE SOTO, HGO.",1,0,1,0,1,113,
03-mar-13,TAMPS.,"NUEVO LAREDO, TAMPS.",1,0,1,0,0,0,
04-mar-13,Q. ROO,"COZUMEL, Q. ROO",0,1,1,0,0,337,
04-mar-13,Q. ROO,"TULUM, Q. ROO",1,0,1,1,0,0,
04-mar-13,Q. ROO,"BACALAR, Q. ROO",1,0,1,0,0,0,
05-mar-13,HGO.,"HUEJUTLA DE REYES, HGO.",0,1,1,0,0,0,
05-mar-13,CHIS.,"SAN CRISTOBAL DE LAS CASAS, CHIS.",0,1,1,0,0,97,
06-mar-13,N.L.,"MONTERREY, N.L.",1,0,1,11,0,1229,
07-mar-13,N.L.,"APODACA, N.L.",0,1,1,0,0,107,
07-mar-13,N.L.,"JUAREZ, N.L.",1,0,1,0,1,200,
07-mar-13,N.L.,"GARCIA, N.L.",0,1,1,0,1,1046,
07-mar-13,N.L.,"SAN PEDRO GARZA GARCIA, N.L.",0,1,1,0,0,0,
07-mar-13,HGO.,"HUEJUTLA DE REYES, HGO.",1,0,1,0,0,0,
07-mar-13,Q. ROO,"BACALAR, Q. ROO",1,0,1,0,0,0,
08-mar-13,HGO.,"HUEJUTLA DE REYES, HGO.",1,0,1,0,0,0,
08-mar-13,N.L.,"SAN PEDRO GARZA GARCIA, N.L.",1,0,1,1,0,301,
08-mar-13,CHIH.,"CHIH., CHIH.",0,1,1,1,0,480,
09-mar-13,N.L.,"APODACA, N.L.",0,1,1,0,0,101,
09-mar-13,N.L.,"GUADALUPE, N.L.",1,0,1,0,0,8241,
09-mar-13,N.L.,"GARCIA, N.L.",1,0,1,0,0,6708,
09-mar-13,TAMPS.,"ALTAMIRA, TAMPS.",1,0,1,0,0,0,
10-mar-13,N.L.,"GRAL. ESCOBEDO, N.L.",1,0,1,0,0,1300,
10-mar-13,N.L.,"JUAREZ, N.L.",1,0,1,3,0,0,
10-mar-13,Q. ROO,"TULUM, Q. ROO",0,1,1,0,0,0,
10-mar-13,TAMPS.,"TAMPICO, TAMPS.",1,0,1,3,0,606,
11-mar-13,CHIH.,"CHIH., CHIH.",0,1,1,1,0,81,
11-mar-13,HGO.,"ACTOPAN, HGO.",1,0,1,0,0,0,
11-mar-13,SON.,"CAJEME, SON.",1,0,1,0,0,0,
13-mar-13,HGO.,"TEPEAPULCO, HGO.",0,1,1,0,1,115,
14-mar-13,CHIH.,"CHIH., CHIH.",1,0,1,0,0,52,
14-mar-13,VER.,"COSAMALOAPAN DE CARPIO, VER.",1,0,1,0,0,0,
15-mar-13,CHIH.,"CHIH., CHIH.",0,1,1,0,0,0,
15-mar-13,HGO.,"IXMIQUILPAN, HGO.",0,1,1,0,1,0,
15-mar-13,VER.,"COSAMALOAPAN DE CARPIO, VER.",0,1,1,0,0,0,
15-mar-13,VER.,"TUXPAM, VER.",1,0,1,0,0,0,
15-mar-13,TAMPS.,"NUEVO LAREDO, TAMPS.",0,1,1,0,0,0,
16-mar-13,VER.,"VER., VER.",0,1,1,0,0,0,
16-mar-13,TAMPS.,"NUEVO LAREDO, TAMPS.",0,1,1,0,0,100,
16-mar-13,TAMPS.,"TAMPICO, TAMPS.",1,0,1,30,0,727,
16-mar-13,JAL.,"TOMATLAN, JAL.",1,0,1,0,0,0,
17-mar-13,TAMPS.,"TAMPICO, TAMPS.",1,0,1,7,0,427,
17-mar-13,VER.,"VER., VER.",0,1,1,0,0,0,
18-mar-13,HGO.,"ACTOPAN, HGO.",1,0,1,0,0,0,
18-mar-13,HGO.,"TEPEAPULCO, HGO.",0,1,1,0,0,0,
18-mar-13,TAMPS.,"XICOTENCATL, TAMPS.",1,0,1,1,0,0,
19-mar-13,Q. ROO,"SOLIDARIDAD, Q. ROO",1,0,1,0,0,5,
19-mar-13,VER.,"VER., VER.",1,0,1,0,0,60,
19-mar-13,CHIH.,"CHIH., CHIH.",1,0,1,0,0,40,
19-mar-13,N.L.,"SABINAS HGO., N.L.",0,1,1,0,0,0,
20-mar-13,N.L.,"SABINAS HGO., N.L.",1,0,1,7,0,50,
20-mar-13,CHIH.,"CUAUHTÉMOC, CHIH.",1,0,1,0,0,0,
21-mar-13,HGO.,"IXMIQUILPAN, HGO.",1,0,1,0,2,0,
21-mar-13,VER.,"VER., VER.",1,0,1,0,0,63,
21-mar-13,TAMPS.,"VICTORIA, TAMPS.",1,0,1,0,0,200,
22-mar-13,CHIH.,"MADERA, CHIH.",1,0,1,0,0,0,
22-mar-13,VER.,"VER., VER.",0,1,1,0,0,0,
22-mar-13,HGO.,"IXMIQUILPAN, HGO.",1,0,1,0,0,0,
22-mar-13,TAMPS.,"TAMPICO, TAMPS.",1,0,1,0,2,507,
22-mar-13,TAMPS.,"REYNOSA, TAMPS.",0,1,1,0,0,0,
23-mar-13,HGO.,"ACTOPAN, HGO.",1,0,1,0,0,0,
23-mar-13,HGO.,"IXMIQUILPAN, HGO.",1,0,1,0,0,0,
23-mar-13,N.L.,"SANTIAGO, N.L.",1,0,1,0,0,0,
23-mar-13,TAMPS.,"VICTORIA, TAMPS.",0,1,1,0,1,0,
24-mar-13,TAMPS.,"ALTAMIRA, TAMPS.",1,0,1,0,0,150,
25-mar-13,HGO.,"ACTOPAN, HGO.",1,0,1,0,0,0,
25-mar-13,S.L.P.,"SOLEDAD DE GRACIANO SANCHEZ, S.L.P.",1,0,1,0,0,0,
25-mar-13,N.L.,"SANTIAGO, N.L.",0,1,1,2,0,5177,
26-mar-13,HGO.,"ACTOPAN, HGO.",1,0,1,0,0,0,
26-mar-13,HGO.,"IXMIQUILPAN, HGO.",1,0,1,0,0,0,
27-mar-13,CAMP.,"CARMEN, CAMP.",1,0,1,0,0,0,
27-mar-13,VER.,"VER., VER.",1,0,1,0,0,0,
29-mar-13,Q. ROO,"BENITO JUAREZ, Q. ROO",1,0,1,0,0,0,
31-mar-13,YUC.,"VALLADOLID, YUC.",1,0,1,0,0,106,
31-mar-13,S.L.P.,"SAN LUIS POTOSI, S.L.P.",1,0,1,0,0,0,
31-mar-13,N.L.,"ALLENDE, N.L.",0,1,1,0,0,1562,
31-mar-13,N.L.,"CERRALVO, N.L.",0,1,1,0,0,50,
01-abr-13,CHIH.,"CUAUHTÉMOC, CHIH.",0,1,1,0,0,0,
01-abr-13,N.L.,"ALLENDE, N.L.",1,0,1,0,0,44,
01-abr-13,Q. ROO,"OTHON P. BLANCO, Q. ROO",1,0,1,0,5,0,
02-abr-13,AGS.,"AGS., AGS.",1,0,1,0,0,15,
02-abr-13,CHIH.,"CUAUHTÉMOC, CHIH.",1,0,1,0,0,0,
02-abr-13,N.L.,"ALLENDE, N.L.",1,0,1,0,0,99,
03-abr-13,VER.,"VER., VER.",0,1,1,0,0,0,
03-abr-13,VER.,"COATZACOALCOS, VER.",1,0,1,0,0,0,
03-abr-13,MEX.,"VALLE DE BRAVO, MEX.",1,0,1,0,2,0,
03-abr-13,S.L.P.,"SAN LUIS POTOSI, S.L.P.",0,1,1,0,0,0,
03-abr-13,Q. ROO,"OTHON P. BLANCO, Q. ROO",0,1,1,0,0,0,
03-abr-13,MICH.,"LA HUACANA, MICH.",0,1,1,0,0,0,
04-abr-13,TAMPS.,"VICTORIA, TAMPS.",1,0,1,0,2,0,
04-abr-13,N.L.,"MONTEMOR., N.L.",1,0,1,0,0,0,
04-abr-13,Q. ROO,"OTHON P. BLANCO, Q. ROO",0,1,1,0,0,0,
04-abr-13,CHIH.,"JANOS, CHIH.",0,1,1,0,0,0,
04-abr-13,VER.,"VER., VER.",0,1,1,0,0,0,
05-abr-13,S.L.P.,"SOLEDAD DE GRACIANO SANCHEZ, S.L.P.",1,0,1,0,0,0,
06-abr-13,TAMPS.,"CIUDAD MADERO, TAMPS.",1,0,1,0,0,37,
06-abr-13,MICH.,"LA HUACANA, MICH.",1,0,1,0,0,0,
07-abr-13,TAMPS.,"GONZALEZ, TAMPS.",1,0,1,0,0,20,
08-abr-13,VER.,"COATEPEC, VER.",1,0,1,0,0,0,
08-abr-13,HGO.,"TIZAYUCA, HGO.",1,0,1,0,0,220,
08-abr-13,Q. ROO,"OTHON P. BLANCO, Q. ROO",0,1,1,0,0,0,
08-abr-13,OAX.,"SANTIAGO TEXTITLAN, OAX.",0,1,1,0,0,0,
08-abr-13,MICH.,"LA HUACANA, MICH.",0,1,1,0,0,0,
09-abr-13,N.L.,"MONTEMOR., N.L.",1,0,1,0,0,50,
09-abr-13,AGS.,"COSÍO, AGS.",1,0,1,0,0,0,
09-abr-13,MICH.,"LA HUACANA, MICH.",0,1,1,0,0,0,
10-abr-13,HGO.,"TIZAYUCA, HGO.",1,0,1,0,0,0,
10-abr-13,AGS.,"COSÍO, AGS.",0,1,1,0,0,0,
11-abr-13,VER.,"COATEPEC, VER.",1,0,1,0,0,62,
12-abr-13,N.L.,"GALEANA, N.L.",1,0,1,0,0,0,
12-abr-13,VER.,"COATEPEC, VER.",1,0,1,0,0,35,
12-abr-13,AGS.,"COSÍO, AGS.",1,0,1,0,0,120,
12-abr-13,COL.,"COL., COL.",1,0,1,0,0,0,
13-abr-13,N.L.,"GALEANA, N.L.",1,0,1,0,0,0,
13-abr-13,OAX.,"CIUDAD IXTEPEC, OAX.",1,0,1,0,0,0,
13-abr-13,TAMPS.,"CIUDAD MADERO, TAMPS.",1,0,1,0,1,0,
13-abr-13,Q. ROO,"BENITO JUAREZ, Q. ROO",1,0,1,1,0,140,
13-abr-13,TAMPS.,"VICTORIA, TAMPS.",1,0,1,0,0,0,
14-abr-13,N.L.,"HGO., N.L.",0,1,1,6,0,100,
14-abr-13,MICH.,"LA HUACANA, MICH.",0,1,1,0,0,0,
15-abr-13,HGO.,"HUAUTLA, HGO.",1,0,1,0,0,0,
15-abr-13,NAY.,"ACAPONETA, NAY.",0,1,1,0,0,0,
15-abr-13,CHIH.,"DELICIAS, CHIH.",1,0,1,0,0,0,
16-abr-13,HGO.,"HUAUTLA, HGO.",1,0,1,0,0,0,
16-abr-13,CHIH.,"CUAUHTÉMOC, CHIH.",1,0,1,0,0,0,
16-abr-13,N.L.,"HGO., N.L.",0,1,1,0,0,0,
16-abr-13,OAX.,"SAN JUAN BAUTISTA LO DE SOTO, OAX.",1,0,1,0,0,0,
17-abr-13,S.L.P.,"RIOVERDE, S.L.P.",1,0,1,0,0,0,
17-abr-13,B.C.,"ENSENADA, B.C.",0,1,1,0,0,0,
17-abr-13,N.L.,"HGO., N.L.",1,0,1,4,0,200,
18-abr-13,VER.,"COATZACOALCOS, VER.",1,0,1,0,0,0,
18-abr-13,AGS.,"SAN FRANCISCO DE LOS ROMO, AGS.",1,0,1,0,0,110,
18-abr-13,CAMP.,"CARMEN, CAMP.",1,0,1,0,0,0,
18-abr-13,N.L.,"ARAMBERRI, N.L.",0,1,1,5,0,0,
19-abr-13,TAMPS.,"NUEVO LAREDO, TAMPS.",0,1,1,0,1,0,
19-abr-13,TAMPS.,"REYNOSA, TAMPS.",0,1,1,0,0,0,
19-abr-13,TAMPS.,"BURGOS, TAMPS.",1,0,1,0,0,0,
20-abr-13,NAY.,"TEPIC, NAY.",1,0,1,0,2,0,
20-abr-13,OAX.,"OCOTLAN DE MOR., OAX.",1,0,1,0,0,0,
20-abr-13,MICH.,"MARAVATIO, MICH.",1,0,1,0,0,0,
21-abr-13,OAX.,"SAN DIONISIO OCOTEPEC, OAX.",1,0,1,0,0,0,
21-abr-13,OAX.,"JUCHITAN DE ZARAGOZA, OAX.",1,0,1,0,0,0,
21-abr-13,S.L.P.,"MATEHUALA, S.L.P.",1,0,1,0,0,0,
21-abr-13,TAMPS.,"TAMPICO, TAMPS.",1,0,1,2,0,437,
21-abr-13,TAMPS.,"CIUDAD MADERO, TAMPS.",1,0,1,3,0,203,
21-abr-13,TAMPS.,"GONZALEZ, TAMPS.",1,0,1,0,0,0,
21-abr-13,MICH.,"MARAVATIO, MICH.",1,0,1,0,0,0,
22-abr-13,VER.,"COATZACOALCOS, VER.",1,0,1,1,0,0,
22-abr-13,NAY.,"TEPIC, NAY.",1,0,1,0,0,0,
22-abr-13,NAY.,"ACAPONETA, NAY.",1,0,1,0,0,0,
22-abr-13,QRO.,"SAN JOAQUIN, QRO.",1,0,1,0,1,0,
22-abr-13,S.L.P.,"SALINAS, S.L.P.",0,1,1,0,0,0,
22-abr-13,TAMPS.,"XICOTENCATL, TAMPS.",0,1,1,0,0,0,
23-abr-13,NAY.,"TEPIC, NAY.",1,0,1,0,0,0,
23-abr-13,TAMPS.,"MATAMOROS, TAMPS.",0,1,1,0,0,0,
23-abr-13,S.L.P.,"RIOVERDE, S.L.P.",1,0,1,0,0,0,
23-abr-13,CHIH.,"CASAS GRANDES, CHIH.",1,0,1,0,0,0,
23-abr-13,HGO.,"HUEJUTLA DE REYES, HGO.",1,0,1,0,0,0,
24-abr-13,MICH.,"APATZINGAN, MICH.",1,0,1,0,0,0,
24-abr-13,N.L.,"GRAL. TERAN, N.L.",0,1,1,0,0,300,
24-abr-13,OAX.,"TLACOLULA DE MATAMOROS, OAX.",1,0,1,0,0,0,
24-abr-13,VER.,"BOCA DEL RIO, VER.",1,0,1,1,0,0,
24-abr-13,S.L.P.,"RIOVERDE, S.L.P.",0,1,1,0,0,0,
25-abr-13,VER.,"CORDOBA, VER.",1,0,1,0,0,7,
25-abr-13,NAY.,"TEPIC, NAY.",1,0,1,0,0,0,
25-abr-13,MICH.,"CHURUMUCO, MICH.",0,1,1,0,0,0,
25-abr-13,CHIH.,"CUAUHTÉMOC, CHIH.",0,1,1,0,0,0,
25-abr-13,TAMPS.,"VICTORIA, TAMPS.",0,1,1,0,1,0,
26-abr-13,S.L.P.,"SALINAS, S.L.P.",1,0,1,0,0,0,
26-abr-13,VER.,"CORDOBA, VER.",1,0,1,1,0,0,
26-abr-13,CHIH.,"NUEVO CASAS GRANDES, CHIH.",1,0,1,0,1,0,
26-abr-13,COL.,"COL., COL.",1,0,1,1,0,0,
26-abr-13,TAMPS.,"TAMPICO, TAMPS.",1,0,1,0,0,0,
27-abr-13,NAY.,"ACAPONETA, NAY.",1,0,1,0,0,0,
27-abr-13,CHIS.,"OCOSINGO, CHIS.",1,0,1,0,0,0,
27-abr-13,B.C.,"MEXICALI, B.C.",0,1,1,0,0,0,
28-abr-13,OAX.,"SAN PEDRO POCHUTLA, OAX.",0,1,1,0,0,0,
28-abr-13,OAX.,"SANTIAGO MINAS, OAX.",0,1,1,0,0,0,
28-abr-13,TAMPS.,"CIUDAD MADERO, TAMPS.",0,1,1,4,0,1087,
29-abr-13,OAX.,"LOMA BONITA, OAX.",1,0,1,0,0,0,
29-abr-13,B.C.,"ENSENADA, B.C.",1,0,1,0,0,0,
30-abr-13,N.L.,"CIENEGA DE FLORES, N.L.",1,0,1,0,0,550,
30-abr-13,VER.,"CORDOBA, VER.",0,1,1,0,0,0,
01-may-13,B.C.,"ENSENADA, B.C.",0,1,1,0,0,0,
02-may-13,N.L.,"CIENEGA DE FLORES, N.L.",0,1,1,20,0,1350,
02-may-13,VER.,"CORDOBA, VER.",1,0,1,1,0,0,
02-may-13,VER.,"COATZACOALCOS, VER.",1,0,1,0,0,0,
02-may-13,MICH.,"TURICATO, MICH.",1,0,1,0,0,0,
02-may-13,TAB.,"CENTRO, TAB.",1,0,1,0,0,0,
02-may-13,TAMPS.,"MATAMOROS, TAMPS.",1,0,1,0,0,0,
02-may-13,TAMPS.,"VICTORIA, TAMPS.",0,1,1,0,0,0,
02-may-13,B.C.,"ENSENADA, B.C.",0,1,1,0,0,0,
03-may-13,CHIS.,"FRONTERA COMALAPA, CHIS.",0,1,1,0,0,0,
03-may-13,NAY.,"SAN PEDRO LAGUNILLAS, NAY.",0,1,1,0,0,0,
03-may-13,VER.,"COSAMALOAPAN DE CARPIO, VER.",0,1,1,0,0,0,
03-may-13,N.L.,"CIENEGA DE FLORES, N.L.",1,0,1,4,0,50,
03-may-13,B.C.,"MEXICALI, B.C.",0,1,1,0,0,0,
03-may-13,TAMPS.,"GUSTAVO DIAZ ORDAZ, TAMPS.",0,1,1,0,0,0,
03-may-13,TAMPS.,"CIUDAD MADERO, TAMPS.",1,0,1,0,0,0,
04-may-13,CHIS.,"OCOSINGO, CHIS.",1,0,1,0,0,0,
04-may-13,TAMPS.,"VICTORIA, TAMPS.",0,1,1,0,0,0,
04-may-13,B.C.,"TIJUANA, B.C.",0,1,1,0,0,0,
04-may-13,MICH.,"JIQUILPAN, MICH.",1,0,1,0,0,0,
05-may-13,VER.,"XALAPA, VER.",0,1,1,0,0,0,
05-may-13,TAB.,"CARDENAS, TAB.",1,0,1,1,0,0,
05-may-13,TAMPS.,"EL MANTE, TAMPS.",0,1,1,0,0,0,
06-may-13,N.L.,"ABASOLO, N.L.",1,0,1,1,0,1000,
06-may-13,MICH.,"AGUILILLA, MICH.",1,0,1,1,0,0,
06-may-13,B.C.,"ENSENADA, B.C.",1,0,1,0,0,0,
07-may-13,VER.,"BOCA DEL RIO, VER.",0,1,1,0,0,11,
07-may-13,TAB.,"CARDENAS, TAB.",1,0,1,0,0,0,
07-may-13,N.L.,"CHINA, N.L.",1,0,1,4,0,100,
08-may-13,VER.,"XALAPA, VER.",1,0,1,0,0,0,
08-may-13,VER.,"BOCA DEL RIO, VER.",1,0,1,0,0,0,
08-may-13,B.C.,"TIJUANA, B.C.",0,1,1,0,0,0,
08-may-13,TAMPS.,"EL MANTE, TAMPS.",1,0,1,0,0,0,
09-may-13,AGS.,"CALVILLO, AGS.",0,1,1,0,0,0,
09-may-13,TAMPS.,"EL MANTE, TAMPS.",1,0,1,0,0,0,
09-may-13,TAMPS.,"EL MANTE, TAMPS.",0,1,1,0,0,0,
10-may-13,CHIH.,"NUEVO CASAS GRANDES, CHIH.",0,1,1,0,0,0,
10-may-13,NAY.,"TEPIC, NAY.",1,0,1,1,0,0,
10-may-13,NAY.,"ACAPONETA, NAY.",0,1,1,0,0,0,
10-may-13,N.L.,"MARIN, N.L.",0,1,1,29,0,0,
11-may-13,TAB.,"CENTRO, TAB.",1,0,1,1,0,0,
11-may-13,TAMPS.,"EL MANTE, TAMPS.",0,1,1,1,0,0,
12-may-13,TAMPS.,"GONZALEZ, TAMPS.",1,0,1,0,0,0,
13-may-13,TAB.,"HUIMANGUILLO, TAB.",1,0,1,0,0,0,
13-may-13,SIN.,"SIN., SIN.",0,1,1,0,0,0,
13-may-13,CAMP.,"CAMP., CAMP.",1,0,1,0,0,0,
13-may-13,B.C.,"TIJUANA, B.C.",0,1,1,0,0,0,
14-may-13,MICH.,"ZITACUARO, MICH.",1,0,1,0,0,0,
14-may-13,NAY.,"SAN BLAS, NAY.",1,0,1,0,0,0,
14-may-13,NAY.,"TUXPAN, NAY.",0,1,1,0,0,0,
14-may-13,SIN.,"SIN., SIN.",0,1,1,0,0,0,
14-may-13,N.L.,"DR. GONZALEZ, N.L.",0,1,1,4,0,0,
14-may-13,MICH.,"COAHUAYANA, MICH.",1,0,1,0,0,0,
14-may-13,COL.,"COL., COL.",0,1,1,0,0,0,
14-may-13,B.C.,"TIJUANA, B.C.",1,0,1,0,0,0,
14-may-13,B.C.,"ENSENADA, B.C.",1,0,1,0,0,0,
15-may-13,AGS.,"PABELLÓN DE ARTEAGA, AGS.",1,0,1,0,0,0,
15-may-13,NAY.,"TUXPAN, NAY.",0,1,1,0,0,0,
15-may-13,CAMP.,"CAMP., CAMP.",1,0,1,0,0,0,
15-may-13,MICH.,"COAHUAYANA, MICH.",0,1,1,0,0,0,
15-may-13,B.C.S.,"MULEGÉ, B.C.S.",1,0,1,0,0,0,
16-may-13,TAB.,"CARDENAS, TAB.",1,0,1,0,0,0,
16-may-13,TAB.,"HUIMANGUILLO, TAB.",1,0,1,0,0,0,
16-may-13,B.C.S.,"MULEGÉ, B.C.S.",1,0,1,0,0,0,
16-may-13,COL.,"COL., COL.",1,0,1,0,0,0,
16-may-13,TAMPS.,"EL MANTE, TAMPS.",1,0,1,0,0,0,
16-may-13,CHIS.,"LAS MARGARITAS, CHIS.",0,1,1,0,0,0,
17-may-13,CHIH.,"ALDAMA, CHIH.",1,0,1,0,0,0,
17-may-13,CHIH.,"NUEVO CASAS GRANDES, CHIH.",1,0,1,0,0,0,
17-may-13,CHIH.,"DELICIAS, CHIH.",1,0,1,0,0,0,
17-may-13,N.L.,"PESQUERIA, N.L.",1,0,1,6,0,700,
17-may-13,TAMPS.,"EL MANTE, TAMPS.",0,1,1,0,0,0,
17-may-13,B.C.,"TIJUANA, B.C.",1,0,1,0,0,0,
18-may-13,VER.,"OTATITLAN, VER.",1,0,1,0,0,77,
18-may-13,TAB.,"CENTRO, TAB.",1,0,1,0,0,54,
18-may-13,MICH.,"URUAPAN, MICH.",1,0,1,0,0,0,
18-may-13,B.C.,"TECATE, B.C.",0,1,1,0,0,0,
19-may-13,MICH.,"ZITACUARO, MICH.",1,0,1,0,0,0,
19-may-13,MICH.,"URUAPAN, MICH.",1,0,1,0,0,0,
20-may-13,CAMP.,"CHAMPOTÓN, CAMP.",1,0,1,0,0,0,
20-may-13,AGS.,"PABELLÓN DE ARTEAGA, AGS.",1,0,1,0,0,9,
20-may-13,SIN.,"SALVADOR ALVARADO, SIN.",1,0,1,0,0,0,
21-may-13,TAMPS.,"EL MANTE, TAMPS.",1,0,1,0,0,0,
21-may-13,TAMPS.,"EL MANTE, TAMPS.",1,0,1,0,0,0,
22-may-13,AGS.,"PABELLÓN DE ARTEAGA, AGS.",1,0,1,0,0,121,
22-may-13,CHIH.,"JUÁREZ, CHIH.",1,0,1,0,0,0,
22-may-13,MICH.,"COAHUAYANA, MICH.",1,0,1,0,0,0,
22-may-13,TAMPS.,"EL MANTE, TAMPS.",0,1,1,0,0,0,
23-may-13,MICH.,"COAHUAYANA, MICH.",1,0,1,0,0,0,
23-may-13,OAX.,"SANTIAGO PINOTEPA NACIONAL, OAX.",1,0,1,0,0,0,
24-may-13,AGS.,"PABELLÓN DE ARTEAGA, AGS.",1,0,1,0,0,24,
24-may-13,GRO.,"BENITO JUAREZ, GRO.",1,0,1,0,0,0,
24-may-13,B.C.,"ENSENADA, B.C.",0,1,1,0,0,0,
24-may-13,OAX.,"SANTIAGO PINOTEPA NACIONAL, OAX.",1,0,1,0,0,0,
24-may-13,TAMPS.,"EL MANTE, TAMPS.",1,0,1,0,0,0,
25-may-13,MICH.,"LAZARO CARDENAS, MICH.",1,0,1,0,0,0,
25-may-13,B.C.S.,"MULEGÉ, B.C.S.",1,0,1,0,0,0,
26-may-13,S.L.P.,"SAN LUIS POTOSI, S.L.P.",1,0,1,0,0,0,
26-may-13,TAMPS.,"EL MANTE, TAMPS.",1,0,1,0,0,0,
26-may-13,B.C.,"ENSENADA, B.C.",0,1,1,0,0,0,
26-may-13,TAMPS.,"MATAMOROS, TAMPS.",0,1,1,0,0,0,
27-may-13,GRO.,"ATOYAC DE ALVAREZ, GRO.",1,0,1,1,0,0,
27-may-13,CHIS.,"FRONTERA COMALAPA, CHIS.",0,1,1,0,0,0,
27-may-13,CHIH.,"HGO. DEL PARRAL, CHIH.",1,0,1,0,0,0,
27-may-13,B.C.,"ENSENADA, B.C.",0,1,1,0,0,0,
28-may-13,OAX.,"PINOTEPA DE DON LUIS, OAX.",1,0,1,0,0,0,
28-may-13,CHIH.,"HGO. DEL PARRAL, CHIH.",1,0,1,0,0,0,
28-may-13,TAB.,"HUIMANGUILLO, TAB.",1,0,1,0,0,50,
28-may-13,B.C.S.,"MULEGÉ, B.C.S.",0,1,1,0,0,0,
29-may-13,SIN.,"SALVADOR ALVARADO, SIN.",1,0,1,0,0,0,
29-may-13,B.C.S.,"MULEGÉ, B.C.S.",1,0,1,0,0,0,
29-may-13,CHIH.,"JUÁREZ, CHIH.",1,0,1,0,0,0,
29-may-13,CHIS.,"COMITAN DE DOMÍNGUEZ, CHIS.",1,0,1,0,0,0,
29-may-13,TAMPS.,"EL MANTE, TAMPS.",1,0,1,0,0,0,
30-may-13,TAB.,"HUIMANGUILLO, TAB.",1,0,1,0,0,0,
30-may-13,COL.,"TECOMÁN, COL.",0,1,1,0,0,0,
30-may-13,AGS.,"SAN JOSÉ DE GRACIA, AGS.",0,1,1,0,0,0,
31-may-13,GRO.,"QUECHULTENANGO, GRO.",1,0,1,0,0,0,
31-may-13,CHIS.,"COMITAN DE DOMÍNGUEZ, CHIS.",0,1,1,0,0,0,
31-may-13,CHIH.,"JUÁREZ, CHIH.",1,0,1,0,0,0,
31-may-13,CAMP.,"CAMP., CAMP.",1,0,1,0,0,0,
31-may-13,MICH.,"COAHUAYANA, MICH.",1,0,1,0,0,0,
01-jun-13,B.C.S.,"MULEGÉ, B.C.S.",0,1,1,0,0,0,
01-jun-13,MICH.,"LAZARO CARDENAS, MICH.",0,1,1,0,0,0,
01-jun-13,S.L.P.,"SAN LUIS POTOSI, S.L.P.",1,0,1,0,0,0,
01-jun-13,GRO.,"QUECHULTENANGO, GRO.",0,1,1,0,0,0,
01-jun-13,TAMPS.,"EL MANTE, TAMPS.",1,0,1,0,0,0,
01-jun-13,S.L.P.,"SAN LUIS POTOSI, S.L.P.",1,0,1,0,0,0,
02-jun-13,GRO.,"QUECHULTENANGO, GRO.",0,1,1,0,0,0,
02-jun-13,B.C.,"ENSENADA, B.C.",1,0,1,0,0,0,
03-jun-13,MICH.,"BUENAVISTA, MICH.",1,0,1,0,0,0,
03-jun-13,B.C.,"TIJUANA, B.C.",0,1,1,0,0,0,
04-jun-13,TAB.,"BALANCAN, TAB.",0,1,1,0,0,0,
04-jun-13,NAY.,"TEPIC, NAY.",1,0,1,0,0,0,
04-jun-13,CAMP.,"CAMP., CAMP.",1,0,1,0,0,0,
04-jun-13,MICH.,"TEPALCATEPEC, MICH.",1,0,1,1,0,0,
04-jun-13,SIN.,"ANGOSTURA, SIN.",0,1,1,0,0,0,
04-jun-13,CHIH.,"HGO. DEL PARRAL, CHIH.",1,0,1,0,0,0,
04-jun-13,AGS.,"SAN JOSÉ DE GRACIA, AGS.",1,0,1,0,0,0,
04-jun-13,B.C.,"ENSENADA, B.C.",0,1,1,0,0,0,
05-jun-13,CHIH.,"HGO. DEL PARRAL, CHIH.",1,0,1,0,0,0,
05-jun-13,VER.,"TEZONAPA, VER.",1,0,1,0,0,0,
05-jun-13,N.L.,"GRAL. ESCOBEDO, N.L.",1,0,1,0,0,62,
05-jun-13,B.C.,"ENSENADA, B.C.",1,0,1,0,0,0,
05-jun-13,OAX.,"MIAHUATLAN DE PORFIRIO DIAZ, OAX.",0,1,1,0,0,0,
07-jun-13,TAMPS.,"EL MANTE, TAMPS.",1,0,1,0,0,0,
07-jun-13,COL.,"MANZANILLO, COL.",1,0,1,2,0,0,
08-jun-13,MICH.,"COALCOMAN DE VAZQUEZ PALLARES, MICH.",1,0,1,0,0,0,
08-jun-13,S.L.P.,"SAN LUIS POTOSI, S.L.P.",1,0,1,0,0,0,
08-jun-13,CHIS.,"YAJALÓN, CHIS.",0,1,1,0,0,0,
09-jun-13,S.L.P.,"CIUDAD VALLES, S.L.P.",1,0,1,0,0,0,
09-jun-13,TAB.,"JONUTA, TAB.",1,0,1,0,0,0,
09-jun-13,TAB.,"JONUTA, TAB.",1,0,1,0,0,0,
09-jun-13,JAL.,"AUTLAN DE NAVARRO, JAL.",0,1,1,0,0,310,
09-jun-13,MICH.,"COALCOMAN DE VAZQUEZ PALLARES, MICH.",0,1,1,0,0,0,
09-jun-13,MICH.,"TEPALCATEPEC, MICH.",1,0,1,0,0,0,
10-jun-13,JAL.,"AUTLAN DE NAVARRO, JAL.",1,0,1,0,0,0,
10-jun-13,SIN.,"MOCORITO, SIN.",0,1,1,0,0,0,
10-jun-13,CHIS.,"LA INDEPENDENCIA, CHIS.",0,1,1,0,0,0,
10-jun-13,CAMP.,"CAMP., CAMP.",1,0,1,0,0,0,
11-jun-13,MICH.,"COALCOMAN DE VAZQUEZ PALLARES, MICH.",1,0,1,0,0,0,
11-jun-13,B.C.,"TIJUANA, B.C.",0,1,1,0,0,0,
12-jun-13,CAMP.,"CAMP., CAMP.",1,0,1,0,0,0,
12-jun-13,MICH.,"TEPALCATEPEC, MICH.",0,1,1,0,0,0,
12-jun-13,TAB.,"JONUTA, TAB.",0,1,1,0,0,0,
12-jun-13,TAMPS.,"EL MANTE, TAMPS.",1,0,1,0,0,23,
12-jun-13,B.C.,"TIJUANA, B.C.",0,1,1,0,0,0,
12-jun-13,B.C.,"ENSENADA, B.C.",0,1,1,0,0,0,
13-jun-13,MICH.,"TEPALCATEPEC, MICH.",0,1,1,0,0,0,
13-jun-13,SIN.,"MOCORITO, SIN.",1,0,1,0,0,0,
13-jun-13,B.C.,"ENSENADA, B.C.",1,0,1,0,0,0,
13-jun-13,CHIH.,"CUAUHTÉMOC, CHIH.",1,0,1,0,0,0,
13-jun-13,TAMPS.,"EL MANTE, TAMPS.",1,0,1,0,0,0,
14-jun-13,B.C.S.,"MULEGÉ, B.C.S.",1,0,1,0,0,0,
14-jun-13,TAB.,"BALANCAN, TAB.",1,0,1,0,0,0,
14-jun-13,OAX.,"MIAHUATLAN DE PORFIRIO DIAZ, OAX.",1,0,1,0,0,156,
14-jun-13,COAH.,"ACUÑA, COAH.",0,1,1,0,0,0,
15-jun-13,NAY.,"LA YESCA, NAY.",1,0,1,0,0,0,
15-jun-13,S.L.P.,"SAN LUIS POTOSI, S.L.P.",0,1,1,0,0,0,
15-jun-13,VER.,"CARLOS A. CARRILLO, VER.",1,0,1,0,0,0,
15-jun-13,OAX.,"MATIAS ROMERO AVENDAÑO, OAX.",1,0,1,0,0,0,
15-jun-13,B.C.S.,"LOS CABOS, B.C.S.",1,0,1,1,0,14,
15-jun-13,TAMPS.,"EL MANTE, TAMPS.",1,0,1,0,0,68,
16-jun-13,B.C.S.,"MULEGÉ, B.C.S.",1,0,1,0,0,0,
16-jun-13,S.L.P.,"SAN LUIS POTOSI, S.L.P.",1,0,1,0,0,0,
17-jun-13,B.C.S.,"MULEGÉ, B.C.S.",1,0,1,0,0,0,
17-jun-13,B.C.,"TIJUANA, B.C.",1,0,1,0,0,0,
18-jun-13,CHIH.,"BUENAVENTURA, CHIH.",0,1,1,0,0,0,
18-jun-13,SIN.,"BADIRAGUATO, SIN.",0,1,1,0,0,0,
18-jun-13,COAH.,"CUATROCIÉNEGAS, COAH.",0,1,1,0,0,0,
19-jun-13,TAB.,"CENTRO, TAB.",1,0,1,1,0,49,
19-jun-13,CAMP.,"CARMEN, CAMP.",1,0,1,0,0,0,
20-jun-13,TAB.,"TENOSIQUE, TAB.",1,0,1,0,0,0,
21-jun-13,B.C.S.,"LOS CABOS, B.C.S.",1,0,1,0,0,0,
22-jun-13,CHIS.,"YAJALÓN, CHIS.",0,1,1,0,0,0,
22-jun-13,B.C.S.,"LA PAZ, B.C.S.",0,1,1,0,0,0,
22-jun-13,B.C.S.,"LOS CABOS, B.C.S.",1,0,1,0,0,160,
22-jun-13,TAB.,"JONUTA, TAB.",0,1,1,0,0,0,
22-jun-13,TAB.,"JONUTA, TAB.",0,1,1,0,0,0,
23-jun-13,B.C.S.,"LA PAZ, B.C.S.",1,0,1,0,0,0,
23-jun-13,GRO.,"ATENANGO DEL RIO, GRO.",1,0,1,0,0,0,
24-jun-13,NAY.,"JALA, NAY.",0,1,1,0,0,0,
24-jun-13,VER.,"TUXPAM, VER.",0,1,1,0,0,0,
24-jun-13,PUE.,"HUAUCHINANGO, PUE.",1,0,1,0,0,0,
25-jun-13,TAB.,"BALANCAN, TAB.",1,0,1,0,0,0,
25-jun-13,PUE.,"HUAUCHINANGO, PUE.",1,0,1,0,0,0,
25-jun-13,NAY.,"JALA, NAY.",0,1,1,0,0,0,
26-jun-13,PUE.,"HUAUCHINANGO, PUE.",1,0,1,0,0,150,
26-jun-13,SIN.,"BADIRAGUATO, SIN.",0,1,1,0,0,0,
26-jun-13,COAH.,"MÚZQUIZ, COAH.",0,1,1,0,0,5,
26-jun-13,NAY.,"JALA, NAY.",1,0,1,0,0,0,
27-jun-13,COAH.,"TORREÓN, COAH.",1,0,1,0,0,0,
27-jun-13,TAB.,"COMALCALCO, TAB.",0,1,1,0,5,0,
27-jun-13,GRO.,"BENITO JUAREZ, GRO.",0,1,1,0,0,0,
27-jun-13,NAY.,"RUIZ, NAY.",1,0,1,0,0,0,
28-jun-13,SIN.,"BADIRAGUATO, SIN.",0,1,1,0,0,0,
28-jun-13,COAH.,"TORREÓN, COAH.",1,0,1,0,4,0,
28-jun-13,OAX.,"CIUDAD IXTEPEC, OAX.",1,0,1,1,0,0,
28-jun-13,COL.,"MANZANILLO, COL.",1,0,1,0,1,0,
29-jun-13,NAY.,"RUIZ, NAY.",1,0,1,0,0,0,
29-jun-13,COAH.,"ALLENDE, COAH.",1,0,1,0,0,0,
30-jun-13,TAMPS.,"GONZALEZ, TAMPS.",1,0,1,1,0,8,
30-jun-13,TAMPS.,"EL MANTE, TAMPS.",0,1,1,0,0,0,
01-jul-13,PUE.,"TEHUACAN, PUE.",0,1,1,0,2,0,
01-jul-13,TAB.,"COMALCALCO, TAB.",1,0,1,1,0,0,
01-jul-13,CHIS.,"MOTOZINTLA, CHIS.",1,0,1,0,0,0,
01-jul-13,CHIS.,"TONALÁ, CHIS.",0,1,1,0,0,0,
01-jul-13,CHIS.,"CINTALAPA, CHIS.",0,1,1,0,0,30,
02-jul-13,COAH.,"ACUÑA, COAH.",0,1,1,1,0,0,
02-jul-13,TAB.,"BALANCAN, TAB.",1,0,1,0,0,0,
02-jul-13,SIN.,"NAVOLATO, SIN.",1,0,1,1,0,0,
02-jul-13,CHIS.,"MOTOZINTLA, CHIS.",1,0,1,0,0,0,
02-jul-13,CHIS.,"CINTALAPA, CHIS.",0,1,1,0,0,0,
02-jul-13,TAMPS.,"EL MANTE, TAMPS.",1,0,1,0,0,0,
02-jul-13,PUE.,"TEHUACAN, PUE.",0,1,1,0,0,150,
03-jul-13,OAX.,"CIUDAD IXTEPEC, OAX.",0,1,1,0,0,0,
03-jul-13,TAB.,"COMALCALCO, TAB.",1,0,1,0,0,0,
03-jul-13,TAB.,"CENTRO, TAB.",0,1,1,0,0,0,
03-jul-13,COAH.,"TORREÓN, COAH.",1,0,1,0,0,0,
03-jul-13,COAH.,"MÚZQUIZ, COAH.",1,0,1,0,0,60,
03-jul-13,NAY.,"HUAJICORI, NAY.",1,0,1,0,0,0,
04-jul-13,CHIS.,"LA INDEPENDENCIA, CHIS.",0,1,1,0,0,0,
04-jul-13,CHIS.,"CHICOMUSELO, CHIS.",1,0,1,0,0,0,
04-jul-13,PUE.,"XICOTEPEC, PUE.",0,1,1,0,0,0,
05-jul-13,NAY.,"IXTLAN DEL RIO, NAY.",1,0,1,1,0,0,
05-jul-13,TAB.,"CENTRO, TAB.",1,0,1,0,0,0,
05-jul-13,COAH.,"TORREÓN, COAH.",1,0,1,0,0,0,
05-jul-13,PUE.,"TEHUACAN, PUE.",1,0,1,0,0,0,
07-jul-13,B.C.,"MEXICALI, B.C.",0,1,1,0,0,0,
08-jul-13,SIN.,"NAVOLATO, SIN.",1,0,1,0,0,0,
08-jul-13,PUE.,"CAÑADA MOR., PUE.",1,0,1,0,0,0,
08-jul-13,TAB.,"JONUTA, TAB.",1,0,1,0,0,0,
09-jul-13,PUE.,"PUE., PUE.",1,0,1,0,0,633,
09-jul-13,COAH.,"TORREÓN, COAH.",1,0,1,0,0,0,
09-jul-13,TAMPS.,"EL MANTE, TAMPS.",0,1,1,0,0,0,
10-jul-13,GRO.,"CHILPANCINGO DE LOS BRAVO, GRO.",0,1,1,0,0,0,
10-jul-13,TAB.,"TEAPA, TAB.",1,0,1,1,0,0,
10-jul-13,PUE.,"TECAMACHALCO, PUE.",0,1,1,0,1,0,
10-jul-13,PUE.,"HUITZILAN DE SERDAN, PUE.",1,0,1,0,0,0,
10-jul-13,B.C.S.,"MULEGÉ, B.C.S.",0,1,1,0,0,0,
10-jul-13,NAY.,"AMATLAN DE CAÑAS, NAY.",1,0,1,0,0,0,
10-jul-13,B.C.,"ENSENADA, B.C.",1,0,1,0,0,0,
10-jul-13,DGO.,"SANTIAGO PAPASQUIARO, DGO.",1,0,1,0,0,0,
11-jul-13,SIN.,"NAVOLATO, SIN.",0,1,1,0,4,0,
11-jul-13,TAB.,"TEAPA, TAB.",1,0,1,0,0,0,
11-jul-13,B.C.,"TIJUANA, B.C.",0,1,1,0,0,0,
12-jul-13,CHIS.,"LA TRINITARIA, CHIS.",0,1,1,0,0,0,
12-jul-13,VER.,"JUAN RODRIGUEZ CLARA, VER.",1,0,1,0,0,0,
12-jul-13,CHIH.,"GÓMEZ FARÍAS, CHIH.",0,1,1,0,0,0,
12-jul-13,CHIH.,"ALDAMA, CHIH.",0,1,1,0,0,0,
12-jul-13,B.C.,"TIJUANA, B.C.",1,0,1,0,0,0,
12-jul-13,B.C.,"ENSENADA, B.C.",1,0,1,0,0,0,
12-jul-13,COAH.,"ACUÑA, COAH.",0,1,1,0,0,0,
12-jul-13,PUE.,"TECAMACHALCO, PUE.",1,0,1,0,0,0,
13-jul-13,NAY.,"AMATLAN DE CAÑAS, NAY.",1,0,1,0,0,0,
13-jul-13,CHIS.,"MAZATÁN, CHIS.",0,1,1,0,0,0,
13-jul-13,TAMPS.,"EL MANTE, TAMPS.",0,1,1,1,0,208,
13-jul-13,N.L.,"JUAREZ, N.L.",0,1,1,0,0,0,
14-jul-13,CHIS.,"HUEHUETÁN, CHIS.",1,0,1,0,0,0,
14-jul-13,MOR.,"CUERNAVACA, MOR.",1,0,1,0,0,301,
14-jul-13,B.C.S.,"COMONDÚ, B.C.S.",0,1,1,0,0,0,
15-jul-13,CHIS.,"OCOSINGO, CHIS.",0,1,1,0,0,0,
15-jul-13,N.L.,"JUAREZ, N.L.",1,0,1,0,0,0,
15-jul-13,CHIS.,"JIQUIPILAS, CHIS.",1,0,1,0,0,0,
15-jul-13,TAMPS.,"REYNOSA, TAMPS.",1,0,1,1,0,27,
16-jul-13,B.C.,"TIJUANA, B.C.",0,1,1,0,0,0,
16-jul-13,N.L.,"JUAREZ, N.L.",0,1,1,5,0,0,
16-jul-13,B.C.S.,"MULEGÉ, B.C.S.",0,1,1,0,0,0,
16-jul-13,QRO.,"QUERETARO, QRO.",0,1,1,0,0,0,
16-jul-13,PUE.,"CHALCHICOMULA DE SESMA, PUE.",1,0,1,2,0,0,
17-jul-13,N.L.,"APODACA, N.L.",1,0,1,0,0,100,
17-jul-13,TAB.,"COMALCALCO, TAB.",1,0,1,0,0,0,
17-jul-13,PUE.,"TECAMACHALCO, PUE.",1,0,1,0,0,0,
17-jul-13,VER.,"OTATITLAN, VER.",1,0,1,0,0,0,
17-jul-13,CHIH.,"MADERA, CHIH.",1,0,1,0,0,0,
18-jul-13,TAB.,"COMALCALCO, TAB.",1,0,1,0,0,0,
18-jul-13,N.L.,"JUAREZ, N.L.",0,1,1,3,0,0,
18-jul-13,TAB.,"BALANCAN, TAB.",1,0,1,0,0,0,
18-jul-13,VER.,"COATZACOALCOS, VER.",1,0,1,0,0,0,
18-jul-13,TAMPS.,"EL MANTE, TAMPS.",0,1,1,0,0,136,
18-jul-13,B.C.S.,"MULEGÉ, B.C.S.",0,1,1,0,0,0,
18-jul-13,TAMPS.,"EL MANTE, TAMPS.",1,0,1,0,0,0,
19-jul-13,VER.,"MINATITLAN, VER.",1,0,1,0,0,32,
19-jul-13,COAH.,"TORREÓN, COAH.",1,0,1,0,0,0,
19-jul-13,PUE.,"SAN MARTIN TEXMELUCAN, PUE.",1,0,1,0,0,900,
19-jul-13,PUE.,"SAN ANDRES CHOLULA, PUE.",1,0,1,0,0,22,
19-jul-13,OAX.,"MIAHUATLAN DE PORFIRIO DIAZ, OAX.",1,0,1,0,1,1785,
19-jul-13,AGS.,"ASIENTOS, AGS.",1,0,1,0,0,0,
20-jul-13,PUE.,"VENUSTIANO CARRANZA, PUE.",0,1,1,0,0,0,
20-jul-13,TAB.,"BALANCAN, TAB.",1,0,1,0,0,0,
20-jul-13,CHIS.,"ESCUINTLA, CHIS.",1,0,1,0,0,0,
20-jul-13,TAMPS.,"REYNOSA, TAMPS.",0,1,1,1,0,60,
20-jul-13,TAMPS.,"GONZALEZ, TAMPS.",1,0,1,1,1,0,
20-jul-13,JAL.,"PUERTO VALLARTA, JAL.",1,0,1,0,0,0,
21-jul-13,B.C.,"ENSENADA, B.C.",0,1,1,0,0,0,
21-jul-13,PUE.,"PUE., PUE.",1,0,1,0,0,0,
21-jul-13,PUE.,"VENUSTIANO CARRANZA, PUE.",1,0,1,1,0,0,
22-jul-13,N.L.,"GRAL. ESCOBEDO, N.L.",0,1,1,1,0,111,
22-jul-13,PUE.,"SAN MARTIN TEXMELUCAN, PUE.",0,1,1,0,0,0,
23-jul-13,AGS.,"ASIENTOS, AGS.",1,0,1,0,0,0,
23-jul-13,PUE.,"VENUSTIANO CARRANZA, PUE.",1,0,1,0,0,0,
23-jul-13,COAH.,"TORREÓN, COAH.",1,0,1,0,0,0,
23-jul-13,TAB.,"COMALCALCO, TAB.",1,0,1,0,0,0,
24-jul-13,PUE.,"SAN MARTIN TEXMELUCAN, PUE.",1,0,1,1,0,87,
24-jul-13,PUE.,"VENUSTIANO CARRANZA, PUE.",1,0,1,0,0,0,
24-jul-13,JAL.,"ZAPOTLAN EL GRANDE, JAL.",0,1,1,0,0,0,
24-jul-13,B.C.,"ENSENADA, B.C.",0,1,1,0,0,0,
24-jul-13,PUE.,"SAN ANDRES CHOLULA, PUE.",0,1,1,0,1,0,
25-jul-13,S.L.P.,"CIUDAD DEL MAIZ, S.L.P.",1,0,1,0,0,0,
25-jul-13,MOR.,"PUENTE DE IXTLA, MOR.",0,1,1,0,0,0,
25-jul-13,GRO.,"CHILPANCINGO DE LOS BRAVO, GRO.",1,0,1,0,3,0,
25-jul-13,JAL.,"ZAPOPAN, JAL.",1,0,1,0,0,0,
26-jul-13,PUE.,"VENUSTIANO CARRANZA, PUE.",0,1,1,0,0,0,
26-jul-13,B.C.S.,"MULEGÉ, B.C.S.",0,1,1,0,0,0,
26-jul-13,CHIS.,"TUZANTÁN, CHIS.",0,1,1,2,0,0,
26-jul-13,TAMPS.,"RIO BRAVO, TAMPS.",0,1,1,1,0,27,
27-jul-13,COAH.,"TORREÓN, COAH.",1,0,1,0,0,0,
27-jul-13,MOR.,"PUENTE DE IXTLA, MOR.",1,0,1,0,0,0,
27-jul-13,GRO.,"CHILPANCINGO DE LOS BRAVO, GRO.",1,0,1,0,0,0,
29-jul-13,SIN.,"COSALA, SIN.",1,0,1,0,0,0,
29-jul-13,COAH.,"TORREÓN, COAH.",1,0,1,0,0,0,
29-jul-13,CHIS.,"OCOSINGO, CHIS.",0,1,1,0,0,0,
29-jul-13,PUE.,"PUE., PUE.",1,0,1,1,0,337,
29-jul-13,PUE.,"SAN MARTIN TEXMELUCAN, PUE.",0,1,1,0,1,0,
29-jul-13,PUE.,"SAN ANDRES CHOLULA, PUE.",0,1,1,0,0,49,
30-jul-13,B.C.,"MEXICALI, B.C.",0,1,1,0,0,0,
30-jul-13,JAL.,"TECALITLAN, JAL.",0,1,1,0,0,0,
30-jul-13,PUE.,"SAN MARTIN TEXMELUCAN, PUE.",0,1,1,0,2,223,
31-jul-13,PUE.,"PUE., PUE.",1,0,1,0,0,150,
31-jul-13,B.C.,"TIJUANA, B.C.",1,0,1,0,0,0,
31-jul-13,B.C.,"ENSENADA, B.C.",0,1,1,0,0,0,
31-jul-13,AGS.,"TEPEZALÁ, AGS.",1,0,1,71,0,0,
31-jul-13,PUE.,"SAN MARTIN TEXMELUCAN, PUE.",0,1,1,0,1,454,
31-jul-13,PUE.,"VENUSTIANO CARRANZA, PUE.",1,0,1,1,0,0,
01-ago-13,VER.,"COATZACOALCOS, VER.",1,0,1,0,0,0,
01-ago-13,CHIH.,"JUÁREZ, CHIH.",0,1,1,0,0,0,
01-ago-13,B.C.,"TIJUANA, B.C.",0,1,1,0,0,0,
01-ago-13,MOR.,"PUENTE DE IXTLA, MOR.",0,1,1,0,0,0,
02-ago-13,AGS.,"TEPEZALÁ, AGS.",0,1,1,0,0,0,
02-ago-13,VER.,"TUXPAM, VER.",0,1,1,0,0,0,
02-ago-13,TAB.,"CUNDUACAN, TAB.",1,0,1,0,0,0,
02-ago-13,TAMPS.,"NUEVO LAREDO, TAMPS.",1,0,1,4,0,899,
02-ago-13,PUE.,"VENUSTIANO CARRANZA, PUE.",1,0,1,0,0,1,
03-ago-13,MOR.,"PUENTE DE IXTLA, MOR.",1,0,1,0,0,0,
03-ago-13,PUE.,"PUE., PUE.",1,0,1,0,0,0,
03-ago-13,PUE.,"VENUSTIANO CARRANZA, PUE.",1,0,1,0,0,0,
04-ago-13,N.L.,"GUADALUPE, N.L.",0,1,1,12,0,70,
04-ago-13,B.C.,"TECATE, B.C.",1,0,1,0,0,0,
04-ago-13,B.C.,"ENSENADA, B.C.",1,0,1,0,0,0,
05-ago-13,PUE.,"ATLIXCO, PUE.",0,1,1,0,1,392,
05-ago-13,N.L.,"GARCIA, N.L.",0,1,1,1,0,24,
06-ago-13,GRO.,"ATOYAC DE ALVAREZ, GRO.",0,1,1,0,0,0,
06-ago-13,JAL.,"PIHUAMO, JAL.",1,0,1,0,0,0,
07-ago-13,HGO.,"HUEJUTLA DE REYES, HGO.",1,0,1,0,0,0,
07-ago-13,B.C.,"TIJUANA, B.C.",1,0,1,0,0,0,
07-ago-13,B.C.,"ENSENADA, B.C.",1,0,1,0,0,0,
07-ago-13,JAL.,"ZAPOPAN, JAL.",1,0,1,0,0,0,
08-ago-13,COAH.,"ACUÑA, COAH.",0,1,1,0,0,0,
09-ago-13,B.C.S.,"MULEGÉ, B.C.S.",1,0,1,0,0,0,
10-ago-13,TAB.,"CUNDUACAN, TAB.",1,0,1,0,0,0,
10-ago-13,COAH.,"ACUÑA, COAH.",0,1,1,0,0,0,
10-ago-13,B.C.S.,"MULEGÉ, B.C.S.",1,0,1,0,0,0,
10-ago-13,TAMPS.,"GONZALEZ, TAMPS.",0,1,1,0,0,0,
11-ago-13,N.L.,"SANTA CATARINA, N.L.",1,0,1,3,0,271,
12-ago-13,COAH.,"TORREÓN, COAH.",1,0,1,0,0,0,
12-ago-13,B.C.,"TIJUANA, B.C.",0,1,1,0,0,0,
12-ago-13,PUE.,"ATLIXCO, PUE.",1,0,1,0,0,0,
12-ago-13,CHIS.,"OCOSINGO, CHIS.",0,1,1,0,0,0,
12-ago-13,VER.,"NANCHITAL DE LAZARO CARDENAS DEL RIO, VER.",1,0,1,0,0,0,
13-ago-13,COAH.,"TORREÓN, COAH.",1,0,1,0,0,0,
13-ago-13,COAH.,"ACUÑA, COAH.",0,1,1,0,0,0,
13-ago-13,PUE.,"ATLIXCO, PUE.",1,0,1,3,0,326,
13-ago-13,PUE.,"TEPEACA, PUE.",1,0,1,0,0,0,
14-ago-13,HGO.,"HUEJUTLA DE REYES, HGO.",0,1,1,0,0,0,
14-ago-13,HGO.,"IXMIQUILPAN, HGO.",1,0,1,0,0,200,
14-ago-13,COAH.,"TORREÓN, COAH.",1,0,1,0,0,0,
14-ago-13,COAH.,"ACUÑA, COAH.",1,0,1,0,0,0,
15-ago-13,SIN.,"SAN IGNACIO, SIN.",1,0,1,0,0,0,
15-ago-13,PUE.,"ATLIXCO, PUE.",1,0,1,0,1,0,
15-ago-13,YUC.,"CHICHIMILA, YUC.",0,1,1,0,0,0,
16-ago-13,HGO.,"HUEJUTLA DE REYES, HGO.",0,1,1,0,0,0,
16-ago-13,CHIH.,"NUEVO CASAS GRANDES, CHIH.",0,1,1,0,0,0,
16-ago-13,COL.,"TECOMÁN, COL.",0,1,1,0,0,0,
16-ago-13,COAH.,"ACUÑA, COAH.",0,1,1,0,0,0,
16-ago-13,TAMPS.,"VICTORIA, TAMPS.",1,0,1,0,1,0,
16-ago-13,JAL.,"GUACHINANGO, JAL.",1,0,1,0,0,22,
16-ago-13,YUC.,"OXKUTZCAB, YUC.",0,1,1,0,0,0,
17-ago-13,HGO.,"IXMIQUILPAN, HGO.",1,0,1,0,0,0,
19-ago-13,N.L.,"SAN NICOLAS DE LOS GARZA, N.L.",0,1,1,12,0,50,
19-ago-13,N.L.,"SAN PEDRO GARZA GARCIA, N.L.",0,1,1,4,0,100,
19-ago-13,PUE.,"ATLIXCO, PUE.",1,0,1,0,0,121,
19-ago-13,PUE.,"TEPEACA, PUE.",1,0,1,1,0,10,
20-ago-13,PUE.,"ATLIXCO, PUE.",1,0,1,0,0,0,
20-ago-13,CHIH.,"CASAS GRANDES, CHIH.",1,0,1,0,0,0,
20-ago-13,YUC.,"TEKAX, YUC.",0,1,1,0,0,0,
20-ago-13,YUC.,"KAUA, YUC.",0,1,1,0,0,0,
20-ago-13,YUC.,"TEKAX, YUC.",1,0,1,0,0,0,
21-ago-13,TAB.,"CUNDUACAN, TAB.",0,1,1,0,0,0,
21-ago-13,CHIH.,"CASAS GRANDES, CHIH.",1,0,1,0,0,0,
21-ago-13,PUE.,"SAN SALVADOR EL SECO, PUE.",1,0,1,0,0,0,
21-ago-13,N.L.,"VALLECILLO, N.L.",0,1,1,35,0,149,
21-ago-13,MOR.,"CUAUTLA, MOR.",0,1,1,0,3,18,
21-ago-13,HGO.,"SAN BARTOLO TUTOTEPEC, HGO.",1,0,1,0,0,0,
22-ago-13,PUE.,"TEPEACA, PUE.",0,1,1,0,0,7,
22-ago-13,CHIH.,"CASAS GRANDES, CHIH.",1,0,1,0,0,0,
22-ago-13,N.L.,"SAN PEDRO GARZA GARCIA, N.L.",1,0,1,21,1,245,
23-ago-13,HGO.,"SAN BARTOLO TUTOTEPEC, HGO.",0,1,1,0,0,0,
23-ago-13,HGO.,"TEPEAPULCO, HGO.",1,0,1,0,0,0,
23-ago-13,N.L.,"GARCIA, N.L.",1,0,1,0,0,0,
23-ago-13,B.C.,"TECATE, B.C.",1,0,1,0,0,0,
24-ago-13,PUE.,"TEPEXI DE RODRIGUEZ, PUE.",0,1,1,0,0,0,
24-ago-13,PUE.,"SAN SALVADOR EL SECO, PUE.",1,0,1,0,0,0,
24-ago-13,B.C.,"TECATE, B.C.",0,1,1,0,0,0,
24-ago-13,HGO.,"JACALA DE LEDEZMA, HGO.",1,0,1,0,0,0,
24-ago-13,JAL.,"CUAUTITLAN DE GARCIA BARRAGAN, JAL.",0,1,1,0,0,0,
26-ago-13,TAB.,"CUNDUACAN, TAB.",1,0,1,0,0,11,
26-ago-13,PUE.,"ATLIXCO, PUE.",0,1,1,0,0,229,
26-ago-13,SON.,"HERMOSILLO, SON.",1,0,1,0,0,0,
27-ago-13,HGO.,"SAN BARTOLO TUTOTEPEC, HGO.",1,0,1,0,0,0,
27-ago-13,HGO.,"JACALA DE LEDEZMA, HGO.",1,0,1,0,0,0,
27-ago-13,CAMP.,"CAMP., CAMP.",1,0,1,0,0,0,
27-ago-13,CHIH.,"BUENAVENTURA, CHIH.",1,0,1,0,0,77,
27-ago-13,SON.,"CAJEME, SON.",0,1,1,0,0,0,
27-ago-13,B.C.,"TIJUANA, B.C.",1,0,1,0,0,0,
28-ago-13,HGO.,"SAN BARTOLO TUTOTEPEC, HGO.",1,0,1,0,0,0,
28-ago-13,MOR.,"CUAUTLA, MOR.",1,0,1,1,0,0,
29-ago-13,HGO.,"JACALA DE LEDEZMA, HGO.",0,1,1,0,0,0,
29-ago-13,SON.,"HERMOSILLO, SON.",1,0,1,0,0,14,
29-ago-13,SON.,"CAJEME, SON.",1,0,1,0,0,1,
29-ago-13,B.C.,"TIJUANA, B.C.",1,0,1,0,0,0,
29-ago-13,B.C.,"ENSENADA, B.C.",0,1,1,0,0,0,
29-ago-13,MOR.,"CUAUTLA, MOR.",1,0,1,1,0,60,
30-ago-13,PUE.,"CHIGNAHUAPAN, PUE.",1,0,1,0,0,0,
30-ago-13,N.L.,"PARAS, N.L.",0,1,1,7,0,1600,
30-ago-13,N.L.,"CHINA, N.L.",1,0,1,0,0,0,
31-ago-13,N.L.,"CHINA, N.L.",0,1,1,3,0,0,
31-ago-13,MOR.,"CUAUTLA, MOR.",1,0,1,0,0,0,
01-sep-13,TAMPS.,"GONZALEZ, TAMPS.",0,1,1,1,0,107,
02-sep-13,CHIH.,"HGO. DEL PARRAL, CHIH.",0,1,1,0,0,0,
03-sep-13,CHIH.,"HGO. DEL PARRAL, CHIH.",0,1,1,0,0,0,
03-sep-13,B.C.,"TIJUANA, B.C.",1,0,1,0,0,0,
04-sep-13,Q. ROO,"OTHON P. BLANCO, Q. ROO",1,0,1,0,0,0,
04-sep-13,YUC.,"CHANKOM, YUC.",1,0,1,0,0,0,
04-sep-13,PUE.,"ATLIXCO, PUE.",1,0,1,1,0,528,
04-sep-13,COAH.,"ACUÑA, COAH.",1,0,1,0,0,0,
05-sep-13,SON.,"HERMOSILLO, SON.",1,0,1,1,0,0,
05-sep-13,SON.,"CAJEME, SON.",1,0,1,0,0,0,
05-sep-13,PUE.,"TEZIUTLAN, PUE.",1,0,1,0,0,274,
05-sep-13,B.C.,"ENSENADA, B.C.",0,1,1,0,0,0,
05-sep-13,COAH.,"ACUÑA, COAH.",1,0,1,0,0,0,
06-sep-13,YUC.,"TEKOM, YUC.",1,0,1,0,0,0,
06-sep-13,PUE.,"ATLIXCO, PUE.",1,0,1,0,0,146,
06-sep-13,Q. ROO,"OTHON P. BLANCO, Q. ROO",1,0,1,0,0,372,
06-sep-13,CHIH.,"CASAS GRANDES, CHIH.",1,0,1,0,0,0,
06-sep-13,CHIH.,"ALDAMA, CHIH.",1,0,1,0,0,0,
07-sep-13,TAMPS.,"GONZALEZ, TAMPS.",1,0,1,0,0,0,
07-sep-13,PUE.,"CALPAN, PUE.",1,0,1,0,0,50,
08-sep-13,B.C.,"ENSENADA, B.C.",0,1,1,0,0,0,
09-sep-13,N.L.,"GRAL. BRAVO, N.L.",1,0,1,0,0,50,
10-sep-13,N.L.,"DR. COSS, N.L.",0,1,1,6,0,0,
11-sep-13,B.C.,"ENSENADA, B.C.",1,0,1,0,0,0,
11-sep-13,Q. ROO,"LAZARO CARDENAS, Q. ROO",1,0,1,0,0,0,
11-sep-13,PUE.,"ATLIXCO, PUE.",1,0,1,6,3,802,
11-sep-13,PUE.,"TEZIUTLAN, PUE.",0,1,1,0,0,0,
12-sep-13,SON.,"CAJEME, SON.",1,0,1,0,0,0,
12-sep-13,COAH.,"ACUÑA, COAH.",0,1,1,0,0,0,
14-sep-13,SON.,"HERMOSILLO, SON.",0,1,1,6,0,0,
14-sep-13,COAH.,"ACUÑA, COAH.",0,1,1,0,0,0,
14-sep-13,N.L.,"MELCHOR OCAMPO, N.L.",0,1,1,0,0,0,
16-sep-13,SON.,"SAN LUIS RIO COLORADO, SON.",1,0,1,0,0,0,
17-sep-13,SIN.,"CULIACAN, SIN.",0,1,1,2,0,0,
17-sep-13,PUE.,"ATLIXCO, PUE.",0,1,1,0,2,0,
18-sep-13,PUE.,"ATLIXCO, PUE.",1,0,1,0,0,0,
18-sep-13,PUE.,"TEZIUTLAN, PUE.",0,1,1,0,0,25,
18-sep-13,MOR.,"XOCHITEPEC, MOR.",0,1,1,0,0,0,
19-sep-13,SON.,"HERMOSILLO, SON.",1,0,1,4,0,47,
19-sep-13,PUE.,"ATLIXCO, PUE.",0,1,1,1,3,0,
19-sep-13,MOR.,"XOCHITEPEC, MOR.",1,0,1,0,0,0,
20-sep-13,PUE.,"ATLIXCO, PUE.",1,0,1,0,0,400,
20-sep-13,PUE.,"TEZIUTLAN, PUE.",1,0,1,0,0,0,
20-sep-13,SON.,"CAJEME, SON.",1,0,1,0,0,0,
20-sep-13,CHIH.,"ALDAMA, CHIH.",1,0,1,0,0,0,
20-sep-13,MOR.,"XOCHITEPEC, MOR.",0,1,1,0,2,0,
20-sep-13,B.C.,"TIJUANA, B.C.",1,0,1,0,0,0,
20-sep-13,B.C.,"ENSENADA, B.C.",1,0,1,0,0,0,
21-sep-13,SON.,"CAJEME, SON.",0,1,1,0,0,0,
21-sep-13,PUE.,"ATLIXCO, PUE.",1,0,1,0,0,0,
23-sep-13,PUE.,"TEZIUTLAN, PUE.",1,0,1,0,0,24,
23-sep-13,SON.,"CAJEME, SON.",1,0,1,0,0,0,
23-sep-13,B.C.,"ENSENADA, B.C.",1,0,1,0,0,0,
23-sep-13,SON.,"SAN LUIS RIO COLORADO, SON.",1,0,1,1,0,60,
24-sep-13,PUE.,"CALPAN, PUE.",1,0,1,0,0,0,
24-sep-13,OAX.,"PINOTEPA DE DON LUIS, OAX.",0,1,1,0,0,0,
25-sep-13,PUE.,"ATLIXCO, PUE.",1,0,1,0,0,326,
25-sep-13,PUE.,"CALPAN, PUE.",0,1,1,0,0,0,
25-sep-13,B.C.,"ENSENADA, B.C.",1,0,1,0,0,0,
26-sep-13,ZAC.,"JALPA, ZAC.",1,0,1,0,0,0,
27-sep-13,ZAC.,"JALPA, ZAC.",1,0,1,0,0,0,
27-sep-13,NAY.,"TEPIC, NAY.",1,0,1,1,0,0,
27-sep-13,TAMPS.,"NUEVO LAREDO, TAMPS.",0,1,1,4,0,118,
28-sep-13,ZAC.,"FRESNILLO, ZAC.",1,0,1,0,0,0,
30-sep-13,NAY.,"TEPIC, NAY.",1,0,1,0,0,0,
30-sep-13,MOR.,"XOCHITEPEC, MOR.",1,0,1,0,3,33,
30-sep-13,N.L.,"CADEREYTA JIMENEZ, N.L.",0,1,1,0,0,14,
01-oct-13,SON.,"CAJEME, SON.",1,0,1,0,0,0,
01-oct-13,NAY.,"TEPIC, NAY.",0,1,1,1,0,0,
01-oct-13,CHIS.,"ARRIAGA, CHIS.",0,1,1,0,0,39,
02-oct-13,B.C.,"ENSENADA, B.C.",1,0,1,0,0,0,
02-oct-13,NAY.,"ACAPONETA, NAY.",0,1,1,0,0,0,
02-oct-13,YUC.,"CHOCHOLA, YUC.",0,1,1,0,0,0,
02-oct-13,CHIS.,"MAPASTEPEC, CHIS.",1,0,1,1,0,0,
02-oct-13,CHIS.,"ARRIAGA, CHIS.",1,0,1,0,0,0,
03-oct-13,NAY.,"TEPIC, NAY.",1,0,1,1,0,0,
03-oct-13,VER.,"CATEMACO, VER.",1,0,1,0,0,0,
03-oct-13,ZAC.,"VALPARAISO, ZAC.",1,0,1,1,0,0,
04-oct-13,NAY.,"ACAPONETA, NAY.",0,1,1,0,0,0,
04-oct-13,COAH.,"SALTILLO, COAH.",1,0,1,0,0,0,
04-oct-13,COAH.,"MÚZQUIZ, COAH.",0,1,1,0,0,0,
04-oct-13,ZAC.,"VALPARAISO, ZAC.",1,0,1,1,0,0,
04-oct-13,ZAC.,"APOZOL, ZAC.",1,0,1,0,0,200,
04-oct-13,B.C.,"TECATE, B.C.",1,0,1,0,0,0,
06-oct-13,N.L.,"MIER Y NORIEGA, N.L.",1,0,1,0,0,0,
07-oct-13,ZAC.,"JEREZ, ZAC.",1,0,1,1,0,23,
07-oct-13,ZAC.,"RIO GRANDE, ZAC.",1,0,1,1,0,0,
07-oct-13,ZAC.,"VALPARAISO, ZAC.",1,0,1,1,0,0,
07-oct-13,CHIS.,"ARRIAGA, CHIS.",1,0,1,0,0,0,
07-oct-13,N.L.,"PESQUERIA, N.L.",1,0,1,5,0,0,
07-oct-13,SON.,"HERMOSILLO, SON.",1,0,1,14,0,0,
07-oct-13,NAY.,"TEPIC, NAY.",1,0,1,0,0,0,
07-oct-13,TAMPS.,"VICTORIA, TAMPS.",1,0,1,0,0,285,
08-oct-13,ZAC.,"TLALTENANGO DE SANCHEZ ROMAN, ZAC.",0,1,1,0,0,0,
08-oct-13,SON.,"CAJEME, SON.",1,0,1,0,0,180,
08-oct-13,TAMPS.,"VICTORIA, TAMPS.",1,0,1,0,0,285,
09-oct-13,CHIS.,"ARRIAGA, CHIS.",1,0,1,0,0,0,
09-oct-13,B.C.,"ENSENADA, B.C.",0,1,1,0,0,0,
10-oct-13,CHIS.,"TAPACHULA, CHIS.",1,0,1,0,0,0,
10-oct-13,CHIS.,"MAPASTEPEC, CHIS.",1,0,1,0,0,0,
10-oct-13,VER.,"XALAPA, VER.",1,0,1,0,0,0,
10-oct-13,ZAC.,"ZAC., ZAC.",0,1,1,1,0,17,
10-oct-13,ZAC.,"GUADALUPE, ZAC.",1,0,1,0,0,50,
10-oct-13,ZAC.,"TLALTENANGO DE SANCHEZ ROMAN, ZAC.",1,0,1,8,0,232,
10-oct-13,SON.,"CAJEME, SON.",1,0,1,0,0,0,
10-oct-13,COAH.,"MONCLOVA, COAH.",1,0,1,0,0,510,
10-oct-13,N.L.,"VILLALDAMA, N.L.",0,1,1,0,0,0,
11-oct-13,ZAC.,"TLALTENANGO DE SANCHEZ ROMAN, ZAC.",1,0,1,0,0,50,
11-oct-13,COAH.,"TORREÓN, COAH.",1,0,1,0,0,0,
11-oct-13,AGS.,"AGS., AGS.",1,0,1,13,0,24,
11-oct-13,CHIS.,"TAPACHULA, CHIS.",1,0,1,0,0,138,
11-oct-13,CHIS.,"CINTALAPA, CHIS.",1,0,1,0,0,0,
11-oct-13,TAMPS.,"VICTORIA, TAMPS.",1,0,1,2,1,115,
11-oct-13,ZAC.,"ZAC., ZAC.",0,1,1,0,0,23,
12-oct-13,SON.,"CAJEME, SON.",1,0,1,0,0,0,
12-oct-13,COAH.,"MÚZQUIZ, COAH.",1,0,1,1,0,0,
12-oct-13,B.C.,"TIJUANA, B.C.",1,0,1,0,0,0,
13-oct-13,ZAC.,"CAÑITAS DE FELIPE PESCADOR, ZAC.",1,0,1,0,0,0,
14-oct-13,NAY.,"HUAJICORI, NAY.",1,0,1,0,0,0,
14-oct-13,HGO.,"ZACUALTIPAN DE ANGELES, HGO.",1,0,1,0,0,0,
14-oct-13,HGO.,"TULANCINGO DE BRAVO, HGO.",1,0,1,0,0,1802,
14-oct-13,CHIS.,"TAPACHULA, CHIS.",1,0,1,0,0,48,
14-oct-13,ZAC.,"TAB., ZAC.",1,0,1,0,0,0,
15-oct-13,B.C.,"TIJUANA, B.C.",1,0,1,0,0,0,
15-oct-13,COAH.,"TORREÓN, COAH.",0,1,1,0,0,0,
15-oct-13,VER.,"XALAPA, VER.",1,0,1,0,0,0,
15-oct-13,ZAC.,"ZAC., ZAC.",1,0,1,0,0,0,
15-oct-13,ZAC.,"JEREZ, ZAC.",0,1,1,0,0,0,
15-oct-13,CHIS.,"REFORMA, CHIS.",1,0,1,0,0,0,
15-oct-13,CAMP.,"CANDELARIA, CAMP.",1,0,1,1,0,2,
15-oct-13,HGO.,"ZACUALTIPAN DE ANGELES, HGO.",1,0,1,0,0,0,
15-oct-13,HGO.,"TULANCINGO DE BRAVO, HGO.",1,0,1,0,0,40,
15-oct-13,OAX.,"PINOTEPA DE DON LUIS, OAX.",1,0,1,1,0,0,
15-oct-13,TAMPS.,"VICTORIA, TAMPS.",0,1,1,0,1,0,
15-oct-13,TAMPS.,"XICOTENCATL, TAMPS.",1,0,1,1,0,58,
16-oct-13,HGO.,"ZACUALTIPAN DE ANGELES, HGO.",1,0,1,0,0,0,
16-oct-13,OAX.,"PINOTEPA DE DON LUIS, OAX.",1,0,1,1,0,0,
16-oct-13,YUC.,"RIO LAGARTOS, YUC.",1,0,1,0,0,0,
16-oct-13,SON.,"CAJEME, SON.",1,0,1,0,0,0,
17-oct-13,ZAC.,"ZAC., ZAC.",1,0,1,0,0,100,
17-oct-13,ZAC.,"GUADALUPE, ZAC.",1,0,1,0,0,800,
17-oct-13,ZAC.,"TLALTENANGO DE SANCHEZ ROMAN, ZAC.",0,1,1,2,0,80,
17-oct-13,ZAC.,"FRESNILLO, ZAC.",1,0,1,1,0,0,
17-oct-13,COAH.,"NUEVA ROSITA, COAH.",0,1,1,0,0,0,
17-oct-13,NAY.,"HUAJICORI, NAY.",1,0,1,0,0,0,
17-oct-13,JAL.,"TIZAPAN EL ALTO, JAL.",1,0,1,0,0,0,
18-oct-13,CHIS.,"REFORMA, CHIS.",1,0,1,0,0,0,
18-oct-13,OAX.,"SANTA MARIA GUIENAGATI, OAX.",1,0,1,6,0,0,
18-oct-13,CHIS.,"TAPACHULA, CHIS.",1,0,1,0,0,0,
18-oct-13,SIN.,"CONCORDIA, SIN.",1,0,1,0,5,0,
18-oct-13,JAL.,"TIZAPAN EL ALTO, JAL.",1,0,1,0,0,0,
18-oct-13,VER.,"XALAPA, VER.",1,0,1,0,0,0,
19-oct-13,CHIS.,"TAPACHULA, CHIS.",1,0,1,0,0,0,
20-oct-13,B.C.,"TIJUANA, B.C.",1,0,1,0,0,0,
21-oct-13,ZAC.,"GUADALUPE, ZAC.",1,0,1,0,0,0,
21-oct-13,B.C.,"ENSENADA, B.C.",0,1,1,0,0,0,
21-oct-13,CHIS.,"TAPACHULA, CHIS.",1,0,1,0,0,0,
21-oct-13,HGO.,"ZACUALTIPAN DE ANGELES, HGO.",1,0,1,0,0,0,
21-oct-13,HGO.,"TULANCINGO DE BRAVO, HGO.",1,0,1,0,0,0,
21-oct-13,TAMPS.,"VICTORIA, TAMPS.",1,0,1,0,0,70,
21-oct-13,NAY.,"IXTLAN DEL RIO, NAY.",0,1,1,0,0,0,
22-oct-13,HGO.,"TULANCINGO DE BRAVO, HGO.",1,0,1,0,0,0,
22-oct-13,ZAC.,"ZAC., ZAC.",1,0,1,0,0,17,
22-oct-13,ZAC.,"FRESNILLO, ZAC.",1,0,1,0,0,50,
22-oct-13,NAY.,"IXTLAN DEL RIO, NAY.",1,0,1,0,0,0,
22-oct-13,CHIS.,"TAPACHULA, CHIS.",1,0,1,0,0,0,
22-oct-13,B.C.,"ENSENADA, B.C.",1,0,1,0,0,0,
22-oct-13,CHIS.,"HUIXTLA, CHIS.",0,1,1,0,0,0,
22-oct-13,SON.,"CAJEME, SON.",0,1,1,0,0,0,
23-oct-13,ZAC.,"ZAC., ZAC.",1,0,1,0,0,0,
23-oct-13,COAH.,"NUEVA ROSITA, COAH.",1,0,1,0,0,0,
23-oct-13,N.L.,"ABASOLO, N.L.",1,0,1,9,0,150,
23-oct-13,HGO.,"TULANCINGO DE BRAVO, HGO.",1,0,1,0,0,0,
23-oct-13,JAL.,"TAPALPA, JAL.",1,0,1,0,0,0,
23-oct-13,CHIS.,"TAPACHULA, CHIS.",1,0,1,2,0,20,
24-oct-13,AGS.,"AGS., AGS.",1,0,1,2,0,140,
24-oct-13,NAY.,"IXTLAN DEL RIO, NAY.",0,1,1,0,0,0,
24-oct-13,B.C.,"TIJUANA, B.C.",0,1,1,0,0,0,
24-oct-13,ZAC.,"GUADALUPE, ZAC.",1,0,1,0,0,0,
24-oct-13,ZAC.,"FRESNILLO, ZAC.",1,0,1,5,0,190,
25-oct-13,ZAC.,"ZAC., ZAC.",0,1,1,0,0,50,
25-oct-13,ZAC.,"GUADALUPE, ZAC.",1,0,1,0,0,0,
25-oct-13,ZAC.,"FRESNILLO, ZAC.",1,0,1,0,0,0,
25-oct-13,CHIS.,"TAPACHULA, CHIS.",1,0,1,2,0,0,
25-oct-13,B.C.,"TIJUANA, B.C.",0,1,1,0,0,0,
25-oct-13,SON.,"CAJEME, SON.",0,1,1,0,0,13,
26-oct-13,CHIS.,"MOTOZINTLA, CHIS.",1,0,1,0,0,0,
26-oct-13,CHIS.,"HUIXTLA, CHIS.",0,1,1,0,0,0,
26-oct-13,B.C.,"TIJUANA, B.C.",1,0,1,0,0,0,
28-oct-13,ZAC.,"JEREZ, ZAC.",0,1,1,1,0,80,
28-oct-13,ZAC.,"VALPARAISO, ZAC.",1,0,1,1,0,0,
29-oct-13,COAH.,"ALLENDE, COAH.",1,0,1,0,0,116,
29-oct-13,CHIS.,"MOTOZINTLA, CHIS.",1,0,1,0,0,0,
29-oct-13,CHIS.,"TUXTLA CHICO, CHIS.",1,0,1,0,0,0,
29-oct-13,CHIS.,"OCOSINGO, CHIS.",0,1,1,0,0,0,
30-oct-13,SON.,"CAJEME, SON.",0,1,1,0,0,0,
30-oct-13,CHIS.,"TAPACHULA, CHIS.",1,0,1,0,1,0,
30-oct-13,ZAC.,"TLALTENANGO DE SANCHEZ ROMAN, ZAC.",0,1,1,0,0,150,
30-oct-13,ZAC.,"JEREZ, ZAC.",1,0,1,0,0,0,
30-oct-13,ZAC.,"FRESNILLO, ZAC.",1,0,1,0,0,115,
30-oct-13,ZAC.,"VALPARAISO, ZAC.",1,0,1,0,0,0,
30-oct-13,SON.,"CAJEME, SON.",0,1,1,0,0,0,
31-oct-13,B.C.,"MEXICALI, B.C.",1,0,1,0,0,0,
31-oct-13,CHIS.,"HUIXTÁN, CHIS.",1,0,1,2,1,66,
31-oct-13,SON.,"HERMOSILLO, SON.",0,1,1,0,0,0,
31-oct-13,COAH.,"MÚZQUIZ, COAH.",1,0,1,6,0,120,
31-oct-13,CHIH.,"MADERA, CHIH.",0,1,1,0,0,0,
31-oct-13,ZAC.,"TLALTENANGO DE SANCHEZ ROMAN, ZAC.",1,0,1,0,0,268,
31-oct-13,ZAC.,"JALPA, ZAC.",1,0,1,0,0,0,
01-nov-13,NAY.,"HUAJICORI, NAY.",1,0,1,0,0,0,
05-nov-13,S.L.P.,"SAN LUIS POTOSI, S.L.P.",0,1,1,0,0,0,
05-nov-13,COAH.,"NUEVA ROSITA, COAH.",1,0,1,0,0,0,
05-nov-13,B.C.,"TIJUANA, B.C.",0,1,1,0,0,0,
05-nov-13,B.C.,"ENSENADA, B.C.",0,1,1,0,0,0,
05-nov-13,JAL.,"ACATLAN DE JUAREZ, JAL.",1,0,1,0,0,0,
06-nov-13,YUC.,"SAN FELIPE, YUC.",0,1,1,0,0,0,
06-nov-13,NAY.,"JALA, NAY.",0,1,1,0,0,0,
06-nov-13,B.C.,"ENSENADA, B.C.",0,1,1,0,0,0,
06-nov-13,COL.,"COL., COL.",0,1,1,0,1,5,
07-nov-13,COAH.,"ARTEAGA, COAH.",1,0,1,0,0,305,
07-nov-13,B.C.,"MEXICALI, B.C.",1,0,1,0,0,0,
07-nov-13,JAL.,"ACATLAN DE JUAREZ, JAL.",1,0,1,0,0,0,
08-nov-13,B.C.,"TECATE, B.C.",1,0,1,0,0,0,
10-nov-13,N.L.,"GRAL. TERAN, N.L.",0,1,1,0,0,0,
11-nov-13,YUC.,"PANABA, YUC.",1,0,1,0,0,0,
11-nov-13,N.L.,"GRAL. TERAN, N.L.",0,1,1,0,0,0,
11-nov-13,B.C.,"TIJUANA, B.C.",0,1,1,0,0,0,
12-nov-13,CHIH.,"JANOS, CHIH.",1,0,1,0,0,0,
12-nov-13,PUE.,"PUE., PUE.",1,0,1,0,0,199,
13-nov-13,HGO.,"TEPEJI DEL RIO DE OCAMPO, HGO.",1,0,1,0,0,0,
13-nov-13,YUC.,"PANABA, YUC.",1,0,1,0,0,0,
13-nov-13,NAY.,"ROSAMORADA, NAY.",0,1,1,0,0,0,
14-nov-13,HGO.,"ZIMAPAN, HGO.",1,0,1,0,0,0,
14-nov-13,COAH.,"CASTAÑOS, COAH.",1,0,1,0,0,0,
14-nov-13,COAH.,"MÚZQUIZ, COAH.",0,1,1,0,0,50,
15-nov-13,B.C.,"TECATE, B.C.",1,0,1,0,0,0,
15-nov-13,B.C.,"ENSENADA, B.C.",1,0,1,0,0,0,
15-nov-13,COAH.,"CASTAÑOS, COAH.",0,1,1,0,0,73,
15-nov-13,COAH.,"ALLENDE, COAH.",0,1,1,0,0,0,
16-nov-13,COAH.,"CASTAÑOS, COAH.",1,0,1,0,0,0,
16-nov-13,TAMPS.,"NUEVO LAREDO, TAMPS.",1,0,1,0,0,0,
16-nov-13,TAMPS.,"TAMPICO, TAMPS.",0,1,1,0,0,0,
16-nov-13,HGO.,"ZIMAPAN, HGO.",1,0,1,0,0,0,
16-nov-13,COAH.,"NUEVA ROSITA, COAH.",0,1,1,0,0,0,
19-nov-13,NAY.,"JALA, NAY.",1,0,1,0,0,0,
21-nov-13,HGO.,"PACHUCA DE SOTO, HGO.",0,1,1,0,0,0,
21-nov-13,NAY.,"JALA, NAY.",1,0,1,0,0,0,
21-nov-13,B.C.,"ENSENADA, B.C.",0,1,1,0,0,0,
21-nov-13,N.L.,"APODACA, N.L.",1,0,1,0,0,275,
22-nov-13,SON.,"URES, SON.",1,0,1,0,0,0,
22-nov-13,SON.,"GUAYMAS, SON.",0,1,1,0,0,0,
22-nov-13,SON.,"ALAMOS, SON.",1,0,1,0,0,0,
22-nov-13,PUE.,"PUE., PUE.",1,0,1,1,0,198,
22-nov-13,SON.,"AGUA PRIETA, SON.",0,1,1,0,0,13,
22-nov-13,HGO.,"PACHUCA DE SOTO, HGO.",1,0,1,0,0,220,
22-nov-13,N.L.,"SAN PEDRO GARZA GARCIA, N.L.",1,0,1,0,0,0,
22-nov-13,N.L.,"APODACA, N.L.",1,0,1,2,0,0,
23-nov-13,COL.,"COL., COL.",1,0,1,0,0,0,
23-nov-13,SON.,"HUATABAMPO, SON.",1,0,1,0,0,0,
23-nov-13,HGO.,"TEPEJI DEL RIO DE OCAMPO, HGO.",1,0,1,0,0,0,
24-nov-13,N.L.,"GRAL. ESCOBEDO, N.L.",1,0,1,1,0,0,
25-nov-13,SON.,"AGUA PRIETA, SON.",0,1,1,0,0,0,
25-nov-13,SON.,"GUAYMAS, SON.",0,1,1,0,0,18,
25-nov-13,SON.,"YECORA, SON.",1,0,1,1,0,0,
25-nov-13,SON.,"HUATABAMPO, SON.",0,1,1,2,0,20,
25-nov-13,SON.,"NAVOJOA, SON.",1,0,1,0,0,50,
25-nov-13,B.C.,"TECATE, B.C.",0,1,1,0,0,0,
25-nov-13,B.C.,"ENSENADA, B.C.",0,1,1,0,0,0,
26-nov-13,SON.,"ALTAR, SON.",0,1,1,0,0,0,
26-nov-13,SON.,"PUERTO PEÑASCO, SON.",1,0,1,0,0,49,
26-nov-13,SON.,"MAGDALENA, SON.",1,0,1,1,0,60,
26-nov-13,SON.,"HERMOSILLO, SON.",1,0,1,1,0,225,
26-nov-13,SON.,"MOCTEZUMA, SON.",1,0,1,1,0,0,
26-nov-13,SON.,"YECORA, SON.",1,0,1,0,0,0,
26-nov-13,SON.,"CAJEME, SON.",0,1,1,0,0,0,
26-nov-13,SON.,"ALAMOS, SON.",0,1,1,0,0,0,
26-nov-13,N.L.,"GRAL. ESCOBEDO, N.L.",1,0,1,2,0,50,
26-nov-13,NAY.,"RUIZ, NAY.",1,0,1,0,0,0,
26-nov-13,PUE.,"PUE., PUE.",1,0,1,0,0,0,
26-nov-13,TAMPS.,"VICTORIA, TAMPS.",1,0,1,0,0,0,
27-nov-13,SON.,"CANANEA, SON.",0,1,1,0,0,0,
27-nov-13,N.L.,"GRAL. ESCOBEDO, N.L.",1,0,1,2,0,150,
27-nov-13,SON.,"GUAYMAS, SON.",1,0,1,0,0,240,
27-nov-13,SON.,"ALAMOS, SON.",1,0,1,0,0,0,
27-nov-13,SON.,"PITIQUITO, SON.",0,1,1,0,0,0,
27-nov-13,SON.,"GENERAL PLUTARCO ELIAS CALLES, SON.",1,0,1,0,0,0,
28-nov-13,TAMPS.,"NUEVO LAREDO, TAMPS.",0,1,1,0,0,0,
28-nov-13,SON.,"AGUA PRIETA, SON.",0,1,1,0,0,0,
28-nov-13,SON.,"SANTA ANA, SON.",1,0,1,1,0,19,
28-nov-13,SON.,"GUAYMAS, SON.",1,0,1,1,0,5,
28-nov-13,SON.,"EMPALME, SON.",1,0,1,1,0,0,
28-nov-13,SON.,"CAJEME, SON.",0,1,1,0,0,0,
28-nov-13,SON.,"ALAMOS, SON.",1,0,1,0,0,0,
29-nov-13,SON.,"CANANEA, SON.",1,0,1,0,0,94,
29-nov-13,SON.,"MAGDALENA, SON.",1,0,1,0,0,43,
29-nov-13,NAY.,"COMPOSTELA, NAY.",1,0,1,0,0,0,
29-nov-13,SON.,"MOCTEZUMA, SON.",0,1,1,0,0,0,
29-nov-13,SON.,"CUMPAS, SON.",1,0,1,0,0,0,
29-nov-13,SON.,"URES, SON.",1,0,1,0,0,0,
29-nov-13,SON.,"CAJEME, SON.",1,0,1,0,0,0,
29-nov-13,SON.,"NAVOJOA, SON.",1,0,1,0,0,0,
29-nov-13,SON.,"ALAMOS, SON.",1,0,1,0,0,20,
29-nov-13,TAMPS.,"NUEVO LAREDO, TAMPS.",1,0,1,1,0,174,
29-nov-13,TAMPS.,"VICTORIA, TAMPS.",1,0,1,0,1,80,
30-nov-13,COAH.,"PIEDRAS NEGRAS, COAH.",0,1,1,0,0,0,
30-nov-13,PUE.,"PUE., PUE.",1,0,1,0,0,0,
30-nov-13,SON.,"CANANEA, SON.",0,1,1,0,0,0,
02-dic-13,CHIS.,"OCOSINGO, CHIS.",0,1,1,0,0,0,
02-dic-13,COL.,"MANZANILLO, COL.",1,0,1,0,0,0,
02-dic-13,SON.,"NOGALES, SON.",1,0,1,1,1,0,
02-dic-13,COAH.,"MONCLOVA, COAH.",0,1,1,0,0,0,
03-dic-13,SON.,"AGUA PRIETA, SON.",1,0,1,1,0,14,
03-dic-13,SON.,"PUERTO PEÑASCO, SON.",1,0,1,0,0,0,
03-dic-13,SON.,"PITIQUITO, SON.",0,1,1,0,0,0,
03-dic-13,NAY.,"RUIZ, NAY.",0,1,1,0,0,0,
03-dic-13,TAMPS.,"EL MANTE, TAMPS.",1,0,1,0,0,0,
03-dic-13,SON.,"HERMOSILLO, SON.",1,0,1,0,0,74,
03-dic-13,SON.,"URES, SON.",1,0,1,0,0,284,
03-dic-13,SON.,"EMPALME, SON.",1,0,1,0,0,2,
03-dic-13,SON.,"CAJEME, SON.",1,0,1,0,0,0,
03-dic-13,SON.,"NAVOJOA, SON.",1,0,1,0,0,0,
03-dic-13,COAH.,"SALTILLO, COAH.",1,0,1,5,0,206,
04-dic-13,SON.,"PUERTO PEÑASCO, SON.",1,0,1,0,0,0,
04-dic-13,SON.,"PITIQUITO, SON.",0,1,1,0,0,0,
04-dic-13,CHIH.,"CASAS GRANDES, CHIH.",1,0,1,0,0,0,
04-dic-13,N.L.,"JUAREZ, N.L.",1,0,1,5,1,0,
04-dic-13,TAMPS.,"NUEVO LAREDO, TAMPS.",1,0,1,0,0,370,
04-dic-13,SON.,"ALAMOS, SON.",1,0,1,0,0,0,
05-dic-13,SON.,"HERMOSILLO, SON.",1,0,1,26,0,151,
05-dic-13,SON.,"BANAMICHI, SON.",0,1,1,0,0,0,
05-dic-13,SON.,"HUATABAMPO, SON.",1,0,1,0,0,0,
05-dic-13,SON.,"ETCHOJOA, SON.",1,0,1,0,0,6,
05-dic-13,SON.,"CABORCA, SON.",1,0,1,0,0,0,
05-dic-13,OAX.,"CIUDAD IXTEPEC, OAX.",1,0,1,1,0,0,
05-dic-13,CHIS.,"PALENQUE, CHIS.",1,0,1,1,0,2,
06-dic-13,B.C.,"TECATE, B.C.",0,1,1,0,0,0,
06-dic-13,SON.,"GUAYMAS, SON.",0,1,1,0,0,585,
06-dic-13,SON.,"CAJEME, SON.",1,0,1,0,0,0,
06-dic-13,N.L.,"SAN NICOLAS DE LOS GARZA, N.L.",0,1,1,0,0,0,
06-dic-13,TAMPS.,"GONZALEZ, TAMPS.",1,0,1,1,0,0,
06-dic-13,TAB.,"CARDENAS, TAB.",1,0,1,0,0,0,
07-dic-13,N.L.,"GUADALUPE, N.L.",1,0,1,1,0,50,
07-dic-13,SON.,"BANAMICHI, SON.",1,0,1,0,0,0,
07-dic-13,SON.,"GUAYMAS, SON.",1,0,1,0,0,0,
07-dic-13,SON.,"HUATABAMPO, SON.",0,1,1,0,0,0,
07-dic-13,COAH.,"MONCLOVA, COAH.",1,0,1,0,0,0,
07-dic-13,SON.,"CABORCA, SON.",0,1,1,0,0,0,
08-dic-13,TAMPS.,"CIUDAD MADERO, TAMPS.",1,0,1,2,0,43,
08-dic-13,B.C.,"ENSENADA, B.C.",1,0,1,0,0,0,
09-dic-13,SON.,"NOGALES, SON.",1,0,1,0,0,0,
09-dic-13,SON.,"GENERAL PLUTARCO ELIAS CALLES, SON.",1,0,1,0,0,0,
09-dic-13,SON.,"MAGDALENA, SON.",1,0,1,2,0,0,
09-dic-13,COAH.,"MONCLOVA, COAH.",1,0,1,0,0,0,
09-dic-13,COL.,"COL., COL.",1,0,1,0,0,0,
09-dic-13,SON.,"URES, SON.",0,1,1,0,0,0,
09-dic-13,SON.,"GUAYMAS, SON.",0,1,1,0,0,0,
09-dic-13,SON.,"NAVOJOA, SON.",1,0,1,8,0,105,
10-dic-13,TAB.,"CARDENAS, TAB.",1,0,1,0,0,0,
10-dic-13,SON.,"MOCTEZUMA, SON.",1,0,1,1,0,0,
10-dic-13,N.L.,"GUADALUPE, N.L.",0,1,1,11,0,280,
10-dic-13,COAH.,"SALTILLO, COAH.",1,0,1,4,0,243,
10-dic-13,SON.,"NOGALES, SON.",0,1,1,2,0,102,
10-dic-13,SON.,"AGUA PRIETA, SON.",0,1,1,0,0,6,
10-dic-13,SON.,"CABORCA, SON.",1,0,1,0,0,0,
10-dic-13,SON.,"CANANEA, SON.",1,0,1,1,0,20,
11-dic-13,N.L.,"GARCIA, N.L.",1,0,1,28,0,0,
11-dic-13,B.C.S.,"MULEGÉ, B.C.S.",0,1,1,0,0,0,
11-dic-13,CAMP.,"CARMEN, CAMP.",0,1,1,0,0,0,
12-dic-13,PUE.,"ATLIXCO, PUE.",1,0,1,0,0,0,
12-dic-13,TAMPS.,"REYNOSA, TAMPS.",1,0,1,0,0,0,
12-dic-13,COAH.,"SALTILLO, COAH.",0,1,1,0,0,0,
13-dic-13,N.L.,"GARCIA, N.L.",0,1,1,4,0,150,
13-dic-13,PUE.,"ATLIXCO, PUE.",1,0,1,0,0,57,
14-dic-13,TAMPS.,"REYNOSA, TAMPS.",1,0,1,6,0,300,
14-dic-13,N.L.,"GARCIA, N.L.",1,0,1,22,0,100,
14-dic-13,N.L.,"SANTIAGO, N.L.",1,0,1,4,0,144,
14-dic-13,CHIS.,"PALENQUE, CHIS.",1,0,1,0,0,48,
16-dic-13,COAH.,"SALTILLO, COAH.",1,0,1,0,0,418,
16-dic-13,SON.,"MOCTEZUMA, SON.",1,0,1,0,0,0,
18-dic-13,YUC.,"VALLADOLID, YUC.",0,1,1,0,0,0,
18-dic-13,PUE.,"ATLIXCO, PUE.",1,0,1,0,0,0,
19-dic-13,CAMP.,"CAMP., CAMP.",0,1,1,0,0,0,
19-dic-13,PUE.,"ATLIXCO, PUE.",1,0,1,0,0,0,
22-dic-13,TAMPS.,"NUEVO LAREDO, TAMPS.",1,0,1,0,0,173,
23-dic-13,COL.,"COL., COL.",1,0,1,0,0,0,
26-dic-13,GRO.,"CHILPANCINGO DE LOS BRAVO, GRO.",1,0,1,0,0,0,
28-dic-13,PUE.,"ATLIXCO, PUE.",0,1,1,0,3,0,
02-ene-14,TAMPS.,"NUEVO LAREDO, TAMPS.",1,0,1,1,0,209,
04-ene-14,PUE.,"ATLIXCO, PUE.",0,1,1,0,0,0,
04-ene-14,TAB.,"TENOSIQUE, TAB.",0,1,1,1,0,0,
07-ene-14,Q. ROO,"OTHON P. BLANCO, Q. ROO",1,0,1,0,0,0,
08-ene-14,CHIH.,"IGNACIO ZARAGOZA, CHIH.",1,0,1,0,0,0,
09-ene-14,CHIH.,"IGNACIO ZARAGOZA, CHIH.",1,0,1,0,0,0,
11-ene-14,YUC.,"OXKUTZCAB, YUC.",1,0,1,0,0,0,
15-ene-14,PUE.,"PUE., PUE.",1,0,1,0,0,86,
16-ene-14,Q. ROO,"COZUMEL, Q. ROO",1,0,1,0,0,26,
16-ene-14,VER.,"COATZACOALCOS, VER.",0,1,1,0,0,0,
16-ene-14,PUE.,"PUE., PUE.",1,0,1,0,0,0,
16-ene-14,CAMP.,"CANDELARIA, CAMP.",0,1,1,0,0,0,
16-ene-14,TAMPS.,"TAMPICO, TAMPS.",1,0,1,0,0,71,
17-ene-14,YUC.,"CHICHIMILA, YUC.",1,0,1,0,0,0,
17-ene-14,PUE.,"PUE., PUE.",0,1,1,0,0,0,
18-ene-14,PUE.,"PUE., PUE.",0,1,1,0,0,130,
19-ene-14,TAMPS.,"GONZALEZ, TAMPS.",1,0,1,0,0,165,
20-ene-14,TAMPS.,"GONZALEZ, TAMPS.",1,0,1,0,0,0,
20-ene-14,Q. ROO,"OTHON P. BLANCO, Q. ROO",1,0,1,0,0,69,
20-ene-14,COAH.,"MONCLOVA, COAH.",1,0,1,0,0,0,
20-ene-14,COAH.,"SALTILLO, COAH.",1,0,1,0,0,40,
21-ene-14,CHIH.,"ROSALES, CHIH.",1,0,1,0,0,0,
21-ene-14,TAB.,"NACAJUCA, TAB.",1,0,1,0,0,0,
21-ene-14,COAH.,"FRONTERA, COAH.",1,0,1,0,0,0,
23-ene-14,CAMP.,"CANDELARIA, CAMP.",0,1,1,1,0,0,
23-ene-14,TAB.,"NACAJUCA, TAB.",1,0,1,1,0,0,
23-ene-14,PUE.,"TEHUACAN, PUE.",1,0,1,0,0,0,
23-ene-14,PUE.,"PUE., PUE.",1,0,1,0,0,0,
23-ene-14,Q. ROO,"BENITO JUAREZ, Q. ROO",1,0,1,0,0,310,
23-ene-14,COAH.,"ACUÑA, COAH.",1,0,1,0,0,0,
24-ene-14,PUE.,"PUE., PUE.",0,1,1,0,0,0,
24-ene-14,Q. ROO,"BENITO JUAREZ, Q. ROO",1,0,1,0,0,577,
24-ene-14,Q. ROO,"OTHON P. BLANCO, Q. ROO",1,0,1,1,0,9,
24-ene-14,TAMPS.,"NUEVO LAREDO, TAMPS.",1,0,1,10,0,1099,
24-ene-14,CAMP.,"CANDELARIA, CAMP.",0,1,1,0,0,0,
24-ene-14,CHIH.,"GÓMEZ FARÍAS, CHIH.",1,0,1,0,0,0,
25-ene-14,TAMPS.,"NUEVO LAREDO, TAMPS.",0,1,1,11,0,342,
25-ene-14,TAMPS.,"GONZALEZ, TAMPS.",1,0,1,1,0,0,
26-ene-14,CAMP.,"CANDELARIA, CAMP.",0,1,1,0,0,0,
26-ene-14,COAH.,"MOR., COAH.",1,0,1,0,0,27,
26-ene-14,COAH.,"ACUÑA, COAH.",1,0,1,0,0,0,
27-ene-14,Q. ROO,"BENITO JUAREZ, Q. ROO",1,0,1,0,0,205,
27-ene-14,COAH.,"TORREÓN, COAH.",1,0,1,0,0,0,
27-ene-14,COAH.,"SALTILLO, COAH.",1,0,1,0,0,0,
28-ene-14,CAMP.,"CANDELARIA, CAMP.",0,1,1,0,0,0,
28-ene-14,TAB.,"TENOSIQUE, TAB.",1,0,1,0,0,0,
28-ene-14,PUE.,"PUE., PUE.",1,0,1,0,0,0,
28-ene-14,COAH.,"MONCLOVA, COAH.",1,0,1,0,0,145,
29-ene-14,TAB.,"NACAJUCA, TAB.",1,0,1,0,0,0,
29-ene-14,PUE.,"TEHUACAN, PUE.",1,0,1,0,0,3,
29-ene-14,Q. ROO,"BENITO JUAREZ, Q. ROO",1,0,1,0,0,577,
29-ene-14,COAH.,"ACUÑA, COAH.",0,1,1,0,0,0,
30-ene-14,TAMPS.,"CIUDAD MADERO, TAMPS.",1,0,1,0,0,0,
30-ene-14,PUE.,"PUE., PUE.",1,0,1,1,0,0,
30-ene-14,COAH.,"FRONTERA, COAH.",0,1,1,0,0,0,
30-ene-14,Q. ROO,"BACALAR, Q. ROO",1,0,1,0,0,0,
30-ene-14,TAB.,"NACAJUCA, TAB.",1,0,1,0,0,35,
31-ene-14,PUE.,"PUE., PUE.",1,0,1,11,0,0,
31-ene-14,COAH.,"SALTILLO, COAH.",1,0,1,3,0,405,
01-feb-14,COAH.,"SALTILLO, COAH.",0,1,1,0,0,114,
01-feb-14,COAH.,"ACUÑA, COAH.",1,0,1,0,0,0,
01-feb-14,COAH.,"PIEDRAS NEGRAS, COAH.",1,0,1,0,0,0,
01-feb-14,COAH.,"TORREÓN, COAH.",1,0,1,0,0,0,
02-feb-14,Q. ROO,"SOLIDARIDAD, Q. ROO",0,1,1,0,0,53,
04-feb-14,COAH.,"FRONTERA, COAH.",1,0,1,0,0,25,
04-feb-14,MICH.,"LAZARO CARDENAS, MICH.",0,1,1,0,0,0,
04-feb-14,PUE.,"PUE., PUE.",1,0,1,0,0,0,
05-feb-14,MEX.,"JUCHITEPEC, MEX.",1,0,1,0,0,0,
05-feb-14,PUE.,"TEHUACAN, PUE.",1,0,1,1,0,50,
05-feb-14,PUE.,"PUE., PUE.",1,0,1,0,0,0,
05-feb-14,COAH.,"SALTILLO, COAH.",0,1,1,0,0,133,
05-feb-14,COAH.,"MONCLOVA, COAH.",1,0,1,0,0,0,
06-feb-14,S.L.P.,"CIUDAD DEL MAIZ, S.L.P.",1,0,1,0,0,0,
06-feb-14,NAY.,"TEPIC, NAY.",1,0,1,0,0,0,
06-feb-14,MICH.,"LAZARO CARDENAS, MICH.",0,1,1,0,0,0,
06-feb-14,TAMPS.,"TAMPICO, TAMPS.",1,0,1,0,0,103,
06-feb-14,MEX.,"JUCHITEPEC, MEX.",1,0,1,0,0,0,
06-feb-14,COAH.,"SALTILLO, COAH.",0,1,1,1,1,319,
07-feb-14,YUC.,"DZAN, YUC.",1,0,1,0,0,0,
07-feb-14,YUC.,"MANI, YUC.",0,1,1,0,0,0,
08-feb-14,COAH.,"SALTILLO, COAH.",0,1,1,1,0,49,
08-feb-14,COAH.,"PIEDRAS NEGRAS, COAH.",0,1,1,0,0,0,
10-feb-14,ZAC.,"TLALTENANGO DE SANCHEZ ROMAN, ZAC.",1,0,1,0,0,0,
10-feb-14,VER.,"ORIZABA, VER.",0,1,1,0,0,0,
11-feb-14,ZAC.,"TLALTENANGO DE SANCHEZ ROMAN, ZAC.",1,0,1,0,0,22,
11-feb-14,COAH.,"PIEDRAS NEGRAS, COAH.",1,0,1,3,0,69,
12-feb-14,PUE.,"TEHUACAN, PUE.",1,0,1,0,0,0,
12-feb-14,NAY.,"ACAPONETA, NAY.",1,0,1,0,0,0,
12-feb-14,TAB.,"CARDENAS, TAB.",1,0,1,1,0,0,
12-feb-14,VER.,"TUXPAM, VER.",0,1,1,0,0,11,
13-feb-14,CAMP.,"CAMP., CAMP.",1,0,1,0,0,0,
13-feb-14,PUE.,"TEHUACAN, PUE.",1,0,1,0,0,0,
13-feb-14,ZAC.,"TLALTENANGO DE SANCHEZ ROMAN, ZAC.",1,0,1,0,0,0,
13-feb-14,ZAC.,"JEREZ, ZAC.",1,0,1,0,0,0,
13-feb-14,COAH.,"SALTILLO, COAH.",0,1,1,0,0,30,
13-feb-14,COAH.,"MÚZQUIZ, COAH.",1,0,1,0,0,2,
14-feb-14,MICH.,"LAZARO CARDENAS, MICH.",0,1,1,0,0,0,
14-feb-14,TAMPS.,"TAMPICO, TAMPS.",1,0,1,0,0,151,
15-feb-14,VER.,"TUXPAM, VER.",1,0,1,1,0,11,
15-feb-14,COAH.,"PIEDRAS NEGRAS, COAH.",0,1,1,0,0,105,
16-feb-14,TAB.,"NACAJUCA, TAB.",0,1,1,0,0,0,
17-feb-14,NAY.,"ACAPONETA, NAY.",1,0,1,0,0,0,
17-feb-14,VER.,"XALAPA, VER.",1,0,1,0,0,0,
17-feb-14,CHIH.,"NUEVO CASAS GRANDES, CHIH.",1,0,1,0,0,0,
17-feb-14,COAH.,"ACUÑA, COAH.",1,0,1,0,0,0,
18-feb-14,VER.,"TUXPAM, VER.",0,1,1,3,0,82,
18-feb-14,VER.,"MARTINEZ DE LA TORRE, VER.",0,1,1,0,0,0,
18-feb-14,ZAC.,"TLALTENANGO DE SANCHEZ ROMAN, ZAC.",1,0,1,0,0,0,
18-feb-14,COAH.,"SALTILLO, COAH.",1,0,1,0,0,0,
19-feb-14,COAH.,"FRONTERA, COAH.",1,0,1,0,0,16,
20-feb-14,VER.,"XALAPA, VER.",1,0,1,0,0,0,
20-feb-14,VER.,"MARTINEZ DE LA TORRE, VER.",1,0,1,0,0,0,
20-feb-14,NAY.,"TEPIC, NAY.",1,0,1,1,0,0,
20-feb-14,TAB.,"HUIMANGUILLO, TAB.",1,0,1,0,0,0,
20-feb-14,CAMP.,"CAMP., CAMP.",1,0,1,0,0,0,
21-feb-14,CAMP.,"CALAKMUL, CAMP.",1,0,1,0,0,0,
21-feb-14,ZAC.,"JEREZ, ZAC.",0,1,1,0,0,0,
21-feb-14,COAH.,"TORREÓN, COAH.",0,1,1,0,0,130,
21-feb-14,NAY.,"TEPIC, NAY.",1,0,1,0,0,0,
21-feb-14,PUE.,"PUE., PUE.",1,0,1,0,0,0,
24-feb-14,MICH.,"LAZARO CARDENAS, MICH.",1,0,1,0,1,0,
24-feb-14,CAMP.,"CALAKMUL, CAMP.",0,1,1,0,0,0,
24-feb-14,TAMPS.,"XICOTENCATL, TAMPS.",1,0,1,1,0,0,
25-feb-14,S.L.P.,"CIUDAD VALLES, S.L.P.",1,0,1,3,0,39,
25-feb-14,VER.,"XALAPA, VER.",1,0,1,0,0,0,
25-feb-14,VER.,"MARTINEZ DE LA TORRE, VER.",0,1,1,0,0,0,
25-feb-14,HGO.,"METEPEC, HGO.",1,0,1,0,0,0,
26-feb-14,VER.,"XALAPA, VER.",1,0,1,0,1,0,
26-feb-14,VER.,"MARTINEZ DE LA TORRE, VER.",0,1,1,0,0,0,
26-feb-14,S.L.P.,"CIUDAD DEL MAIZ, S.L.P.",1,0,1,0,0,0,
27-feb-14,CAMP.,"CAMP., CAMP.",1,0,1,0,0,0,
27-feb-14,S.L.P.,"CIUDAD VALLES, S.L.P.",0,1,1,0,0,0,
27-feb-14,VER.,"MARTINEZ DE LA TORRE, VER.",0,1,1,0,0,0,
27-feb-14,MICH.,"LAZARO CARDENAS, MICH.",1,0,1,0,0,0,
27-feb-14,COAH.,"SALTILLO, COAH.",1,0,1,0,0,382,
27-feb-14,COAH.,"FRONTERA, COAH.",1,0,1,0,0,0,
27-feb-14,TAMPS.,"TAMPICO, TAMPS.",1,0,1,0,0,0,
28-feb-14,CHIH.,"HGO. DEL PARRAL, CHIH.",1,0,1,0,0,0,
28-feb-14,S.L.P.,"CIUDAD VALLES, S.L.P.",0,1,1,0,1,0,
28-feb-14,COAH.,"FRONTERA, COAH.",1,0,1,0,0,246,
28-feb-14,CAMP.,"CAMP., CAMP.",1,0,1,0,0,0,
28-feb-14,VER.,"ALAMO, VER.",1,0,1,1,0,27,
28-feb-14,VER.,"MARTINEZ DE LA TORRE, VER.",1,0,1,0,0,0,
28-feb-14,VER.,"MARTINEZ DE LA TORRE, VER.",1,0,1,0,0,0,
01-mar-14,VER.,"COATZACOALCOS, VER.",1,0,1,0,0,0,
03-mar-14,S.L.P.,"CIUDAD VALLES, S.L.P.",0,1,1,0,0,31,
03-mar-14,MICH.,"LAZARO CARDENAS, MICH.",1,0,1,0,0,0,
03-mar-14,NAY.,"COMPOSTELA, NAY.",1,0,1,0,0,0,
03-mar-14,VER.,"POZA RICA DE HGO., VER.",1,0,1,0,0,0,
04-mar-14,VER.,"PAPANTLA, VER.",1,0,1,0,0,0,
04-mar-14,HGO.,"HUEJUTLA DE REYES, HGO.",1,0,1,0,0,0,
04-mar-14,VER.,"MARTINEZ DE LA TORRE, VER.",0,1,1,0,0,0,
04-mar-14,N.L.,"MONTERREY, N.L.",1,0,1,3,0,318,
04-mar-14,S.L.P.,"CIUDAD VALLES, S.L.P.",0,1,1,2,1,14,
04-mar-14,B.C.S.,"MULEGÉ, B.C.S.",1,0,1,0,0,0,
05-mar-14,SON.,"CAJEME, SON.",1,0,1,0,0,0,
05-mar-14,VER.,"POZA RICA DE HGO., VER.",1,0,1,0,0,0,
05-mar-14,VER.,"XALAPA, VER.",1,0,1,0,0,0,
06-mar-14,SON.,"CAJEME, SON.",1,0,1,3,0,0,
06-mar-14,VER.,"ZONGOLICA, VER.",1,0,1,0,0,0,
06-mar-14,VER.,"POZA RICA DE HGO., VER.",1,0,1,0,0,0,
07-mar-14,TAMPS.,"EL MANTE, TAMPS.",1,0,1,1,0,8,
07-mar-14,HGO.,"HUEJUTLA DE REYES, HGO.",1,0,1,0,0,0,
07-mar-14,ZAC.,"ZAC., ZAC.",1,0,1,1,0,0,
07-mar-14,VER.,"TUXPAM, VER.",1,0,1,0,0,226,
07-mar-14,VER.,"ALAMO, VER.",1,0,1,2,0,19,
08-mar-14,VER.,"TUXPAM, VER.",1,0,1,0,0,226,
08-mar-14,VER.,"ALAMO, VER.",1,0,1,2,0,19,
08-mar-14,PUE.,"TEHUACAN, PUE.",1,0,1,0,0,17,
10-mar-14,VER.,"POZA RICA DE HGO., VER.",1,0,1,0,0,0,
10-mar-14,VER.,"SAN RAFAEL, VER.",1,0,1,0,0,0,
10-mar-14,ZAC.,"JEREZ, ZAC.",1,0,1,0,0,0,
10-mar-14,N.L.,"SAN NICOLAS DE LOS GARZA, N.L.",0,1,1,3,0,50,
11-mar-14,B.C.,"TECATE, B.C.",0,1,1,0,0,0,
11-mar-14,N.L.,"SAN NICOLAS DE LOS GARZA, N.L.",1,0,1,0,0,37,
12-mar-14,VER.,"POZA RICA DE HGO., VER.",1,0,1,0,0,0,
12-mar-14,VER.,"COATZINTLA, VER.",1,0,1,0,0,0,
12-mar-14,PUE.,"TEPEXI DE RODRIGUEZ, PUE.",1,0,1,1,0,0,
12-mar-14,SON.,"HERMOSILLO, SON.",1,0,1,1,0,5,
12-mar-14,B.C.,"ENSENADA, B.C.",1,0,1,0,0,0,
12-mar-14,TAMPS.,"TAMPICO, TAMPS.",1,0,1,1,0,35,
12-mar-14,VER.,"SAN RAFAEL, VER.",0,1,1,0,0,0,
13-mar-14,VER.,"POZA RICA DE HGO., VER.",1,0,1,0,0,0,
13-mar-14,ZAC.,"TLALTENANGO DE SANCHEZ ROMAN, ZAC.",1,0,1,0,0,53,
14-mar-14,ZAC.,"JEREZ, ZAC.",1,0,1,0,0,0,
14-mar-14,VER.,"XALAPA, VER.",0,1,1,0,1,113,
14-mar-14,N.L.,"SAN NICOLAS DE LOS GARZA, N.L.",1,0,1,0,0,200,
14-mar-14,MICH.,"LAZARO CARDENAS, MICH.",1,0,1,0,0,0,
14-mar-14,COAH.,"ACUÑA, COAH.",0,1,1,0,0,0,
15-mar-14,SON.,"HERMOSILLO, SON.",1,0,1,1,0,0,
15-mar-14,MICH.,"LAZARO CARDENAS, MICH.",0,1,1,0,0,0,
16-mar-14,B.C.,"TIJUANA, B.C.",0,1,1,0,0,0,
17-mar-14,N.L.,"MONTERREY, N.L.",1,0,1,5,0,0,
17-mar-14,CHIH.,"HGO. DEL PARRAL, CHIH.",1,0,1,0,0,0,
18-mar-14,HGO.,"ACAXOCHITLAN, HGO.",1,0,1,0,0,0,
18-mar-14,N.L.,"SAN NICOLAS DE LOS GARZA, N.L.",0,1,1,0,0,0,
18-mar-14,CHIH.,"HGO. DEL PARRAL, CHIH.",1,0,1,1,0,0,
18-mar-14,SON.,"HERMOSILLO, SON.",0,1,1,0,0,0,
19-mar-14,JAL.,"CASIMIRO CASTILLO, JAL.",0,1,1,0,0,0,
19-mar-14,ZAC.,"SOMBRERETE, ZAC.",1,0,1,0,0,0,
19-mar-14,CHIH.,"HGO. DEL PARRAL, CHIH.",0,1,1,0,0,0,
19-mar-14,MICH.,"LAZARO CARDENAS, MICH.",1,0,1,0,0,0,
20-mar-14,YUC.,"TIZIMIN, YUC.",0,1,1,0,0,0,
20-mar-14,JAL.,"GUADALAJARA, JAL.",1,0,1,0,0,0,
20-mar-14,CHIH.,"HGO. DEL PARRAL, CHIH.",0,1,1,0,0,0,
21-mar-14,VER.,"TUXPAM, VER.",0,1,1,0,0,0,
21-mar-14,TAB.,"CENTLA, TAB.",1,0,1,0,3,71,
21-mar-14,CHIH.,"JUÁREZ, CHIH.",1,0,1,0,1,0,
21-mar-14,COAH.,"ACUÑA, COAH.",0,1,1,0,0,0,
22-mar-14,ZAC.,"SOMBRERETE, ZAC.",1,0,1,0,0,0,
24-mar-14,CHIS.,"TUXTLA GUTIÉRREZ, CHIS.",0,1,1,0,0,0,
24-mar-14,ZAC.,"VALPARAISO, ZAC.",0,1,1,0,0,0,
24-mar-14,NAY.,"SAN PEDRO LAGUNILLAS, NAY.",1,0,1,0,0,12,
24-mar-14,MICH.,"LAZARO CARDENAS, MICH.",1,0,1,1,0,0,
24-mar-14,JAL.,"GUADALAJARA, JAL.",1,0,1,1,0,0,
24-mar-14,COAH.,"ACUÑA, COAH.",0,1,1,0,0,0,
24-mar-14,QRO.,"TEQUISQUIAPAN, QRO.",1,0,1,0,2,0,
25-mar-14,QRO.,"TEQUISQUIAPAN, QRO.",1,0,1,0,0,0,
26-mar-14,CHIS.,"TUXTLA GUTIÉRREZ, CHIS.",0,1,1,3,0,703,
26-mar-14,AGS.,"AGS., AGS.",1,0,1,2,0,0,
26-mar-14,OAX.,"MATIAS ROMERO AVENDAÑO, OAX.",0,1,1,0,0,44,
26-mar-14,ZAC.,"VALPARAISO, ZAC.",1,0,1,0,0,0,
26-mar-14,MICH.,"LAZARO CARDENAS, MICH.",1,0,1,0,1,0,
26-mar-14,OAX.,"MATIAS ROMERO AVENDAÑO, OAX.",0,1,1,0,0,44,
26-mar-14,OAX.,"LOMA BONITA, OAX.",1,0,1,2,0,147,
26-mar-14,OAX.,"OAX. DE JUAREZ, OAX.",1,0,1,1,0,148,
27-mar-14,OAX.,"MATIAS ROMERO AVENDAÑO, OAX.",0,1,1,0,0,0,
27-mar-14,SON.,"HERMOSILLO, SON.",0,1,1,0,0,0,
27-mar-14,OAX.,"OAX. DE JUAREZ, OAX.",1,0,1,0,0,0,
28-mar-14,CHIH.,"PRAXEDIS G. GRO., CHIH.",0,1,1,0,0,0,
28-mar-14,ZAC.,"JEREZ, ZAC.",1,0,1,0,0,0,
28-mar-14,NAY.,"SAN PEDRO LAGUNILLAS, NAY.",0,1,1,0,0,0,
28-mar-14,VER.,"PANUCO, VER.",0,1,1,0,0,0,
28-mar-14,OAX.,"OAX. DE JUAREZ, OAX.",1,0,1,0,0,1,
28-mar-14,COAH.,"SALTILLO, COAH.",0,1,1,0,0,0,
29-mar-14,TAMPS.,"MATAMOROS, TAMPS.",0,1,1,0,0,0,
29-mar-14,OAX.,"OAX. DE JUAREZ, OAX.",1,0,1,1,0,0,
29-mar-14,OAX.,"LOMA BONITA, OAX.",0,1,1,4,0,0,
29-mar-14,OAX.,"SANTIAGO JUXTLAHUACA, OAX.",1,0,1,1,0,0,
29-mar-14,CHIS.,"YAJALÓN, CHIS.",0,1,1,0,0,0,
29-mar-14,N.L.,"SAN NICOLAS DE LOS GARZA, N.L.",1,0,1,0,0,0,
30-mar-14,B.C.,"TIJUANA, B.C.",0,1,1,0,0,0,
30-mar-14,B.C.,"ENSENADA, B.C.",0,1,1,0,0,0,
31-mar-14,OAX.,"OCOTLAN DE MOR., OAX.",1,0,1,0,0,0,
31-mar-14,SON.,"HERMOSILLO, SON.",0,1,1,0,0,0,
31-mar-14,OAX.,"CIUDAD IXTEPEC, OAX.",1,0,1,0,0,0,
31-mar-14,OAX.,"OCOTLAN DE MOR., OAX.",1,0,1,0,0,0,
31-mar-14,VER.,"VER., VER.",1,0,1,0,0,0,
01-abr-14,HGO.,"MIXQUIAHUALA DE JUAREZ, HGO.",1,0,1,0,0,0,
01-abr-14,OAX.,"OCOTLAN DE MOR., OAX.",1,0,1,0,0,0,
01-abr-14,OAX.,"HEROICA CIUDAD DE HUAJUAPAN DE LEON, OAX.",0,1,1,0,0,0,
01-abr-14,CHIS.,"TUXTLA GUTIÉRREZ, CHIS.",0,1,1,2,1,531,
01-abr-14,B.C.,"ENSENADA, B.C.",0,1,1,0,0,0,
02-abr-14,CHIS.,"TUXTLA GUTIÉRREZ, CHIS.",1,0,1,1,0,383,
02-abr-14,OAX.,"OAX. DE JUAREZ, OAX.",0,1,1,0,0,0,
02-abr-14,OAX.,"CIUDAD IXTEPEC, OAX.",1,0,1,0,0,0,
02-abr-14,ZAC.,"VALPARAISO, ZAC.",1,0,1,1,0,0,
03-abr-14,N.L.,"SANTA CATARINA, N.L.",1,0,1,3,0,113,
03-abr-14,PUE.,"IZUCAR DE MATAMOROS, PUE.",0,1,1,0,0,0,
03-abr-14,CHIS.,"TUZANTÁN, CHIS.",0,1,1,0,0,0,
03-abr-14,OAX.,"OCOTLAN DE MOR., OAX.",1,0,1,0,0,0,
04-abr-14,OAX.,"OAX. DE JUAREZ, OAX.",1,0,1,1,0,8,
04-abr-14,OAX.,"CIUDAD IXTEPEC, OAX.",0,1,1,2,0,0,
04-abr-14,B.C.,"TIJUANA, B.C.",0,1,1,0,0,0,
04-abr-14,N.L.,"SANTA CATARINA, N.L.",0,1,1,40,0,0,
04-abr-14,CHIS.,"TUZANTÁN, CHIS.",1,0,1,0,0,0,
04-abr-14,ZAC.,"MONTE ESCOBEDO, ZAC.",1,0,1,1,0,0,
04-abr-14,NAY.,"SAN PEDRO LAGUNILLAS, NAY.",1,0,1,0,0,0,
04-abr-14,SON.,"HERMOSILLO, SON.",0,1,1,0,0,0,
04-abr-14,CHIS.,"TUXTLA GUTIÉRREZ, CHIS.",0,1,1,0,0,124,
05-abr-14,B.C.,"TECATE, B.C.",0,1,1,0,0,0,
05-abr-14,PUE.,"IZUCAR DE MATAMOROS, PUE.",1,0,1,0,0,0,
05-abr-14,N.L.,"GUADALUPE, N.L.",0,1,1,0,0,500,
05-abr-14,N.L.,"SANTA CATARINA, N.L.",1,0,1,0,0,0,
05-abr-14,DGO.,"DGO., DGO.",1,0,1,0,0,0,
06-abr-14,N.L.,"GUADALUPE, N.L.",1,0,1,0,0,400,
06-abr-14,TAMPS.,"GONZALEZ, TAMPS.",1,0,1,0,0,0,
06-abr-14,CHIS.,"TONALÁ, CHIS.",1,0,1,0,0,0,
07-abr-14,HGO.,"CHILCUAUTLA, HGO.",1,0,1,0,0,0,
07-abr-14,OAX.,"NEJAPA DE MADERO, OAX.",0,1,1,0,0,0,
07-abr-14,OAX.,"OAX. DE JUAREZ, OAX.",1,0,1,0,0,0,
07-abr-14,ZAC.,"ZAC., ZAC.",1,0,1,0,0,60,
07-abr-14,N.L.,"GUADALUPE, N.L.",1,0,1,4,0,200,
07-abr-14,N.L.,"SANTA CATARINA, N.L.",1,0,1,5,0,150,
07-abr-14,B.C.,"ENSENADA, B.C.",0,1,1,0,0,0,
08-abr-14,OAX.,"SAN FRANCISCO SOLA, OAX.",1,0,1,0,0,0,
08-abr-14,OAX.,"SANTA MARIA DEL TULE, OAX.",1,0,1,0,0,0,
08-abr-14,ZAC.,"MONTE ESCOBEDO, ZAC.",1,0,1,0,0,0,
08-abr-14,N.L.,"GUADALUPE, N.L.",1,0,1,0,0,350,
08-abr-14,CHIS.,"TUZANTÁN, CHIS.",1,0,1,0,0,100,
08-abr-14,CHIH.,"CASAS GRANDES, CHIH.",0,1,1,0,0,0,
09-abr-14,OAX.,"OAX. DE JUAREZ, OAX.",1,0,1,7,0,122,
09-abr-14,OAX.,"HEROICA CIUDAD DE HUAJUAPAN DE LEON, OAX.",1,0,1,0,0,0,
09-abr-14,OAX.,"PINOTEPA DE DON LUIS, OAX.",0,1,1,0,0,0,
09-abr-14,OAX.,"SANTA MARIA COLOTEPEC, OAX.",1,0,1,0,0,0,
09-abr-14,YUC.,"TEMAX, YUC.",0,1,1,0,0,0,
09-abr-14,PUE.,"IZUCAR DE MATAMOROS, PUE.",1,0,1,0,0,0,
10-abr-14,YUC.,"DZILAM GONZALEZ, YUC.",1,0,1,0,0,0,
10-abr-14,OAX.,"SANTA MARIA DEL TULE, OAX.",0,1,1,0,0,0,
10-abr-14,VER.,"TANTOYUCA, VER.",0,1,1,0,0,0,
10-abr-14,ZAC.,"LORETO, ZAC.",1,0,1,1,0,0,
10-abr-14,VER.,"TLAPACOYAN, VER.",1,0,1,0,0,0,
10-abr-14,OAX.,"HEROICA CIUDAD DE TLAXIACO, OAX.",1,0,1,0,0,0,
10-abr-14,PUE.,"IZUCAR DE MATAMOROS, PUE.",1,0,1,0,0,0,
11-abr-14,SON.,"HERMOSILLO, SON.",0,1,1,2,0,48,
11-abr-14,ZAC.,"LORETO, ZAC.",1,0,1,1,0,0,
11-abr-14,AGS.,"AGS., AGS.",1,0,1,1,0,6,
11-abr-14,JAL.,"TLAQUEPAQUE, JAL.",1,0,1,0,1,0,
11-abr-14,YUC.,"DZILAM GONZALEZ, YUC.",1,0,1,0,0,0,
11-abr-14,CAMP.,"PALIZADA, CAMP.",0,1,1,0,0,0,
11-abr-14,OAX.,"SANTA MARIA COLOTEPEC, OAX.",0,1,1,0,0,0,
11-abr-14,OAX.,"NEJAPA DE MADERO, OAX.",1,0,1,0,0,0,
12-abr-14,SON.,"HERMOSILLO, SON.",0,1,1,0,0,0,
12-abr-14,SON.,"CAJEME, SON.",1,0,1,0,0,0,
12-abr-14,VER.,"COATZACOALCOS, VER.",1,0,1,0,0,0,
14-abr-14,OAX.,"OAX. DE JUAREZ, OAX.",1,0,1,1,0,3,
14-abr-14,OAX.,"SANTA MARIA DEL TULE, OAX.",0,1,1,0,0,0,
14-abr-14,OAX.,"SANTO DOMINGO INGENIO, OAX.",1,0,1,0,0,29,
14-abr-14,OAX.,"MIAHUATLAN DE PORFIRIO DIAZ, OAX.",1,0,1,0,0,0,
14-abr-14,SON.,"CAJEME, SON.",1,0,1,1,0,1,
15-abr-14,OAX.,"MIAHUATLAN DE PORFIRIO DIAZ, OAX.",1,0,1,0,0,0,
15-abr-14,AGS.,"AGS., AGS.",1,0,1,0,0,70,
15-abr-14,OAX.,"OAX. DE JUAREZ, OAX.",1,0,1,0,0,12,
15-abr-14,CHIS.,"REFORMA, CHIS.",0,1,1,0,0,0,
15-abr-14,NAY.,"SAN PEDRO LAGUNILLAS, NAY.",1,0,1,2,0,0,
15-abr-14,B.C.,"TIJUANA, B.C.",1,0,1,0,0,0,
15-abr-14,N.L.,"SANTA CATARINA, N.L.",0,1,1,72,0,7680,
16-abr-14,N.L.,"APODACA, N.L.",0,1,1,25,0,700,
16-abr-14,TAMPS.,"TAMPICO, TAMPS.",0,1,1,10,0,315,
16-abr-14,S.L.P.,"CIUDAD VALLES, S.L.P.",1,0,1,0,1,0,
16-abr-14,OAX.,"PINOTEPA DE DON LUIS, OAX.",1,0,1,0,0,0,
16-abr-14,MEX.,"NAUCALPAN DE JUAREZ, MEX.",1,0,1,164,0,0,
18-abr-14,N.L.,"GRAL. ESCOBEDO, N.L.",1,0,1,30,0,650,
19-abr-14,N.L.,"GRAL. ESCOBEDO, N.L.",1,0,1,0,0,50,
19-abr-14,B.C.,"TIJUANA, B.C.",1,0,1,0,0,0,
19-abr-14,B.C.,"ENSENADA, B.C.",0,1,1,0,0,0,
21-abr-14,OAX.,"MIAHUATLAN DE PORFIRIO DIAZ, OAX.",1,0,1,0,0,0,
21-abr-14,TAB.,"PARAISO, TAB.",0,1,1,0,0,0,
21-abr-14,OAX.,"OAX. DE JUAREZ, OAX.",1,0,1,0,1,0,
21-abr-14,CHIS.,"HUEHUETÁN, CHIS.",1,0,1,1,0,0,
21-abr-14,S.L.P.,"CIUDAD VALLES, S.L.P.",1,0,1,0,0,70,
21-abr-14,OAX.,"EL ESPINAL, OAX.",1,0,1,5,0,0,
21-abr-14,N.L.,"GRAL. ESCOBEDO, N.L.",1,0,1,2,0,200,
22-abr-14,CHIS.,"SUCHIATE, CHIS.",1,0,1,0,0,0,
22-abr-14,SON.,"CAJEME, SON.",1,0,1,0,0,0,
22-abr-14,MEX.,"NAUCALPAN DE JUAREZ, MEX.",0,1,1,1,0,466,
22-abr-14,NAY.,"SAN BLAS, NAY.",1,0,1,0,0,0,
22-abr-14,CHIS.,"REFORMA, CHIS.",0,1,1,0,0,0,
22-abr-14,OAX.,"OAX. DE JUAREZ, OAX.",0,1,1,0,1,0,
22-abr-14,OAX.,"HEROICA CIUDAD DE HUAJUAPAN DE LEON, OAX.",1,0,1,0,0,0,
22-abr-14,OAX.,"EL ESPINAL, OAX.",0,1,1,0,0,19,
22-abr-14,B.C.,"TIJUANA, B.C.",1,0,1,0,0,0,
22-abr-14,CHIH.,"CHIH., CHIH.",1,0,1,0,0,0,
22-abr-14,CHIH.,"AHUMADA, CHIH.",1,0,1,0,0,0,
23-abr-14,OAX.,"PINOTEPA DE DON LUIS, OAX.",0,1,1,0,0,0,
23-abr-14,SON.,"HERMOSILLO, SON.",1,0,1,0,0,0,
23-abr-14,SON.,"CAJEME, SON.",1,0,1,0,0,0,
23-abr-14,CHIS.,"SUCHIATE, CHIS.",0,1,1,0,0,0,
23-abr-14,S.L.P.,"CIUDAD VALLES, S.L.P.",1,0,1,1,0,70,
23-abr-14,B.C.,"TECATE, B.C.",0,1,1,0,0,0,
23-abr-14,CHIS.,"REFORMA, CHIS.",1,0,1,0,0,0,
23-abr-14,COAH.,"RAMOS ARIZPE, COAH.",1,0,1,0,0,12,
24-abr-14,CHIS.,"SUCHIATE, CHIS.",1,0,1,0,0,0,
25-abr-14,OAX.,"SANTIAGO LAOLLAGA, OAX.",1,0,1,0,0,23,
25-abr-14,OAX.,"EL ESPINAL, OAX.",0,1,1,3,0,0,
25-abr-14,OAX.,"PINOTEPA DE DON LUIS, OAX.",1,0,1,0,0,0,
25-abr-14,SON.,"HERMOSILLO, SON.",1,0,1,38,0,0,
25-abr-14,N.L.,"GRAL. ESCOBEDO, N.L.",0,1,1,17,0,150,
25-abr-14,ZAC.,"MONTE ESCOBEDO, ZAC.",0,1,1,0,0,0,
26-abr-14,CHIS.,"REFORMA, CHIS.",1,0,1,1,0,25,
26-abr-14,B.C.S.,"COMONDÚ, B.C.S.",1,0,1,0,0,0,
26-abr-14,B.C.,"TECATE, B.C.",0,1,1,0,0,0,
26-abr-14,N.L.,"APODACA, N.L.",1,0,1,4,0,0,
27-abr-14,N.L.,"GRAL. ESCOBEDO, N.L.",1,0,1,2,0,200,
27-abr-14,N.L.,"APODACA, N.L.",1,0,1,4,0,100,
28-abr-14,OAX.,"LOMA BONITA, OAX.",0,1,1,0,0,0,
28-abr-14,MEX.,"VALLE DE BRAVO, MEX.",0,1,1,0,0,0,
28-abr-14,SON.,"CAJEME, SON.",1,0,1,0,0,0,
28-abr-14,OAX.,"CIUDAD IXTEPEC, OAX.",1,0,1,1,0,0,
28-abr-14,SIN.,"GUASAVE, SIN.",1,0,1,0,0,0,
29-abr-14,SON.,"CAJEME, SON.",1,0,1,0,0,0,
29-abr-14,OAX.,"PINOTEPA DE DON LUIS, OAX.",0,1,1,0,0,0,
29-abr-14,OAX.,"SANTA MARIA HUATULCO, OAX.",0,1,1,0,0,0,
29-abr-14,SIN.,"ANGOSTURA, SIN.",0,1,1,0,0,0,
30-abr-14,ZAC.,"MONTE ESCOBEDO, ZAC.",0,1,1,0,0,0,
30-abr-14,OAX.,"SAN PEDRO MIXTEPEC, OAX.",0,1,1,0,0,0,
30-abr-14,OAX.,"SANTA MARIA HUATULCO, OAX.",0,1,1,0,0,0,
01-may-14,OAX.,"HEROICA CIUDAD DE HUAJUAPAN DE LEON, OAX.",1,0,1,1,0,128,
01-may-14,OAX.,"SANTA MARIA HUATULCO, OAX.",0,1,1,0,0,0,
01-may-14,B.C.,"TIJUANA, B.C.",0,1,1,0,0,0,
01-may-14,ZAC.,"SAIN ALTO, ZAC.",1,0,1,0,0,0,
02-may-14,COAH.,"ACUÑA, COAH.",0,1,1,0,0,0,
02-may-14,OAX.,"OAX. DE JUAREZ, OAX.",0,1,1,1,0,24,
02-may-14,OAX.,"SANTA CRUZ XOXOCOTLAN, OAX.",1,0,1,0,0,0,
02-may-14,NAY.,"SAN BLAS, NAY.",1,0,1,1,0,0,
02-may-14,N.L.,"SAN PEDRO GARZA GARCIA, N.L.",0,1,1,55,0,3200,
02-may-14,OAX.,"HEROICA CIUDAD DE EJUTLA DE CRESPO, OAX.",1,0,1,0,0,0,
02-may-14,TAMPS.,"MIQUIHUANA, TAMPS.",0,1,1,0,0,0,
03-may-14,OAX.,"PINOTEPA DE DON LUIS, OAX.",1,0,1,0,0,0,
03-may-14,SON.,"GUAYMAS, SON.",0,1,1,2,0,0,
03-may-14,MEX.,"VALLE DE BRAVO, MEX.",1,0,1,0,0,0,
04-may-14,N.L.,"SAN PEDRO GARZA GARCIA, N.L.",0,1,1,35,0,2400,
04-may-14,N.L.,"CADEREYTA JIMENEZ, N.L.",1,0,1,4,0,67,
05-may-14,N.L.,"SAN PEDRO GARZA GARCIA, N.L.",1,0,1,14,0,4650,
05-may-14,N.L.,"CADEREYTA JIMENEZ, N.L.",1,0,1,0,0,0,
05-may-14,B.C.,"ENSENADA, B.C.",0,1,1,0,0,0,
05-may-14,SIN.,"ANGOSTURA, SIN.",0,1,1,0,0,0,
06-may-14,SIN.,"ANGOSTURA, SIN.",0,1,1,0,0,0,
06-may-14,S.L.P.,"CIUDAD VALLES, S.L.P.",0,1,1,0,1,0,
06-may-14,SON.,"CAJEME, SON.",1,0,1,1,0,0,
06-may-14,JAL.,"GUADALAJARA, JAL.",0,1,1,0,0,0,
06-may-14,OAX.,"SANTIAGO JUXTLAHUACA, OAX.",0,1,1,0,0,0,
06-may-14,OAX.,"HEROICA CIUDAD DE HUAJUAPAN DE LEON, OAX.",1,0,1,0,0,0,
07-may-14,CHIH.,"HGO. DEL PARRAL, CHIH.",1,0,1,0,0,0,
07-may-14,N.L.,"SAN PEDRO GARZA GARCIA, N.L.",1,0,1,12,0,3460,
07-may-14,JAL.,"GUADALAJARA, JAL.",1,0,1,0,0,0,
07-may-14,B.C.,"ENSENADA, B.C.",0,1,1,0,0,0,
07-may-14,NAY.,"SAN BLAS, NAY.",1,0,1,0,0,0,
07-may-14,SON.,"CAJEME, SON.",0,1,1,0,0,0,
07-may-14,ZAC.,"FRESNILLO, ZAC.",1,0,1,0,0,0,
08-may-14,B.C.,"ENSENADA, B.C.",1,0,1,0,0,0,
08-may-14,SIN.,"ANGOSTURA, SIN.",0,1,1,0,0,0,
08-may-14,NAY.,"SAN BLAS, NAY.",1,0,1,0,0,0,
08-may-14,TAB.,"PARAISO, TAB.",0,1,1,1,0,0,
08-may-14,ZAC.,"FRESNILLO, ZAC.",1,0,1,0,0,0,
08-may-14,JAL.,"GUADALAJARA, JAL.",1,0,1,0,0,0,
08-may-14,CHIH.,"HGO. DEL PARRAL, CHIH.",1,0,1,0,0,0,
09-may-14,OAX.,"SAN ANDRES HUAXPALTEPEC, OAX.",1,0,1,0,0,0,
09-may-14,OAX.,"SAN PEDRO POCHUTLA, OAX.",1,0,1,0,0,0,
09-may-14,MEX.,"TENANCINGO, MEX.",0,1,1,0,2,0,
09-may-14,JAL.,"GUADALAJARA, JAL.",0,1,1,0,0,0,
09-may-14,N.L.,"CADEREYTA JIMENEZ, N.L.",1,0,1,0,0,0,
09-may-14,TAMPS.,"MATAMOROS, TAMPS.",0,1,1,4,0,115,
09-may-14,COAH.,"RAMOS ARIZPE, COAH.",1,0,1,0,0,0,
09-may-14,SIN.,"ANGOSTURA, SIN.",0,1,1,0,0,0,
10-may-14,VER.,"COATZINTLA, VER.",1,0,1,0,0,0,
10-may-14,B.C.,"TIJUANA, B.C.",0,1,1,0,0,0,
11-may-14,OAX.,"CIUDAD IXTEPEC, OAX.",0,1,1,0,0,0,
12-may-14,OAX.,"CIUDAD IXTEPEC, OAX.",0,1,1,0,0,0,
12-may-14,TAB.,"JALPA DE MENDEZ, TAB.",1,0,1,0,0,0,
12-may-14,COAH.,"ACUÑA, COAH.",1,0,1,0,0,0,
12-may-14,CHIH.,"HGO. DEL PARRAL, CHIH.",1,0,1,1,0,0,
12-may-14,OAX.,"OAX. DE JUAREZ, OAX.",1,0,1,0,0,0,
12-may-14,SON.,"HERMOSILLO, SON.",0,1,1,9,0,0,
12-may-14,TAMPS.,"GONZALEZ, TAMPS.",1,0,1,0,0,261,
13-may-14,S.L.P.,"CIUDAD VALLES, S.L.P.",0,1,1,1,0,15,
13-may-14,N.L.,"SAN PEDRO GARZA GARCIA, N.L.",0,1,1,2,0,190,
14-may-14,SIN.,"MOCORITO, SIN.",1,0,1,0,1,0,
14-may-14,MEX.,"TENANGO DEL VALLE, MEX.",1,0,1,0,0,0,
14-may-14,CHIS.,"SAN CRISTOBAL DE LAS CASAS, CHIS.",1,0,1,0,0,0,
14-may-14,B.C.,"TIJUANA, B.C.",1,0,1,0,0,0,
14-may-14,B.C.,"TECATE, B.C.",0,1,1,0,0,0,
14-may-14,ZAC.,"LORETO, ZAC.",1,0,1,0,0,96,
15-may-14,COAH.,"ACUÑA, COAH.",1,0,1,0,0,0,
15-may-14,COAH.,"ARTEAGA, COAH.",1,0,1,7,0,0,
15-may-14,COAH.,"FRONTERA, COAH.",1,0,1,0,0,0,
16-may-14,VER.,"TUXPAM, VER.",1,0,1,1,0,0,
16-may-14,ZAC.,"LORETO, ZAC.",1,0,1,0,0,20,
19-may-14,Q. ROO,"COZUMEL, Q. ROO",1,0,1,0,0,0,
19-may-14,B.C.,"MEXICALI, B.C.",1,0,1,0,0,0,
20-may-14,CAMP.,"CALAKMUL, CAMP.",0,1,1,0,0,0,
20-may-14,SIN.,"MOCORITO, SIN.",0,1,1,0,0,0,
20-may-14,VER.,"MISANTLA, VER.",1,0,1,0,0,0,
20-may-14,JAL.,"TLAQUEPAQUE, JAL.",0,1,1,0,0,0,
21-may-14,ZAC.,"LORETO, ZAC.",1,0,1,0,0,0,
21-may-14,Q. ROO,"COZUMEL, Q. ROO",0,1,1,0,0,385,
21-may-14,N.L.,"GARCIA, N.L.",0,1,1,31,0,3287,
21-may-14,CHIH.,"MADERA, CHIH.",1,0,1,0,0,0,
21-may-14,VER.,"MISANTLA, VER.",1,0,1,0,0,0,
22-may-14,HGO.,"PACHUCA DE SOTO, HGO.",1,0,1,0,0,30,
22-may-14,NAY.,"ACAPONETA, NAY.",1,0,1,0,0,0,
22-may-14,SIN.,"MOCORITO, SIN.",0,1,1,0,0,0,
22-may-14,JAL.,"TLAQUEPAQUE, JAL.",1,0,1,0,0,0,
22-may-14,TAB.,"TENOSIQUE, TAB.",1,0,1,0,0,0,
22-may-14,B.C.,"TIJUANA, B.C.",1,0,1,0,0,0,
22-may-14,B.C.,"ENSENADA, B.C.",0,1,1,0,0,0,
23-may-14,CHIH.,"GUADALUPE, CHIH.",0,1,1,0,0,0,
23-may-14,VER.,"MISANTLA, VER.",1,0,1,0,0,0,
23-may-14,SON.,"HERMOSILLO, SON.",1,0,1,0,0,950,
23-may-14,B.C.,"TIJUANA, B.C.",1,0,1,0,0,0,
25-may-14,B.C.,"TIJUANA, B.C.",0,1,1,0,0,0,
25-may-14,B.C.,"ENSENADA, B.C.",1,0,1,0,0,0,
26-may-14,ZAC.,"VALPARAISO, ZAC.",1,0,1,1,0,0,
26-may-14,N.L.,"JUAREZ, N.L.",0,1,1,0,0,219,
27-may-14,S.L.P.,"CIUDAD VALLES, S.L.P.",1,0,1,1,1,8,
27-may-14,HGO.,"PACHUCA DE SOTO, HGO.",0,1,1,0,0,39,
27-may-14,QRO.,"TEQUISQUIAPAN, QRO.",1,0,1,0,0,0,
28-may-14,JAL.,"TLAQUEPAQUE, JAL.",1,0,1,0,0,5,
28-may-14,SON.,"CAJEME, SON.",1,0,1,10,0,0,
28-may-14,N.L.,"JUAREZ, N.L.",1,0,1,4,0,125,
28-may-14,CHIH.,"GUADALUPE, CHIH.",1,0,1,0,0,0,
30-may-14,N.L.,"JUAREZ, N.L.",0,1,1,1,0,100,
30-may-14,S.L.P.,"CIUDAD VALLES, S.L.P.",0,1,1,1,0,0,
30-may-14,PUE.,"COXCATLAN, PUE.",1,0,1,0,0,0,
30-may-14,B.C.,"TIJUANA, B.C.",0,1,1,0,0,0,
30-may-14,COL.,"COL., COL.",0,1,1,0,0,0,
31-may-14,N.L.,"JUAREZ, N.L.",0,1,1,2,0,42,
31-may-14,SON.,"CAJEME, SON.",1,0,1,0,0,14,
31-may-14,B.C.,"TIJUANA, B.C.",1,0,1,0,0,0,
02-jun-14,B.C.,"TIJUANA, B.C.",1,0,1,0,0,0,
02-jun-14,N.L.,"SANTIAGO, N.L.",0,1,1,40,0,1866,
02-jun-14,ZAC.,"VILLANUEVA, ZAC.",1,0,1,1,0,9,
02-jun-14,ZAC.,"VALPARAISO, ZAC.",1,0,1,1,0,0,
03-jun-14,QRO.,"EZEQUIEL MONTES, QRO.",0,1,1,0,1,0,
03-jun-14,COL.,"COL., COL.",0,1,1,0,0,0,
04-jun-14,OAX.,"OAX. DE JUAREZ, OAX.",0,1,1,0,0,0,
05-jun-14,MEX.,"SULTEPEC, MEX.",0,1,1,0,0,0,
05-jun-14,JAL.,"ZAPOPAN, JAL.",1,0,1,0,0,10,
05-jun-14,YUC.,"CHANKOM, YUC.",0,1,1,0,0,0,
05-jun-14,SON.,"CAJEME, SON.",1,0,1,0,0,0,
05-jun-14,OAX.,"CIUDAD IXTEPEC, OAX.",0,1,1,10,0,0,
06-jun-14,N.L.,"SANTIAGO, N.L.",0,1,1,0,0,0,
06-jun-14,COL.,"COL., COL.",1,0,1,0,0,0,
06-jun-14,SIN.,"BADIRAGUATO, SIN.",1,0,1,0,0,0,
06-jun-14,ZAC.,"VALPARAISO, ZAC.",1,0,1,1,0,0,
06-jun-14,JAL.,"ZAPOPAN, JAL.",0,1,1,0,0,0,
07-jun-14,MEX.,"SULTEPEC, MEX.",1,0,1,0,0,0,
08-jun-14,B.C.,"ENSENADA, B.C.",0,1,1,0,0,0,
09-jun-14,HGO.,"TIZAYUCA, HGO.",1,0,1,0,1,0,
09-jun-14,JAL.,"ZAPOPAN, JAL.",1,0,1,0,0,0,
09-jun-14,COAH.,"MÚZQUIZ, COAH.",1,0,1,0,0,0,
09-jun-14,MEX.,"IXTAPAN DE LA SAL, MEX.",0,1,1,0,0,0,
10-jun-14,OAX.,"OAX. DE JUAREZ, OAX.",1,0,1,1,0,0,
10-jun-14,YUC.,"CHIKINDZONOT, YUC.",0,1,1,0,0,0,
10-jun-14,YUC.,"ACANCEH, YUC.",0,1,1,0,0,0,
10-jun-14,ZAC.,"VILLANUEVA, ZAC.",1,0,1,1,0,10,
10-jun-14,S.L.P.,"SAN LUIS POTOSI, S.L.P.",1,0,1,0,0,27,
10-jun-14,CHIH.,"CHIH., CHIH.",1,0,1,0,0,58,
10-jun-14,SON.,"HERMOSILLO, SON.",0,1,1,0,0,15,
10-jun-14,B.C.,"TECATE, B.C.",0,1,1,0,0,0,
10-jun-14,COAH.,"MONCLOVA, COAH.",1,0,1,0,0,0,
11-jun-14,COL.,"TECOMÁN, COL.",0,1,1,0,0,0,
11-jun-14,HGO.,"TIZAYUCA, HGO.",0,1,1,0,0,0,
11-jun-14,OAX.,"OAX. DE JUAREZ, OAX.",0,1,1,0,0,0,
11-jun-14,SIN.,"CHOIX, SIN.",1,0,1,0,0,0,
11-jun-14,JAL.,"ZAPOPAN, JAL.",1,0,1,0,0,0,
12-jun-14,HGO.,"TIZAYUCA, HGO.",1,0,1,0,0,0,
12-jun-14,CHIH.,"CHIH., CHIH.",1,0,1,0,0,150,
12-jun-14,COL.,"COL., COL.",1,0,1,0,0,101,
12-jun-14,ZAC.,"VILLANUEVA, ZAC.",1,0,1,0,0,0,
12-jun-14,N.L.,"BUSTAMANTE, N.L.",0,1,1,1,0,0,
13-jun-14,JAL.,"ZAPOPAN, JAL.",1,0,1,0,0,0,
13-jun-14,COL.,"COL., COL.",1,0,1,0,0,0,
13-jun-14,ZAC.,"VILLANUEVA, ZAC.",0,1,1,0,0,0,
13-jun-14,MEX.,"IXTAPAN DE LA SAL, MEX.",1,0,1,0,0,0,
13-jun-14,MEX.,"ALMOLOYA DE ALQUISIRAS, MEX.",1,0,1,0,0,0,
14-jun-14,OAX.,"OAX. DE JUAREZ, OAX.",1,0,1,1,0,34,
14-jun-14,MEX.,"IXTAPAN DE LA SAL, MEX.",1,0,1,0,0,0,
16-jun-14,OAX.,"OAX. DE JUAREZ, OAX.",0,1,1,0,0,0,
16-jun-14,COL.,"COL., COL.",1,0,1,0,0,0,
16-jun-14,COL.,"COL., COL.",0,1,1,0,0,0,
16-jun-14,CHIH.,"CHIH., CHIH.",0,1,1,0,0,30,
16-jun-14,COAH.,"SALTILLO, COAH.",1,0,1,0,0,0,
16-jun-14,COAH.,"TORREÓN, COAH.",1,0,1,0,0,0,
16-jun-14,MEX.,"TULTITLAN, MEX.",1,0,1,0,0,0,
17-jun-14,CHIH.,"CHIH., CHIH.",1,0,1,1,0,205,
17-jun-14,YUC.,"TIMUCUY, YUC.",1,0,1,0,0,0,
17-jun-14,COL.,"TECOMÁN, COL.",0,1,1,0,0,0,
17-jun-14,MEX.,"IXTAPALUCA, MEX.",1,0,1,0,0,0,
18-jun-14,COL.,"COL., COL.",1,0,1,0,0,0,
18-jun-14,NAY.,"LA YESCA, NAY.",0,1,1,0,0,0,
18-jun-14,B.C.,"TIJUANA, B.C.",1,0,1,0,0,0,
18-jun-14,B.C.,"TECATE, B.C.",0,1,1,0,0,0,
19-jun-14,HGO.,"TULANCINGO DE BRAVO, HGO.",1,0,1,0,0,0,
19-jun-14,COAH.,"SALTILLO, COAH.",0,1,1,2,0,40,
19-jun-14,COAH.,"FRONTERA, COAH.",1,0,1,0,0,0,
20-jun-14,B.C.S.,"LA PAZ, B.C.S.",0,1,1,0,0,0,
20-jun-14,B.C.S.,"COMONDÚ, B.C.S.",1,0,1,0,0,0,
20-jun-14,JAL.,"ZAPOPAN, JAL.",0,1,1,0,0,0,
20-jun-14,COAH.,"SALTILLO, COAH.",1,0,1,1,0,19,
21-jun-14,B.C.S.,"LA PAZ, B.C.S.",1,0,1,0,0,0,
21-jun-14,SON.,"ALTAR, SON.",1,0,1,0,0,0,
21-jun-14,B.C.,"ENSENADA, B.C.",0,1,1,0,0,0,
23-jun-14,B.C.S.,"LA PAZ, B.C.S.",1,0,1,0,0,0,
23-jun-14,N.L.,"SALINAS VICTORIA, N.L.",1,0,1,10,0,3135,
23-jun-14,B.C.,"TIJUANA, B.C.",0,1,1,0,0,0,
23-jun-14,NAY.,"LA YESCA, NAY.",1,0,1,0,0,0,
24-jun-14,B.C.,"ENSENADA, B.C.",0,1,1,0,0,0,
24-jun-14,N.L.,"SALINAS VICTORIA, N.L.",0,1,1,12,0,100,
24-jun-14,ZAC.,"VILLANUEVA, ZAC.",0,1,1,0,0,0,
24-jun-14,COL.,"COL., COL.",1,0,1,0,0,0,
24-jun-14,YUC.,"TECOH, YUC.",1,0,1,0,0,0,
24-jun-14,YUC.,"SOTUTA, YUC.",0,1,1,0,0,0,
25-jun-14,SIN.,"SAN IGNACIO, SIN.",0,1,1,0,0,0,
25-jun-14,COAH.,"PIEDRAS NEGRAS, COAH.",0,1,1,0,0,0,
25-jun-14,COAH.,"TORREÓN, COAH.",1,0,1,0,0,0,
26-jun-14,N.L.,"SALINAS VICTORIA, N.L.",0,1,1,0,0,0,
26-jun-14,SIN.,"SAN IGNACIO, SIN.",1,0,1,0,0,0,
26-jun-14,COL.,"COL., COL.",1,0,1,0,0,0,
26-jun-14,NAY.,"ACAPONETA, NAY.",1,0,1,0,0,0,
26-jun-14,COAH.,"TORREÓN, COAH.",1,0,1,0,0,0,
26-jun-14,COL.,"COL., COL.",1,0,1,0,0,0,
26-jun-14,COL.,"TECOMÁN, COL.",1,0,1,0,0,0,
27-jun-14,COAH.,"TORREÓN, COAH.",1,0,1,0,0,0,
27-jun-14,COAH.,"MONCLOVA, COAH.",1,0,1,0,0,0,
27-jun-14,SIN.,"SAN IGNACIO, SIN.",0,1,1,0,1,0,
27-jun-14,SON.,"HERMOSILLO, SON.",1,0,1,7,0,0,
30-jun-14,COL.,"TECOMÁN, COL.",1,0,1,5,0,0,
01-jul-14,SIN.,"NAVOLATO, SIN.",1,0,1,0,0,0,
01-jul-14,N.L.,"HUALAHUISES, N.L.",0,1,1,0,0,0,
02-jul-14,PUE.,"PUE., PUE.",1,0,1,0,0,0,
03-jul-14,SIN.,"SAN IGNACIO, SIN.",0,1,1,0,0,0,
03-jul-14,NAY.,"LA YESCA, NAY.",0,1,1,0,0,0,
03-jul-14,B.C.S.,"MULEGÉ, B.C.S.",0,1,1,0,0,0,
04-jul-14,Q. ROO,"OTHON P. BLANCO, Q. ROO",1,0,1,1,0,0,
04-jul-14,B.C.,"TIJUANA, B.C.",0,1,1,0,0,0,
04-jul-14,B.C.,"ENSENADA, B.C.",1,0,1,0,0,0,
05-jul-14,HGO.,"NOPALA DE VILLAGRAN, HGO.",1,0,1,0,0,0,
05-jul-14,N.L.,"CARMEN, N.L.",1,0,1,17,0,3680,
05-jul-14,SON.,"CAJEME, SON.",0,1,1,1,0,0,
06-jul-14,N.L.,"HUALAHUISES, N.L.",1,0,1,0,0,0,
06-jul-14,B.C.S.,"MULEGÉ, B.C.S.",0,1,1,0,0,0,
07-jul-14,Q. ROO,"OTHON P. BLANCO, Q. ROO",1,0,1,0,0,0,
07-jul-14,B.C.,"TIJUANA, B.C.",1,0,1,0,0,0,
08-jul-14,JAL.,"TLAQUEPAQUE, JAL.",1,0,1,1,0,5,
08-jul-14,YUC.,"TIXKOKOB, YUC.",1,0,1,0,0,0,
08-jul-14,COAH.,"MONCLOVA, COAH.",1,0,1,0,0,0,
08-jul-14,COAH.,"TORREÓN, COAH.",1,0,1,0,0,0,
08-jul-14,PUE.,"PUE., PUE.",1,0,1,1,0,0,
08-jul-14,N.L.,"HUALAHUISES, N.L.",0,1,1,14,0,0,
08-jul-14,ZAC.,"FRESNILLO, ZAC.",0,1,1,0,0,0,
08-jul-14,B.C.,"TIJUANA, B.C.",1,0,1,0,0,0,
09-jul-14,COAH.,"SALTILLO, COAH.",1,0,1,1,0,0,
09-jul-14,ZAC.,"VILLANUEVA, ZAC.",1,0,1,0,0,200,
09-jul-14,ZAC.,"VALPARAISO, ZAC.",0,1,1,0,0,0,
10-jul-14,COAH.,"SALTILLO, COAH.",1,0,1,0,0,0,
10-jul-14,COAH.,"MONCLOVA, COAH.",1,0,1,0,0,0,
10-jul-14,N.L.,"HUALAHUISES, N.L.",1,0,1,1,0,88,
10-jul-14,PUE.,"PUE., PUE.",1,0,1,0,0,110,
10-jul-14,B.C.,"TIJUANA, B.C.",0,1,1,0,0,0,
10-jul-14,CHIH.,"CHIH., CHIH.",1,0,1,0,0,0,
11-jul-14,COL.,"COL., COL.",0,1,1,0,0,0,
11-jul-14,COAH.,"TORREÓN, COAH.",1,0,1,0,0,0,
11-jul-14,ZAC.,"VALPARAISO, ZAC.",0,1,1,0,0,0,
13-jul-14,N.L.,"LOS HERRERAS, N.L.",0,1,1,0,0,0,
14-jul-14,COAH.,"PIEDRAS NEGRAS, COAH.",1,0,1,0,0,0,
14-jul-14,CHIH.,"MEOQUI, CHIH.",1,0,1,0,0,0,
15-jul-14,N.L.,"ANAHUAC, N.L.",0,1,1,0,0,0,
15-jul-14,B.C.,"TECATE, B.C.",0,1,1,0,0,0,
15-jul-14,CHIH.,"MEOQUI, CHIH.",0,1,1,0,0,0,
15-jul-14,ZAC.,"FRESNILLO, ZAC.",0,1,1,0,0,0,
16-jul-14,SON.,"CAJEME, SON.",1,0,1,0,0,0,
17-jul-14,COAH.,"MONCLOVA, COAH.",1,0,1,0,0,0,
17-jul-14,ZAC.,"FRESNILLO, ZAC.",0,1,1,0,0,0,
17-jul-14,JAL.,"TLAQUEPAQUE, JAL.",0,1,1,0,0,0,
18-jul-14,N.L.,"LOS HERRERAS, N.L.",0,1,1,0,0,150,
18-jul-14,COAH.,"PIEDRAS NEGRAS, COAH.",0,1,1,0,0,0,
19-jul-14,B.C.S.,"LA PAZ, B.C.S.",0,1,1,0,0,0,
20-jul-14,N.L.,"ANAHUAC, N.L.",0,1,1,0,0,100,
21-jul-14,SON.,"CAJEME, SON.",0,1,1,0,0,0,
22-jul-14,JAL.,"GUADALAJARA, JAL.",1,0,1,0,0,0,
23-jul-14,CHIH.,"MEOQUI, CHIH.",1,0,1,0,0,0,
23-jul-14,N.L.,"ABASOLO, N.L.",0,1,1,5,0,2294,
23-jul-14,N.L.,"MINA, N.L.",0,1,1,0,0,0,
24-jul-14,N.L.,"ABASOLO, N.L.",1,0,1,0,0,1450,
25-jul-14,COAH.,"TORREÓN, COAH.",1,0,1,0,0,0,
25-jul-14,COAH.,"MONCLOVA, COAH.",1,0,1,0,0,0,
25-jul-14,JAL.,"ZAPOPAN, JAL.",1,0,1,0,0,0,
25-jul-14,N.L.,"ABASOLO, N.L.",1,0,1,3,0,2397,
25-jul-14,CHIH.,"CHIH., CHIH.",1,0,1,1,0,1,
26-jul-14,TAMPS.,"MATAMOROS, TAMPS.",1,0,1,0,0,0,
28-jul-14,CHIS.,"CINTALAPA, CHIS.",0,1,1,0,0,30,
29-jul-14,CAMP.,"CAMP., CAMP.",0,1,1,0,0,0,
29-jul-14,COL.,"COL., COL.",1,0,1,0,0,0,
30-jul-14,B.C.S.,"MULEGÉ, B.C.S.",0,1,1,0,0,0,
31-jul-14,B.C.S.,"MULEGÉ, B.C.S.",0,1,1,0,0,0,
31-jul-14,ZAC.,"VILLANUEVA, ZAC.",0,1,1,0,0,18,
31-jul-14,JAL.,"GUADALAJARA, JAL.",1,0,1,0,0,4,
31-jul-14,PUE.,"TETELA DE OCAMPO, PUE.",1,0,1,0,0,0,
31-jul-14,N.L.,"CERRALVO, N.L.",0,1,1,32,0,1725,
31-jul-14,COAH.,"SALTILLO, COAH.",1,0,1,0,0,0,
01-ago-14,B.C.,"MEXICALI, B.C.",1,0,1,0,0,0,
01-ago-14,N.L.,"CERRALVO, N.L.",1,0,1,34,0,2882,
01-ago-14,N.L.,"DR. ARROYO, N.L.",1,0,1,2,0,0,
01-ago-14,VER.,"COATZACOALCOS, VER.",1,0,1,0,0,0,
03-ago-14,N.L.,"DR. ARROYO, N.L.",1,0,1,1,0,0,
05-ago-14,CHIS.,"CINTALAPA, CHIS.",1,0,1,0,0,0,
05-ago-14,SON.,"HERMOSILLO, SON.",1,0,1,2,0,80,
05-ago-14,COAH.,"PIEDRAS NEGRAS, COAH.",1,0,1,0,0,0,
06-ago-14,COAH.,"SALTILLO, COAH.",1,0,1,1,0,20,
06-ago-14,COAH.,"MONCLOVA, COAH.",1,0,1,0,0,0,
06-ago-14,B.C.,"MEXICALI, B.C.",1,0,1,0,0,0,
06-ago-14,N.L.,"DR. ARROYO, N.L.",1,0,1,0,0,0,
07-ago-14,COAH.,"SALTILLO, COAH.",1,0,1,0,0,185,
07-ago-14,COAH.,"PIEDRAS NEGRAS, COAH.",0,1,1,0,0,0,
07-ago-14,B.C.,"ENSENADA, B.C.",0,1,1,0,0,0,
08-ago-14,COAH.,"TORREÓN, COAH.",0,1,1,0,0,0,
08-ago-14,N.L.,"DR. ARROYO, N.L.",1,0,1,0,0,0,
08-ago-14,SON.,"HERMOSILLO, SON.",1,0,1,1,0,0,
09-ago-14,PUE.,"ATLIXCO, PUE.",1,0,1,0,0,2,
09-ago-14,CHIH.,"JUÁREZ, CHIH.",1,0,1,0,0,0,
11-ago-14,SON.,"CAJEME, SON.",0,1,1,0,0,0,
11-ago-14,COAH.,"ACUÑA, COAH.",0,1,1,0,0,0,
12-ago-14,N.L.,"MONTERREY, N.L.",1,0,1,18,0,47,
12-ago-14,COAH.,"PIEDRAS NEGRAS, COAH.",1,0,1,0,0,0,
12-ago-14,B.C.,"ENSENADA, B.C.",1,0,1,0,0,0,
12-ago-14,B.C.,"TIJUANA, B.C.",1,0,1,0,0,0,
13-ago-14,ZAC.,"SOMBRERETE, ZAC.",1,0,1,0,0,0,
14-ago-14,B.C.,"PLAYAS DE ROSARITO, B.C.",1,0,1,0,0,0,
14-ago-14,CHIH.,"JUÁREZ, CHIH.",1,0,1,0,0,0,
15-ago-14,ZAC.,"VALPARAISO, ZAC.",1,0,1,0,0,0,
15-ago-14,COAH.,"SALTILLO, COAH.",1,0,1,0,0,465,
15-ago-14,TAMPS.,"MATAMOROS, TAMPS.",1,0,1,75,0,0,
15-ago-14,N.L.,"SAN NICOLAS DE LOS GARZA, N.L.",1,0,1,8,0,0,
16-ago-14,N.L.,"SAN NICOLAS DE LOS GARZA, N.L.",1,0,1,0,0,0,
16-ago-14,ZAC.,"VALPARAISO, ZAC.",1,0,1,0,0,0,
16-ago-14,ZAC.,"SOMBRERETE, ZAC.",1,0,1,0,0,10,
16-ago-14,B.C.,"ENSENADA, B.C.",1,0,1,0,0,0,
16-ago-14,B.C.,"TIJUANA, B.C.",1,0,1,0,0,0,
18-ago-14,CHIH.,"JUÁREZ, CHIH.",1,0,1,0,0,0,
18-ago-14,COAH.,"PIEDRAS NEGRAS, COAH.",1,0,1,0,0,0,
18-ago-14,ZAC.,"FRESNILLO, ZAC.",1,0,1,0,0,0,
19-ago-14,B.C.,"ENSENADA, B.C.",1,0,1,0,0,0,
19-ago-14,COAH.,"SALTILLO, COAH.",1,0,1,5,0,43,
19-ago-14,SIN.,"COSALA, SIN.",0,1,1,0,4,0,
19-ago-14,N.L.,"SAN NICOLAS DE LOS GARZA, N.L.",1,0,1,1,0,0,
19-ago-14,JAL.,"TLAQUEPAQUE, JAL.",1,0,1,0,0,0,
20-ago-14,N.L.,"SAN NICOLAS DE LOS GARZA, N.L.",1,0,1,0,0,309,
20-ago-14,S.L.P.,"CIUDAD VALLES, S.L.P.",1,0,1,0,0,0,
20-ago-14,NAY.,"IXTLAN DEL RIO, NAY.",0,1,1,0,0,0,
20-ago-14,JAL.,"TLAQUEPAQUE, JAL.",0,1,1,0,0,0,
20-ago-14,PUE.,"ATLIXCO, PUE.",1,0,1,0,5,202,
20-ago-14,PUE.,"PUE., PUE.",1,0,1,2,0,47,
21-ago-14,COAH.,"FRONTERA, COAH.",0,1,1,0,0,0,
21-ago-14,B.C.,"TIJUANA, B.C.",0,1,1,0,0,0,
21-ago-14,ZAC.,"FRESNILLO, ZAC.",1,0,1,0,0,0,
22-ago-14,N.L.,"GUADALUPE, N.L.",1,0,1,7,0,50,
22-ago-14,CHIH.,"JUÁREZ, CHIH.",1,0,1,0,0,0,
22-ago-14,TAB.,"TENOSIQUE, TAB.",0,1,1,0,0,0,
22-ago-14,B.C.,"ENSENADA, B.C.",1,0,1,0,0,0,
24-ago-14,N.L.,"SANTA CATARINA, N.L.",1,0,1,7,0,0,
25-ago-14,VER.,"MARTINEZ DE LA TORRE, VER.",1,0,1,0,0,0,
26-ago-14,SIN.,"COSALA, SIN.",0,1,1,0,0,0,
26-ago-14,B.C.,"ENSENADA, B.C.",1,0,1,0,0,0,
26-ago-14,B.C.,"MEXICALI, B.C.",0,1,1,0,0,0,
26-ago-14,VER.,"MARTINEZ DE LA TORRE, VER.",0,1,1,0,0,0,
27-ago-14,COAH.,"SALTILLO, COAH.",1,0,1,0,0,0,
27-ago-14,COAH.,"PIEDRAS NEGRAS, COAH.",0,1,1,0,0,0,
27-ago-14,TAB.,"TENOSIQUE, TAB.",1,0,1,0,0,0,
27-ago-14,PUE.,"PUE., PUE.",1,0,1,1,0,0,
27-ago-14,N.L.,"SANTA CATARINA, N.L.",1,0,1,16,0,237,
27-ago-14,B.C.,"ENSENADA, B.C.",0,1,1,0,0,0,
27-ago-14,SON.,"CAJEME, SON.",0,1,1,0,0,0,
27-ago-14,NAY.,"IXTLAN DEL RIO, NAY.",0,1,1,0,0,0,
27-ago-14,ZAC.,"TEPECHITLAN, ZAC.",1,0,1,0,0,0,
28-ago-14,COL.,"COL., COL.",1,0,1,0,0,0,
28-ago-14,B.C.,"ENSENADA, B.C.",0,1,1,0,0,0,
28-ago-14,B.C.,"MEXICALI, B.C.",1,0,1,0,0,0,
28-ago-14,MICH.,"LAZARO CARDENAS, MICH.",1,0,1,1,0,244,
29-ago-14,SIN.,"COSALA, SIN.",1,0,1,0,0,0,
29-ago-14,VER.,"MARTINEZ DE LA TORRE, VER.",1,0,1,0,0,0,
29-ago-14,COAH.,"MÚZQUIZ, COAH.",1,0,1,0,0,0,
29-ago-14,N.L.,"GUADALUPE, N.L.",1,0,1,141,0,400,
29-ago-14,MICH.,"TEPALCATEPEC, MICH.",1,0,1,1,0,0,
29-ago-14,PUE.,"ATLIXCO, PUE.",0,1,1,0,0,0,
30-ago-14,N.L.,"GUADALUPE, N.L.",1,0,1,1,0,850,
30-ago-14,B.C.,"ENSENADA, B.C.",0,1,1,0,0,0,
31-ago-14,N.L.,"GUADALUPE, N.L.",1,0,1,0,0,634,
31-ago-14,MICH.,"APATZINGAN, MICH.",1,0,1,0,0,276,
31-ago-14,B.C.,"TIJUANA, B.C.",0,1,1,0,0,0,
31-ago-14,B.C.,"ENSENADA, B.C.",1,0,1,0,0,0,
01-sep-14,SIN.,"COSALA, SIN.",1,0,1,0,0,0,
02-sep-14,COAH.,"SALTILLO, COAH.",0,1,1,0,0,411,
02-sep-14,SIN.,"COSALA, SIN.",1,0,1,0,0,0,
02-sep-14,COL.,"COL., COL.",1,0,1,0,1,0,
02-sep-14,VER.,"MARTINEZ DE LA TORRE, VER.",1,0,1,0,0,0,
02-sep-14,CHIH.,"HGO. DEL PARRAL, CHIH.",0,1,1,0,0,0,
02-sep-14,N.L.,"APODACA, N.L.",0,1,1,3,0,1150,
02-sep-14,PUE.,"ATLIXCO, PUE.",1,0,1,0,0,0,
03-sep-14,VER.,"MARTINEZ DE LA TORRE, VER.",1,0,1,0,0,0,
03-sep-14,COAH.,"TORREÓN, COAH.",0,1,1,0,0,0,
03-sep-14,SON.,"HERMOSILLO, SON.",1,0,1,38,0,142,
03-sep-14,SON.,"CAJEME, SON.",0,1,1,0,0,0,
03-sep-14,N.L.,"APODACA, N.L.",1,0,1,0,0,0,
03-sep-14,AGS.,"JESÚS MARÍA, AGS.",1,0,1,5,0,5,
04-sep-14,JAL.,"TLAQUEPAQUE, JAL.",1,0,1,0,0,0,
04-sep-14,MICH.,"ZITACUARO, MICH.",1,0,1,0,0,0,
04-sep-14,PUE.,"PUE., PUE.",1,0,1,0,0,61,
04-sep-14,PUE.,"AMOZOC, PUE.",1,0,1,0,0,0,
04-sep-14,N.L.,"APODACA, N.L.",1,0,1,16,0,0,
05-sep-14,ZAC.,"TEPECHITLAN, ZAC.",1,0,1,0,0,0,
05-sep-14,COL.,"TECOMÁN, COL.",1,0,1,0,0,0,
05-sep-14,TAB.,"TENOSIQUE, TAB.",1,0,1,0,0,0,
05-sep-14,TAMPS.,"VICTORIA, TAMPS.",1,0,1,4,0,160,
05-sep-14,PUE.,"AMOZOC, PUE.",1,0,1,0,0,71,
06-sep-14,PUE.,"PUE., PUE.",1,0,1,0,0,0,
06-sep-14,MICH.,"SAHUAYO, MICH.",1,0,1,0,0,0,
06-sep-14,B.C.,"ENSENADA, B.C.",1,0,1,0,0,0,
07-sep-14,N.L.,"APODACA, N.L.",1,0,1,0,0,0,
07-sep-14,SON.,"HERMOSILLO, SON.",1,0,1,1,0,0,
08-sep-14,MICH.,"BUENAVISTA, MICH.",1,0,1,0,0,0,
08-sep-14,CHIH.,"CHIH., CHIH.",0,1,1,0,0,0,
08-sep-14,CHIH.,"JUÁREZ, CHIH.",0,1,1,0,0,0,
08-sep-14,COAH.,"SALTILLO, COAH.",1,0,1,0,0,182,
09-sep-14,SON.,"HERMOSILLO, SON.",1,0,1,0,0,0,
09-sep-14,COAH.,"FRONTERA, COAH.",1,0,1,0,0,0,
10-sep-14,HGO.,"HUICHAPAN, HGO.",0,1,1,0,0,0,
10-sep-14,COL.,"COL., COL.",1,0,1,0,0,0,
10-sep-14,CHIH.,"CHIH., CHIH.",0,1,1,0,0,0,
11-sep-14,N.L.,"CADEREYTA JIMENEZ, N.L.",0,1,1,0,0,0,
11-sep-14,CHIH.,"JUÁREZ, CHIH.",1,0,1,0,0,0,
12-sep-14,TAMPS.,"VICTORIA, TAMPS.",1,0,1,9,0,308,
12-sep-14,SON.,"HERMOSILLO, SON.",1,0,1,6,0,626,
13-sep-14,SON.,"HERMOSILLO, SON.",1,0,1,0,0,295,
14-sep-14,N.L.,"GARCIA, N.L.",1,0,1,163,0,500,
15-sep-14,TAB.,"HUIMANGUILLO, TAB.",1,0,1,0,0,0,
16-sep-14,TAMPS.,"VICTORIA, TAMPS.",1,0,1,0,0,0,
17-sep-14,HGO.,"HUICHAPAN, HGO.",1,0,1,0,0,0,
17-sep-14,CHIH.,"CHIH., CHIH.",0,1,1,0,0,0,
19-sep-14,AGS.,"JESÚS MARÍA, AGS.",0,1,1,0,0,18,
19-sep-14,N.L.,"CADEREYTA JIMENEZ, N.L.",0,1,1,0,0,0,
20-sep-14,TAMPS.,"VICTORIA, TAMPS.",1,0,1,0,0,0,
20-sep-14,TAMPS.,"VICTORIA, TAMPS.",1,0,1,0,0,0,
20-sep-14,AGS.,"JESÚS MARÍA, AGS.",0,1,1,2,0,0,
21-sep-14,MICH.,"JIQUILPAN, MICH.",1,0,1,0,0,0,
21-sep-14,N.L.,"GARCIA, N.L.",1,0,1,65,0,0,
22-sep-14,AGS.,"SAN JOSÉ DE GRACIA, AGS.",0,1,1,0,0,0,
22-sep-14,VER.,"SAN RAFAEL, VER.",0,1,1,0,0,0,
22-sep-14,N.L.,"GARCIA, N.L.",1,0,1,0,0,0,
22-sep-14,TAB.,"CENTRO, TAB.",1,0,1,0,0,0,
23-sep-14,TAB.,"CENTRO, TAB.",1,0,1,0,0,0,
23-sep-14,TAMPS.,"VICTORIA, TAMPS.",0,1,1,0,0,16,
23-sep-14,AGS.,"SAN JOSÉ DE GRACIA, AGS.",0,1,1,0,0,2,
23-sep-14,N.L.,"GARCIA, N.L.",0,1,1,0,0,4550,
24-sep-14,S.L.P.,"SAN LUIS POTOSI, S.L.P.",1,0,1,0,0,0,
24-sep-14,PUE.,"PUE., PUE.",1,0,1,0,0,0,
25-sep-14,MICH.,"LA HUACANA, MICH.",0,1,1,1,0,0,
25-sep-14,MICH.,"ARTEAGA, MICH.",1,0,1,0,0,0,
25-sep-14,CHIH.,"JUÁREZ, CHIH.",0,1,1,0,0,0,
25-sep-14,PUE.,"ATLIXCO, PUE.",1,0,1,7,0,0,
26-sep-14,PUE.,"PUE., PUE.",1,0,1,0,0,0,
26-sep-14,JAL.,"TLAQUEPAQUE, JAL.",1,0,1,0,0,0,
26-sep-14,COL.,"TECOMÁN, COL.",1,0,1,0,0,0,
27-sep-14,JAL.,"TLAQUEPAQUE, JAL.",1,0,1,0,0,0,
29-sep-14,COL.,"COL., COL.",1,0,1,0,0,0,
29-sep-14,MICH.,"LA HUACANA, MICH.",0,1,1,1,0,0,
29-sep-14,AGS.,"AGS., AGS.",1,0,1,0,0,220,
30-sep-14,SIN.,"ELOTA, SIN.",0,1,1,1,0,0,
30-sep-14,MICH.,"ARTEAGA, MICH.",1,0,1,0,0,0,
30-sep-14,MICH.,"LAZARO CARDENAS, MICH.",1,0,1,0,0,0,
30-sep-14,B.C.,"TIJUANA, B.C.",0,1,1,0,0,0,
30-sep-14,COAH.,"SALTILLO, COAH.",1,0,1,0,0,0,
01-oct-14,YUC.,"UMAN, YUC.",1,0,1,0,0,0,
01-oct-14,PUE.,"PUE., PUE.",0,1,1,1,0,0,
01-oct-14,B.C.,"TIJUANA, B.C.",0,1,1,0,0,0,
01-oct-14,B.C.,"ENSENADA, B.C.",0,1,1,0,0,0,
01-oct-14,AGS.,"AGS., AGS.",1,0,1,0,0,0,
02-oct-14,S.L.P.,"SAN LUIS POTOSI, S.L.P.",1,0,1,0,0,0,
02-oct-14,MICH.,"ZINAPECUARO, MICH.",1,0,1,1,0,29,
02-oct-14,MICH.,"HUETAMO, MICH.",1,0,1,0,0,0,
02-oct-14,COL.,"TECOMÁN, COL.",1,0,1,0,0,0,
02-oct-14,B.C.S.,"MULEGÉ, B.C.S.",0,1,1,0,0,0,
03-oct-14,B.C.S.,"MULEGÉ, B.C.S.",0,1,1,0,0,0,
03-oct-14,N.L.,"SAN NICOLAS DE LOS GARZA, N.L.",1,0,1,0,0,0,
04-oct-14,N.L.,"SAN NICOLAS DE LOS GARZA, N.L.",0,1,1,18,0,0,
04-oct-14,MICH.,"TIQUICHEO DE NICOLAS ROMERO, MICH.",0,1,1,0,0,0,
04-oct-14,MICH.,"TIQUICHEO DE NICOLAS ROMERO, MICH.",1,0,1,0,0,0,
06-oct-14,JAL.,"TLAQUEPAQUE, JAL.",0,1,1,0,0,0,
06-oct-14,COAH.,"SALTILLO, COAH.",1,0,1,1,0,464,
06-oct-14,CHIH.,"JUÁREZ, CHIH.",1,0,1,0,0,0,
06-oct-14,MICH.,"TIQUICHEO DE NICOLAS ROMERO, MICH.",1,0,1,1,0,0,
06-oct-14,MICH.,"HUETAMO, MICH.",1,0,1,1,0,0,
06-oct-14,N.L.,"SAN NICOLAS DE LOS GARZA, N.L.",0,1,1,0,0,339,
07-oct-14,JAL.,"TLAQUEPAQUE, JAL.",0,1,1,0,0,0,
07-oct-14,CHIH.,"JUÁREZ, CHIH.",0,1,1,0,0,0,
07-oct-14,SON.,"NOGALES, SON.",1,0,1,0,0,0,
07-oct-14,SON.,"ALTAR, SON.",1,0,1,1,0,10,
07-oct-14,SON.,"PITIQUITO, SON.",1,0,1,1,0,0,
07-oct-14,SON.,"GENERAL PLUTARCO ELIAS CALLES, SON.",1,0,1,1,0,0,
08-oct-14,B.C.,"ENSENADA, B.C.",0,1,1,0,0,0,
08-oct-14,SON.,"CAJEME, SON.",1,0,1,0,0,50,
08-oct-14,SON.,"HUATABAMPO, SON.",1,0,1,0,0,24,
08-oct-14,SON.,"ETCHOJOA, SON.",1,0,1,0,0,0,
08-oct-14,SIN.,"ELOTA, SIN.",1,0,1,0,2,0,
08-oct-14,MICH.,"HUETAMO, MICH.",1,0,1,0,0,0,
08-oct-14,MOR.,"CUERNAVACA, MOR.",1,0,1,0,3,0,
08-oct-14,SON.,"FRONTERAS, SON.",0,1,1,0,0,0,
08-oct-14,SON.,"SANTA ANA, SON.",1,0,1,0,0,0,
08-oct-14,CHIH.,"JUÁREZ, CHIH.",1,0,1,0,0,0,
08-oct-14,PUE.,"PUE., PUE.",0,1,1,0,0,0,
08-oct-14,N.L.,"SAN NICOLAS DE LOS GARZA, N.L.",1,0,1,0,0,50,
08-oct-14,GRO.,"CHILAPA DE ALVAREZ, GRO.",1,0,1,0,0,0,
08-oct-14,COL.,"TECOMÁN, COL.",1,0,1,0,0,0,
08-oct-14,CHIH.,"JUÁREZ, CHIH.",1,0,1,0,0,0,
08-oct-14,GRO.,"CHILAPA DE ALVAREZ, GRO.",1,0,1,0,0,0,
09-oct-14,SON.,"HERMOSILLO, SON.",1,0,1,0,0,2100,
09-oct-14,SON.,"SANTA ANA, SON.",1,0,1,1,0,20,
09-oct-14,SON.,"GENERAL PLUTARCO ELIAS CALLES, SON.",0,1,1,0,0,0,
09-oct-14,NAY.,"ACAPONETA, NAY.",1,0,1,0,0,0,
10-oct-14,CHIH.,"JUÁREZ, CHIH.",1,0,1,0,0,0,
10-oct-14,SON.,"SAN MIGUEL DE HORCASITAS, SON.",1,0,1,1,0,30,
10-oct-14,SON.,"CAJEME, SON.",1,0,1,0,0,0,
10-oct-14,SON.,"HUATABAMPO, SON.",1,0,1,0,0,0,
10-oct-14,SON.,"SANTA ANA, SON.",1,0,1,0,0,0,
10-oct-14,SON.,"CABORCA, SON.",1,0,1,0,0,0,
10-oct-14,GRO.,"CHILAPA DE ALVAREZ, GRO.",1,0,1,1,0,7,
10-oct-14,SON.,"GUAYMAS, SON.",1,0,1,0,0,0,
11-oct-14,SON.,"SAN MIGUEL DE HORCASITAS, SON.",0,1,1,0,0,0,
11-oct-14,SON.,"BENITO JUAREZ, SON.",1,0,1,0,0,0,
11-oct-14,SON.,"EMPALME, SON.",0,1,1,0,0,0,
11-oct-14,MICH.,"AGUILILLA, MICH.",0,1,1,1,0,0,
11-oct-14,SON.,"MAGDALENA, SON.",0,1,1,0,0,0,
11-oct-14,SON.,"CANANEA, SON.",0,1,1,0,0,0,
11-oct-14,GRO.,"COAHUAYUTLA DE JOSE MARIA IZAZAGA, GRO.",0,1,1,0,0,0,
11-oct-14,TLAX.,"TLAX., TLAX.",0,1,1,0,0,0,
12-oct-14,MICH.,"PARACHO, MICH.",1,0,1,0,0,3579,
12-oct-14,MICH.,"PARACHO, MICH.",1,0,1,0,0,357,
13-oct-14,COL.,"COL., COL.",0,1,1,0,0,0,
13-oct-14,SON.,"AGUA PRIETA, SON.",0,1,1,0,0,0,
13-oct-14,SON.,"PUERTO PEÑASCO, SON.",1,0,1,0,0,0,
13-oct-14,SON.,"SAHUARIPA, SON.",0,1,1,0,0,0,
13-oct-14,SON.,"GUAYMAS, SON.",1,0,1,0,0,40,
13-oct-14,N.L.,"GUADALUPE, N.L.",0,1,1,0,0,0,
13-oct-14,NAY.,"ACAPONETA, NAY.",1,0,1,0,0,0,
13-oct-14,CHIH.,"JUÁREZ, CHIH.",0,1,1,0,0,0,
13-oct-14,GRO.,"TECPAN DE GALEANA, GRO.",1,0,1,0,0,0,
13-oct-14,GRO.,"COAHUAYUTLA DE JOSE MARIA IZAZAGA, GRO.",1,0,1,0,0,0,
14-oct-14,SON.,"IMURIS, SON.",0,1,1,0,0,0,
14-oct-14,SON.,"CANANEA, SON.",1,0,1,0,0,60,
14-oct-14,SON.,"AGUA PRIETA, SON.",0,1,1,0,0,0,
14-oct-14,SON.,"FRONTERAS, SON.",0,1,1,0,0,0,
14-oct-14,SON.,"PUERTO PEÑASCO, SON.",1,0,1,0,0,0,
14-oct-14,SON.,"PITIQUITO, SON.",1,0,1,0,0,0,
14-oct-14,SON.,"SAN MIGUEL DE HORCASITAS, SON.",1,0,1,0,0,6,
14-oct-14,SON.,"CAJEME, SON.",1,0,1,2,0,20,
14-oct-14,SON.,"SAHUARIPA, SON.",1,0,1,0,0,0,
14-oct-14,SON.,"ETCHOJOA, SON.",1,0,1,0,0,0,
14-oct-14,COL.,"COL., COL.",1,0,1,0,0,0,
14-oct-14,AGS.,"AGS., AGS.",1,0,1,1,0,0,
14-oct-14,B.C.,"ENSENADA, B.C.",0,1,1,0,0,0,
15-oct-14,YUC.,"TIXCACALCUPUL, YUC.",0,1,1,0,0,0,
15-oct-14,COAH.,"SALTILLO, COAH.",1,0,1,0,0,175,
15-oct-14,CHIH.,"JUÁREZ, CHIH.",1,0,1,0,0,0,
15-oct-14,SON.,"SAN MIGUEL DE HORCASITAS, SON.",1,0,1,0,0,14,
15-oct-14,SON.,"HUATABAMPO, SON.",1,0,1,0,0,0,
15-oct-14,AGS.,"AGS., AGS.",1,0,1,4,0,45,
15-oct-14,COL.,"TECOMÁN, COL.",0,1,1,0,0,0,
16-oct-14,COL.,"COL., COL.",1,0,1,0,0,0,
16-oct-14,CHIH.,"HGO. DEL PARRAL, CHIH.",0,1,1,0,0,0,
16-oct-14,SON.,"SANTA ANA, SON.",1,0,1,0,0,40,
16-oct-14,SON.,"FRONTERAS, SON.",0,1,1,0,0,0,
16-oct-14,SON.,"CAJEME, SON.",1,0,1,6,0,0,
16-oct-14,SON.,"BENITO JUAREZ, SON.",1,0,1,7,0,0,
16-oct-14,COAH.,"SALTILLO, COAH.",1,0,1,0,0,195,
16-oct-14,SIN.,"CONCORDIA, SIN.",1,0,1,0,0,0,
17-oct-14,SON.,"BENITO JUAREZ, SON.",1,0,1,0,0,20,
17-oct-14,SON.,"SAHUARIPA, SON.",1,0,1,0,0,0,
17-oct-14,SON.,"GUAYMAS, SON.",1,0,1,1,0,71,
17-oct-14,SON.,"EMPALME, SON.",1,0,1,0,0,17,
17-oct-14,ZAC.,"TRINIDAD GARCIA DE LA CADENA, ZAC.",0,1,1,0,0,10,
17-oct-14,AGS.,"AGS., AGS.",1,0,1,0,0,0,
17-oct-14,JAL.,"TLAQUEPAQUE, JAL.",1,0,1,0,1,0,
17-oct-14,SON.,"CANANEA, SON.",1,0,1,0,0,0,
17-oct-14,SON.,"PUERTO PEÑASCO, SON.",1,0,1,0,0,0,
18-oct-14,B.C.S.,"COMONDÚ, B.C.S.",0,1,1,0,0,0,
18-oct-14,TLAX.,"ZACATELCO, TLAX.",0,1,1,0,0,0,
18-oct-14,GRO.,"ACAPULCO DE JUAREZ, GRO.",0,1,1,0,0,0,
18-oct-14,N.L.,"SANTA CATARINA, N.L.",0,1,1,0,0,236,
18-oct-14,ZAC.,"TRINIDAD GARCIA DE LA CADENA, ZAC.",0,1,1,0,0,0,
18-oct-14,SON.,"CANANEA, SON.",1,0,1,0,0,0,
18-oct-14,SON.,"PUERTO PEÑASCO, SON.",1,0,1,0,0,0,
18-oct-14,CHIS.,"PALENQUE, CHIS.",1,0,1,0,0,131,
19-oct-14,ZAC.,"TRINIDAD GARCIA DE LA CADENA, ZAC.",0,1,1,0,0,0,
19-oct-14,MICH.,"ZACAPU, MICH.",1,0,1,0,0,6240,
19-oct-14,CHIS.,"TONALÁ, CHIS.",0,1,1,0,0,40,
19-oct-14,CHIS.,"OCOSINGO, CHIS.",1,0,1,0,0,0,
19-oct-14,B.C.S.,"COMONDÚ, B.C.S.",0,1,1,0,0,0,
20-oct-14,COL.,"TECOMÁN, COL.",0,1,1,0,0,0,
20-oct-14,MICH.,"ARIO, MICH.",1,0,1,0,0,0,
20-oct-14,N.L.,"SANTA CATARINA, N.L.",1,0,1,0,0,98,
20-oct-14,SON.,"IMURIS, SON.",1,0,1,0,0,0,
20-oct-14,SON.,"CANANEA, SON.",1,0,1,1,0,0,
20-oct-14,SON.,"AGUA PRIETA, SON.",1,0,1,1,0,200,
21-oct-14,GRO.,"ACAPULCO DE JUAREZ, GRO.",1,0,1,0,0,0,
21-oct-14,GRO.,"PETATLAN, GRO.",0,1,1,0,0,0,
21-oct-14,SON.,"HERMOSILLO, SON.",1,0,1,6,0,200,
21-oct-14,SON.,"CAJEME, SON.",1,0,1,0,1,0,
21-oct-14,SON.,"GUAYMAS, SON.",1,0,1,0,0,50,
21-oct-14,GRO.,"TELOLOAPAN, GRO.",1,0,1,0,0,0,
21-oct-14,SON.,"NOGALES, SON.",1,0,1,0,0,8,
21-oct-14,SON.,"AGUA PRIETA, SON.",1,0,1,0,0,0,
21-oct-14,SON.,"FRONTERAS, SON.",0,1,1,1,0,0,
22-oct-14,VER.,"SOLEDAD DE DOBLADO, VER.",1,0,1,0,0,0,
22-oct-14,GRO.,"ACAPULCO DE JUAREZ, GRO.",0,1,1,0,0,0,
22-oct-14,GRO.,"PETATLAN, GRO.",1,0,1,0,0,0,
23-oct-14,SIN.,"CONCORDIA, SIN.",1,0,1,0,4,0,
23-oct-14,COL.,"TECOMÁN, COL.",1,0,1,0,0,0,
23-oct-14,VER.,"SOLEDAD DE DOBLADO, VER.",1,0,1,0,0,0,
23-oct-14,TLAX.,"ZACATELCO, TLAX.",1,0,1,0,0,0,
23-oct-14,S.L.P.,"SAN LUIS POTOSI, S.L.P.",1,0,1,0,0,0,
23-oct-14,N.L.,"GRAL. ESCOBEDO, N.L.",1,0,1,0,0,0,
23-oct-14,SON.,"HERMOSILLO, SON.",1,0,1,10,0,0,
23-oct-14,SON.,"EMPALME, SON.",0,1,1,0,0,0,
23-oct-14,SON.,"ETCHOJOA, SON.",1,0,1,1,0,0,
23-oct-14,SON.,"NOGALES, SON.",0,1,1,6,0,1,
23-oct-14,SON.,"PUERTO PEÑASCO, SON.",1,0,1,0,0,0,
23-oct-14,SON.,"PITIQUITO, SON.",1,0,1,0,0,0,
23-oct-14,GRO.,"PETATLAN, GRO.",1,0,1,0,0,0,
23-oct-14,MICH.,"TEPALCATEPEC, MICH.",1,0,1,0,0,9,
24-oct-14,TAMPS.,"PADILLA, TAMPS.",1,0,1,3,0,100,
24-oct-14,MICH.,"LAZARO CARDENAS, MICH.",1,0,1,0,0,138,
24-oct-14,ZAC.,"GUADALUPE, ZAC.",0,1,1,0,0,0,
24-oct-14,TAMPS.,"PADILLA, TAMPS.",1,0,1,3,0,190,
24-oct-14,SON.,"SAN MIGUEL DE HORCASITAS, SON.",0,1,1,0,0,0,
24-oct-14,SON.,"CAJEME, SON.",1,0,1,0,0,0,
24-oct-14,SON.,"ETCHOJOA, SON.",1,0,1,0,0,0,
24-oct-14,SON.,"NOGALES, SON.",0,1,1,1,0,153,
24-oct-14,SON.,"CANANEA, SON.",0,1,1,0,0,410,
24-oct-14,SON.,"PUERTO PEÑASCO, SON.",1,0,1,0,0,0,
24-oct-14,SON.,"CABORCA, SON.",0,1,1,0,0,0,
24-oct-14,SON.,"SAN LUIS RIO COLORADO, SON.",1,0,1,5,0,0,
25-oct-14,MOR.,"CUERNAVACA, MOR.",0,1,1,0,0,0,
25-oct-14,CHIS.,"PICHUCALCO, CHIS.",0,1,1,0,0,0,
25-oct-14,SON.,"SANTA ANA, SON.",0,1,1,0,0,0,
25-oct-14,SON.,"CABORCA, SON.",1,0,1,1,0,0,
25-oct-14,SON.,"PITIQUITO, SON.",1,0,1,0,0,0,
25-oct-14,GRO.,"ACAPULCO DE JUAREZ, GRO.",1,0,1,0,0,0,
25-oct-14,B.C.,"ENSENADA, B.C.",1,0,1,0,0,0,
25-oct-14,TAMPS.,"PADILLA, TAMPS.",0,1,1,0,0,106,
25-oct-14,CHIH.,"JUÁREZ, CHIH.",0,1,1,0,0,0,
25-oct-14,SON.,"HERMOSILLO, SON.",1,0,1,21,0,0,
25-oct-14,SON.,"SAN MIGUEL DE HORCASITAS, SON.",0,1,1,0,0,0,
25-oct-14,SON.,"CAJEME, SON.",0,1,1,0,0,0,
26-oct-14,CHIS.,"OCOSINGO, CHIS.",0,1,1,4,0,160,
26-oct-14,N.L.,"APODACA, N.L.",0,1,1,19,0,956,
26-oct-14,TLAX.,"TEOLOCHOLCO, TLAX.",1,0,1,0,0,0,
26-oct-14,CHIS.,"PICHUCALCO, CHIS.",1,0,1,0,6,94,
27-oct-14,MICH.,"ZAMORA, MICH.",0,1,1,1,0,450,
27-oct-14,COL.,"TECOMÁN, COL.",0,1,1,0,0,0,
27-oct-14,COAH.,"TORREÓN, COAH.",1,0,1,0,0,0,
27-oct-14,SON.,"GUAYMAS, SON.",1,0,1,0,0,3,
27-oct-14,SIN.,"EL FUERTE, SIN.",1,0,1,0,0,0,
27-oct-14,CHIS.,"TONALÁ, CHIS.",1,0,1,7,0,388,
27-oct-14,SON.,"CANANEA, SON.",0,1,1,0,0,0,
27-oct-14,SON.,"GENERAL PLUTARCO ELIAS CALLES, SON.",1,0,1,0,0,0,
28-oct-14,SON.,"HERMOSILLO, SON.",1,0,1,10,0,0,
28-oct-14,SON.,"YECORA, SON.",1,0,1,0,0,0,
28-oct-14,SON.,"HUATABAMPO, SON.",1,0,1,0,0,0,
28-oct-14,SON.,"ALAMOS, SON.",1,0,1,0,0,0,
28-oct-14,CHIS.,"PICHUCALCO, CHIS.",1,0,1,2,0,173,
28-oct-14,SON.,"MAGDALENA, SON.",1,0,1,0,0,0,
28-oct-14,SON.,"PUERTO PEÑASCO, SON.",1,0,1,1,0,60,
28-oct-14,MOR.,"CUERNAVACA, MOR.",1,0,1,0,1,0,
28-oct-14,CHIH.,"JUÁREZ, CHIH.",1,0,1,0,0,0,
28-oct-14,GRO.,"PETATLAN, GRO.",0,1,1,0,0,1,
29-oct-14,SON.,"CAJEME, SON.",1,0,1,0,0,0,
29-oct-14,COAH.,"MONCLOVA, COAH.",1,0,1,0,0,0,
29-oct-14,COAH.,"TORREÓN, COAH.",0,1,1,0,0,0,
29-oct-14,TAMPS.,"PADILLA, TAMPS.",0,1,1,0,0,30,
29-oct-14,ZAC.,"TRINIDAD GARCIA DE LA CADENA, ZAC.",0,1,1,1,0,0,
29-oct-14,AGS.,"AGS., AGS.",1,0,1,0,0,0,
29-oct-14,PUE.,"SAN PEDRO CHOLULA, PUE.",1,0,1,1,0,61,
29-oct-14,SON.,"NOGALES, SON.",1,0,1,0,0,0,
29-oct-14,SON.,"ALTAR, SON.",1,0,1,0,0,0,
29-oct-14,SON.,"CABORCA, SON.",1,0,1,0,0,0,
29-oct-14,SON.,"PITIQUITO, SON.",0,1,1,0,0,0,
29-oct-14,SON.,"SAN LUIS RIO COLORADO, SON.",1,0,1,0,0,0,
30-oct-14,CAMP.,"CARMEN, CAMP.",1,0,1,0,0,0,
30-oct-14,COAH.,"SALTILLO, COAH.",1,0,1,0,0,0,
30-oct-14,COAH.,"TORREÓN, COAH.",1,0,1,0,0,0,
30-oct-14,COAH.,"FRONTERA, COAH.",1,0,1,0,0,0,
30-oct-14,CHIS.,"SAN CRISTOBAL DE LAS CASAS, CHIS.",1,0,1,0,0,0,
30-oct-14,SON.,"PUERTO PEÑASCO, SON.",0,1,1,0,0,50,
31-oct-14,SON.,"MAGDALENA, SON.",1,0,1,0,0,0,
31-oct-14,SON.,"AGUA PRIETA, SON.",0,1,1,0,0,0,
31-oct-14,SON.,"GENERAL PLUTARCO ELIAS CALLES, SON.",0,1,1,0,0,100,
31-oct-14,CAMP.,"CARMEN, CAMP.",1,0,1,0,0,0,
31-oct-14,B.C.S.,"MULEGÉ, B.C.S.",1,0,1,0,0,0,
31-oct-14,COAH.,"SALTILLO, COAH.",0,1,1,1,0,0,
31-oct-14,CHIS.,"PICHUCALCO, CHIS.",1,0,1,6,0,563,
31-oct-14,SON.,"CAJEME, SON.",0,1,1,0,0,0,
31-oct-14,N.L.,"APODACA, N.L.",0,1,1,29,0,2784,
31-oct-14,TAMPS.,"PADILLA, TAMPS.",0,1,1,0,0,0,
01-nov-14,SON.,"GUAYMAS, SON.",1,0,1,1,0,0,
01-nov-14,SON.,"HUATABAMPO, SON.",1,0,1,1,0,100,
01-nov-14,SON.,"ALAMOS, SON.",0,1,1,0,0,0,
01-nov-14,SON.,"AGUA PRIETA, SON.",0,1,1,0,0,0,
01-nov-14,SON.,"PUERTO PEÑASCO, SON.",0,1,1,0,0,0,
03-nov-14,COAH.,"SALTILLO, COAH.",1,0,1,0,0,140,
03-nov-14,COAH.,"FRONTERA, COAH.",1,0,1,0,0,0,
03-nov-14,COAH.,"SALTILLO, COAH.",1,0,1,0,0,0,
04-nov-14,B.C.,"ENSENADA, B.C.",0,1,1,0,0,0,
04-nov-14,N.L.,"CADEREYTA JIMENEZ, N.L.",1,0,1,0,0,0,
04-nov-14,NAY.,"AMATLAN DE CAÑAS, NAY.",0,1,1,0,0,0,
04-nov-14,GRO.,"TELOLOAPAN, GRO.",0,1,1,0,0,0,
05-nov-14,TLAX.,"EL CARMEN TEQUEXQUITLA, TLAX.",0,1,1,0,0,0,
05-nov-14,GRO.,"FLORENCIO VILLARREAL, GRO.",0,1,1,0,1,0,
05-nov-14,GRO.,"ATOYAC DE ALVAREZ, GRO.",0,1,1,1,0,0,
05-nov-14,GRO.,"TECPAN DE GALEANA, GRO.",0,1,1,0,0,0,
05-nov-14,CHIS.,"TONALÁ, CHIS.",0,1,1,2,0,902,
05-nov-14,SON.,"HERMOSILLO, SON.",1,0,1,1,0,0,
05-nov-14,AGS.,"SAN FRANCISCO DE LOS ROMO, AGS.",1,0,1,1,0,0,
06-nov-14,S.L.P.,"SAN LUIS POTOSI, S.L.P.",1,0,1,0,0,0,
06-nov-14,CHIS.,"PALENQUE, CHIS.",1,0,1,0,0,0,
06-nov-14,CHIH.,"JUÁREZ, CHIH.",0,1,1,0,0,0,
06-nov-14,CHIS.,"PICHUCALCO, CHIS.",0,1,1,0,0,480,
06-nov-14,JAL.,"TOMATLAN, JAL.",1,0,1,0,0,0,
06-nov-14,GRO.,"ATOYAC DE ALVAREZ, GRO.",1,0,1,0,0,0,
07-nov-14,CHIS.,"OCOSINGO, CHIS.",1,0,1,0,0,88,
07-nov-14,COAH.,"SALTILLO, COAH.",1,0,1,0,0,120,
07-nov-14,GRO.,"PUNGARABATO, GRO.",0,1,1,0,0,0,
07-nov-14,JAL.,"TOMATLAN, JAL.",0,1,1,0,0,0,
08-nov-14,CHIS.,"COMITAN DE DOMÍNGUEZ, CHIS.",1,0,1,0,0,40,
08-nov-14,AGS.,"SAN FRANCISCO DE LOS ROMO, AGS.",1,0,1,1,0,0,
09-nov-14,TLAX.,"CALPULALPAN, TLAX.",0,1,1,0,0,0,
09-nov-14,CHIS.,"VILLAFLORES, CHIS.",1,0,1,2,0,50,
09-nov-14,CHIS.,"PICHUCALCO, CHIS.",0,1,1,0,0,0,
09-nov-14,CHIS.,"COMITAN DE DOMÍNGUEZ, CHIS.",1,0,1,0,0,0,
10-nov-14,CHIS.,"SAN CRISTOBAL DE LAS CASAS, CHIS.",1,0,1,0,0,0,
10-nov-14,CHIS.,"PICHUCALCO, CHIS.",0,1,1,6,0,384,
10-nov-14,CHIS.,"OCOSINGO, CHIS.",0,1,1,1,0,88,
10-nov-14,AGS.,"AGS., AGS.",0,1,1,1,0,0,
11-nov-14,AGS.,"CALVILLO, AGS.",1,0,1,0,0,0,
11-nov-14,B.C.S.,"LOS CABOS, B.C.S.",0,1,1,0,0,0,
11-nov-14,GRO.,"ALCOZAUCA DE GRO., GRO.",0,1,1,0,0,0,
11-nov-14,GRO.,"FLORENCIO VILLARREAL, GRO.",1,0,1,0,0,0,
11-nov-14,CHIS.,"VILLAFLORES, CHIS.",1,0,1,0,0,400,
11-nov-14,CHIH.,"JUÁREZ, CHIH.",1,0,1,0,0,0,
12-nov-14,CHIS.,"VILLAFLORES, CHIS.",0,1,1,0,0,305,
12-nov-14,QRO.,"AMEALCO DE BONFIL, QRO.",1,0,1,0,0,0,
12-nov-14,QRO.,"HUIMILPAN, QRO.",0,1,1,0,0,0,
13-nov-14,SIN.,"SALVADOR ALVARADO, SIN.",1,0,1,0,0,0,
13-nov-14,AGS.,"CALVILLO, AGS.",1,0,1,0,0,0,
13-nov-14,Q. ROO,"OTHON P. BLANCO, Q. ROO",0,1,1,0,0,0,
13-nov-14,CHIH.,"JUÁREZ, CHIH.",1,0,1,0,0,0,
14-nov-14,COAH.,"SALTILLO, COAH.",1,0,1,0,0,33,
14-nov-14,AGS.,"AGS., AGS.",1,0,1,6,0,0,
18-nov-14,AGS.,"CALVILLO, AGS.",0,1,1,0,0,0,
18-nov-14,GRO.,"TELOLOAPAN, GRO.",0,1,1,0,0,0,
19-nov-14,CHIH.,"JUÁREZ, CHIH.",1,0,1,0,0,0,
21-nov-14,HGO.,"HUASCA DE OCAMPO, HGO.",0,1,1,0,0,0,
21-nov-14,COAH.,"SALTILLO, COAH.",0,1,1,0,0,0,
21-nov-14,N.L.,"GUADALUPE, N.L.",1,0,1,0,0,0,
26-nov-14,ZAC.,"JALPA, ZAC.",0,1,1,0,0,0,
26-nov-14,GRO.,"ZIHUATANEJO DE AZUETA, GRO.",1,0,1,0,0,0,
26-nov-14,N.L.,"SABINAS HGO., N.L.",0,1,1,0,0,0,
27-nov-14,GRO.,"ZIHUATANEJO DE AZUETA, GRO.",1,0,1,0,0,0,
28-nov-14,HGO.,"HUASCA DE OCAMPO, HGO.",1,0,1,0,3,0,
28-nov-14,N.L.,"SABINAS HGO., N.L.",0,1,1,2,0,28,
28-nov-14,ZAC.,"JALPA, ZAC.",0,1,1,0,0,0,
01-dic-14,GRO.,"HUITZUCO DE LOS FIGUEROA, GRO.",1,0,1,0,0,165,
02-dic-14,ZAC.,"TRINIDAD GARCIA DE LA CADENA, ZAC.",0,1,1,0,0,0,
03-dic-14,GRO.,"HUITZUCO DE LOS FIGUEROA, GRO.",1,0,1,0,0,0,
03-dic-14,N.L.,"ANAHUAC, N.L.",0,1,1,0,0,0,
04-dic-14,GRO.,"HUITZUCO DE LOS FIGUEROA, GRO.",1,0,1,1,0,0,
04-dic-14,TAMPS.,"MATAMOROS, TAMPS.",0,1,1,0,0,48,
04-dic-14,GRO.,"FLORENCIO VILLARREAL, GRO.",1,0,1,0,0,0,
05-dic-14,GRO.,"ACAPULCO DE JUAREZ, GRO.",1,0,1,0,0,0,
08-dic-14,COAH.,"ACUÑA, COAH.",1,0,1,0,0,0,
08-dic-14,COL.,"COL., COL.",0,1,1,0,0,0,
08-dic-14,GRO.,"ACAPULCO DE JUAREZ, GRO.",1,0,1,0,0,0,
09-dic-14,COL.,"COL., COL.",1,0,1,0,0,0,
10-dic-14,COAH.,"ACUÑA, COAH.",1,0,1,0,0,0,
10-dic-14,N.L.,"MONTERREY, N.L.",0,1,1,18,0,638,
11-dic-14,CHIS.,"BENEMÉRITO DE LAS AMÉRICAS, CHIS.",1,0,1,0,0,0,
11-dic-14,GRO.,"ACAPULCO DE JUAREZ, GRO.",1,0,1,0,0,0,
12-dic-14,CHIS.,"BENEMÉRITO DE LAS AMÉRICAS, CHIS.",0,1,1,0,0,0,
12-dic-14,CHIH.,"HGO. DEL PARRAL, CHIH.",0,1,1,0,0,0,
12-dic-14,GRO.,"TELOLOAPAN, GRO.",1,0,1,0,0,0,
12-dic-14,TAMPS.,"NUEVO LAREDO, TAMPS.",1,0,1,1,0,65,
13-dic-14,COAH.,"TORREÓN, COAH.",1,0,1,0,0,0,
13-dic-14,CHIH.,"HGO. DEL PARRAL, CHIH.",0,1,1,0,0,0,
15-dic-14,TAMPS.,"MATAMOROS, TAMPS.",1,0,1,0,0,0,
15-dic-14,GRO.,"TELOLOAPAN, GRO.",0,1,1,0,0,0,
16-dic-14,N.L.,"SAN NICOLAS DE LOS GARZA, N.L.",1,0,1,4,0,62,
19-dic-14,B.C.S.,"COMONDÚ, B.C.S.",1,0,1,0,0,0,
19-dic-14,COAH.,"ACUÑA, COAH.",1,0,1,0,0,0,
23-dic-14,GRO.,"ACAPULCO DE JUAREZ, GRO.",0,1,1,0,0,0,
25-dic-14,DGO.,"DGO., DGO.",1,0,1,4,0,0,
26-dic-14,CHIS.,"BENEMÉRITO DE LAS AMÉRICAS, CHIS.",0,1,1,0,0,0,
26-dic-14,COAH.,"TORREÓN, COAH.",1,0,1,0,0,0,
27-dic-14,CHIS.,"MARQUÉS DE COMILLAS, CHIS.",0,1,1,0,0,0,
30-dic-14,PUE.,"ATLIXCO, PUE.",1,0,1,0,0,0,
31-dic-14,CHIS.,"BENEMÉRITO DE LAS AMÉRICAS, CHIS.",0,1,1,0,0,0,
02-ene-15,CHIS.,"BENEMÉRITO DE LAS AMÉRICAS, CHIS.",0,1,1,0,0,0,
03-ene-15,VER.,"TUXPAM, VER.",1,0,1,0,0,9,
03-ene-15,PUE.,"ATLIXCO, PUE.",1,0,1,0,0,0,
04-ene-15,DGO.,"DGO., DGO.",0,1,1,0,0,0,
07-ene-15,COL.,"COL., COL.",0,1,1,0,0,0,
08-ene-15,COL.,"TECOMÁN, COL.",1,0,1,0,0,0,
08-ene-15,DGO.,"DGO., DGO.",0,1,1,0,0,0,
11-ene-15,DGO.,"DGO., DGO.",1,0,1,0,0,0,
12-ene-15,TAB.,"TENOSIQUE, TAB.",1,0,1,0,0,0,
13-ene-15,DGO.,"DGO., DGO.",1,0,1,14,0,0,
13-ene-15,ZAC.,"TRINIDAD GARCIA DE LA CADENA, ZAC.",1,0,1,0,0,0,
14-ene-15,CHIS.,"MARQUÉS DE COMILLAS, CHIS.",0,1,1,0,0,0,
17-ene-15,DGO.,"DGO., DGO.",1,0,1,0,0,0,
19-ene-15,COAH.,"ACUÑA, COAH.",0,1,1,0,0,0,
20-ene-15,CHIS.,"MARQUÉS DE COMILLAS, CHIS.",0,1,1,0,0,0,
23-ene-15,CHIS.,"MARAVILLA TENEJAPA, CHIS.",0,1,1,0,0,0,
23-ene-15,COAH.,"ACUÑA, COAH.",1,0,1,0,0,0,
23-ene-15,PUE.,"TEHUACAN, PUE.",1,0,1,0,0,0,
23-ene-15,PUE.,"TEHUACAN, PUE.",1,0,1,0,0,0,
25-ene-15,PUE.,"ATLIXCO, PUE.",0,1,1,0,0,0,
28-ene-15,DGO.,"DGO., DGO.",1,0,1,0,0,0,
30-ene-15,PUE.,"TEHUACAN, PUE.",0,1,1,0,0,21,
31-ene-15,PUE.,"TEHUACAN, PUE.",1,0,1,0,0,0,
02-feb-15,DGO.,"DGO., DGO.",1,0,1,8,1,0,
04-feb-15,B.C.,"ENSENADA, B.C.",1,0,1,0,0,0,
04-feb-15,DGO.,"DGO., DGO.",0,1,1,0,0,0,
04-feb-15,CHIS.,"BENEMÉRITO DE LAS AMÉRICAS, CHIS.",1,0,1,0,0,0,
05-feb-15,CHIS.,"BENEMÉRITO DE LAS AMÉRICAS, CHIS.",1,0,1,0,0,0,
05-feb-15,CHIS.,"BENEMÉRITO DE LAS AMÉRICAS, CHIS.",0,1,1,0,0,0,
05-feb-15,PUE.,"TEHUACAN, PUE.",0,1,1,0,0,0,
05-feb-15,COAH.,"ACUÑA, COAH.",1,0,1,0,0,0,
05-feb-15,B.C.,"ENSENADA, B.C.",1,0,1,0,0,0,
05-feb-15,TAMPS.,"NUEVO LAREDO, TAMPS.",0,1,1,0,0,0,
05-feb-15,GRO.,"ACAPULCO DE JUAREZ, GRO.",0,1,1,0,0,0,
05-feb-15,NAY.,"TEPIC, NAY.",1,0,1,0,1,0,
06-feb-15,B.C.,"TIJUANA, B.C.",0,1,1,0,0,0,
06-feb-15,B.C.,"ENSENADA, B.C.",1,0,1,0,0,0,
06-feb-15,GRO.,"IGUALA DE LA INDEPENDENCIA, GRO.",1,0,1,0,0,0,
07-feb-15,TAMPS.,"NUEVO LAREDO, TAMPS.",0,1,1,0,0,50,
07-feb-15,GRO.,"IGUALA DE LA INDEPENDENCIA, GRO.",0,1,1,0,0,0,
07-feb-15,B.C.,"ENSENADA, B.C.",1,0,1,0,0,0,
08-feb-15,B.C.,"ENSENADA, B.C.",1,0,1,0,0,0,
08-feb-15,GRO.,"IGUALA DE LA INDEPENDENCIA, GRO.",1,0,1,0,0,0,
10-feb-15,YUC.,"TEKAL DE VENEGAS, YUC.",0,1,1,0,0,0,
10-feb-15,NAY.,"TEPIC, NAY.",1,0,1,0,0,0,
11-feb-15,GRO.,"IGUALA DE LA INDEPENDENCIA, GRO.",1,0,1,0,0,0,
12-feb-15,CHIS.,"BENEMÉRITO DE LAS AMÉRICAS, CHIS.",1,0,1,0,0,0,
12-feb-15,ZAC.,"TEUL DE GONZALEZ ORTEGA, ZAC.",1,0,1,0,0,0,
13-feb-15,COAH.,"ACUÑA, COAH.",1,0,1,0,0,0,
13-feb-15,PUE.,"ATLIXCO, PUE.",1,0,1,0,0,0,
14-feb-15,B.C.,"ENSENADA, B.C.",1,0,1,0,0,0,
15-feb-15,TAMPS.,"NUEVO LAREDO, TAMPS.",1,0,1,0,0,0,
17-feb-15,COAH.,"TORREÓN, COAH.",0,1,1,0,0,0,
20-feb-15,COL.,"COL., COL.",1,0,1,0,0,0,
20-feb-15,PUE.,"ATLIXCO, PUE.",1,0,1,0,0,0,
28-feb-15,HGO.,"PACHUCA DE SOTO, HGO.",1,0,1,0,0,200,
02-mar-15,GRO.,"ACAPULCO DE JUAREZ, GRO.",1,0,1,0,0,0,
03-mar-15,VER.,"POZA RICA DE HGO., VER.",0,1,1,0,0,0,
03-mar-15,CHIS.,"MARAVILLA TENEJAPA, CHIS.",1,0,1,0,0,0,
04-mar-15,CHIS.,"BENEMÉRITO DE LAS AMÉRICAS, CHIS.",0,1,1,0,0,0,
04-mar-15,B.C.,"ENSENADA, B.C.",0,1,1,0,0,0,
05-mar-15,ZAC.,"FRESNILLO, ZAC.",1,0,1,0,0,0,
05-mar-15,GRO.,"HUITZUCO DE LOS FIGUEROA, GRO.",0,1,1,0,0,0,
05-mar-15,HGO.,"PACHUCA DE SOTO, HGO.",0,1,1,0,0,0,
05-mar-15,PUE.,"TEHUACAN, PUE.",1,0,1,0,0,12,
06-mar-15,TAMPS.,"MATAMOROS, TAMPS.",0,1,1,0,0,0,
06-mar-15,VER.,"POZA RICA DE HGO., VER.",1,0,1,3,0,304,
06-mar-15,CHIS.,"MARAVILLA TENEJAPA, CHIS.",1,0,1,0,0,0,
09-mar-15,TAB.,"COMALCALCO, TAB.",1,0,1,0,0,0,
10-mar-15,PUE.,"TEHUACAN, PUE.",1,0,1,0,0,20,
10-mar-15,TAMPS.,"TAMPICO, TAMPS.",1,0,1,0,0,0,
11-mar-15,OAX.,"MIAHUATLAN DE PORFIRIO DIAZ, OAX.",1,0,1,0,7,0,
11-mar-15,TAB.,"COMALCALCO, TAB.",1,0,1,0,0,0,
11-mar-15,COAH.,"TORREÓN, COAH.",1,0,1,0,0,0,
12-mar-15,NAY.,"COMPOSTELA, NAY.",1,0,1,0,0,0,
12-mar-15,OAX.,"MIAHUATLAN DE PORFIRIO DIAZ, OAX.",0,1,1,0,0,0,
12-mar-15,B.C.,"TIJUANA, B.C.",0,1,1,0,0,0,
13-mar-15,YUC.,"TUNKAS, YUC.",0,1,1,0,0,0,
13-mar-15,DGO.,"LERDO, DGO.",1,0,1,0,1,0,
16-mar-15,DGO.,"LERDO, DGO.",1,0,1,0,0,0,
18-mar-15,PUE.,"TEHUACAN, PUE.",0,1,1,0,0,177,
18-mar-15,COL.,"COL., COL.",1,0,1,0,0,0,
18-mar-15,OAX.,"SALINA CRUZ, OAX.",1,0,1,0,0,0,
18-mar-15,OAX.,"MIAHUATLAN DE PORFIRIO DIAZ, OAX.",0,1,1,4,0,0,
18-mar-15,GRO.,"LA UNION DE ISIDORO MONTES DE OCA, GRO.",0,1,1,0,0,0,
19-mar-15,CHIS.,"BENEMÉRITO DE LAS AMÉRICAS, CHIS.",1,0,1,0,0,0,
19-mar-15,CHIS.,"REFORMA, CHIS.",1,0,1,0,0,0,
19-mar-15,OAX.,"SALINA CRUZ, OAX.",1,0,1,40,0,0,
20-mar-15,OAX.,"MIAHUATLAN DE PORFIRIO DIAZ, OAX.",0,1,1,0,0,0,
20-mar-15,OAX.,"SALINA CRUZ, OAX.",1,0,1,0,0,0,
23-mar-15,HGO.,"TEPEJI DEL RIO DE OCAMPO, HGO.",1,0,1,0,0,0,
23-mar-15,OAX.,"CIUDAD IXTEPEC, OAX.",0,1,1,0,0,0,
24-mar-15,B.C.,"ENSENADA, B.C.",0,1,1,0,0,0,
24-mar-15,OAX.,"CIUDAD IXTEPEC, OAX.",0,1,1,0,0,0,
24-mar-15,HGO.,"TULA DE ALLENDE, HGO.",1,0,1,0,0,0,
24-mar-15,HGO.,"TEPEJI DEL RIO DE OCAMPO, HGO.",1,0,1,0,0,0,
25-mar-15,PUE.,"TEHUACAN, PUE.",1,0,1,0,0,0,
26-mar-15,OAX.,"CIUDAD IXTEPEC, OAX.",0,1,1,0,0,112,
26-mar-15,B.C.,"MEXICALI, B.C.",1,0,1,0,0,0,
27-mar-15,HGO.,"TULA DE ALLENDE, HGO.",1,0,1,0,0,0,
28-mar-15,HGO.,"TEPEJI DEL RIO DE OCAMPO, HGO.",0,1,1,0,0,0,
01-ago-15,CHIH.,"HGO. DEL PARRAL, CHIH.",0,1,1,0,0,0,
02-ago-15,GRO.,"ACAPULCO DE JUAREZ, GRO.",1,0,1,1,1,0,
02-ago-15,GRO.,"PETATLAN, GRO.",0,1,1,0,0,10,
02-ago-15,JAL.,"PUERTO VALLARTA, JAL.",1,0,1,0,0,0,
03-ago-15,GRO.,"EDUARDO NERI, GRO.",1,0,1,0,0,0,
03-ago-15,COAH.,"MONCLOVA, COAH.",1,0,1,0,0,0,
03-ago-15,VER.,"MISANTLA, VER.",1,0,1,0,0,0,
03-ago-15,OAX.,"SAN JUAN BAUTISTA TUXTEPEC, OAX.",1,0,1,0,0,0,
03-ago-15,OAX.,"PINOTEPA DE DON LUIS, OAX.",1,0,1,0,0,0,
03-ago-15,MEX.,"HUEHUETOCA, MEX.",1,0,1,1,0,0,
04-ago-15,PUE.,"PUE., PUE.",1,0,1,0,0,56,
04-ago-15,HGO.,"APAN, HGO.",1,0,1,0,0,0,
04-ago-15,CHIS.,"BENEMÉRITO DE LAS AMÉRICAS, CHIS.",1,0,1,0,0,0,
04-ago-15,B.C.S.,"MULEGÉ, B.C.S.",0,1,1,0,0,0,
05-ago-15,OAX.,"SAN JUAN BAUTISTA ATATLAHUCA, OAX.",0,1,1,0,0,0,
05-ago-15,OAX.,"SAN JUAN BAUTISTA TUXTEPEC, OAX.",1,0,1,0,0,36,
05-ago-15,B.C.S.,"MULEGÉ, B.C.S.",0,1,1,0,0,0,
05-ago-15,MEX.,"HUEHUETOCA, MEX.",0,1,1,0,0,150,
06-ago-15,HGO.,"APAN, HGO.",0,1,1,0,0,70,
06-ago-15,OAX.,"MIAHUATLAN DE PORFIRIO DIAZ, OAX.",0,1,1,15,0,0,
06-ago-15,OAX.,"SAN JUAN BAUTISTA LO DE SOTO, OAX.",0,1,1,0,0,0,
06-ago-15,OAX.,"SAN PEDRO POCHUTLA, OAX.",1,0,1,0,0,0,
06-ago-15,CHIH.,"JANOS, CHIH.",1,0,1,0,0,0,
06-ago-15,GRO.,"COYUCA DE BENITEZ, GRO.",1,0,1,0,0,140,
06-ago-15,COAH.,"TORREÓN, COAH.",1,0,1,0,0,0,
06-ago-15,COAH.,"MONCLOVA, COAH.",1,0,1,0,0,20,
06-ago-15,VER.,"MISANTLA, VER.",0,1,1,0,0,0,
06-ago-15,CHIH.,"CUAUHTÉMOC, CHIH.",1,0,1,0,0,0,
07-ago-15,GRO.,"ACAPULCO DE JUAREZ, GRO.",0,1,1,0,0,0,
07-ago-15,GRO.,"COYUCA DE BENITEZ, GRO.",1,0,1,0,0,0,
07-ago-15,ZAC.,"JEREZ, ZAC.",1,0,1,0,0,0,
07-ago-15,OAX.,"OAX. DE JUAREZ, OAX.",1,0,1,1,0,0,
07-ago-15,TAMPS.,"VICTORIA, TAMPS.",1,0,1,0,0,105,
07-ago-15,GRO.,"EDUARDO NERI, GRO.",1,0,1,0,3,10,
07-ago-15,MEX.,"HUEHUETOCA, MEX.",1,0,1,0,0,0,
08-ago-15,ZAC.,"JEREZ, ZAC.",0,1,1,0,0,0,
08-ago-15,JAL.,"TOMATLAN, JAL.",1,0,1,0,0,0,
08-ago-15,DGO.,"GOMEZ PALACIO, DGO.",1,0,1,0,3,0,
08-ago-15,DGO.,"LERDO, DGO.",1,0,1,0,0,0,
09-ago-15,DGO.,"LERDO, DGO.",0,1,1,0,1,2,
09-ago-15,DGO.,"MAPIMI, DGO.",0,1,1,0,0,0,
09-ago-15,JAL.,"TOMATLAN, JAL.",1,0,1,0,0,0,
09-ago-15,TAB.,"BALANCAN, TAB.",0,1,1,0,0,0,
09-ago-15,TAMPS.,"GRO., TAMPS.",1,0,1,0,0,0,
10-ago-15,B.C.S.,"MULEGÉ, B.C.S.",0,1,1,0,0,0,
10-ago-15,SIN.,"MAZATLAN, SIN.",1,0,1,0,0,0,
10-ago-15,VER.,"OZULUAMA DE MASCARE±AS, VER.",0,1,1,0,0,0,
10-ago-15,VER.,"MISANTLA, VER.",0,1,1,0,0,0,
10-ago-15,CHIS.,"BENEMÉRITO DE LAS AMÉRICAS, CHIS.",0,1,1,0,0,0,
10-ago-15,OAX.,"MIAHUATLAN DE PORFIRIO DIAZ, OAX.",1,0,1,0,0,0,
10-ago-15,OAX.,"OAX. DE JUAREZ, OAX.",1,0,1,1,0,2,
10-ago-15,GRO.,"LEONARDO BRAVO, GRO.",1,0,1,0,0,0,
11-ago-15,CHIS.,"BENEMÉRITO DE LAS AMÉRICAS, CHIS.",1,0,1,0,0,0,
11-ago-15,OAX.,"SAN JUAN BAUTISTA TUXTEPEC, OAX.",1,0,1,1,0,0,
11-ago-15,CHIS.,"TONALÁ, CHIS.",1,0,1,0,0,0,
11-ago-15,OAX.,"SANTA MARIA ZACATEPEC, OAX.",0,1,1,0,0,0,
11-ago-15,QRO.,"AMEALCO DE BONFIL, QRO.",0,1,1,0,0,0,
11-ago-15,TAB.,"CENTRO, TAB.",1,0,1,0,0,58,
11-ago-15,COAH.,"MÚZQUIZ, COAH.",0,1,1,0,0,0,
11-ago-15,TAMPS.,"VICTORIA, TAMPS.",0,1,1,3,0,11,
11-ago-15,GRO.,"COAHUAYUTLA DE JOSE MARIA IZAZAGA, GRO.",0,1,1,0,0,0,
12-ago-15,CHIS.,"BENEMÉRITO DE LAS AMÉRICAS, CHIS.",1,0,1,0,0,0,
12-ago-15,COAH.,"MONCLOVA, COAH.",1,0,1,0,0,0,
12-ago-15,COAH.,"MÚZQUIZ, COAH.",0,1,1,0,0,0,
12-ago-15,DGO.,"TLAHUALILO, DGO.",1,0,1,0,0,0,
12-ago-15,GRO.,"PETATLAN, GRO.",0,1,1,0,0,0,
12-ago-15,GRO.,"COAHUAYUTLA DE JOSE MARIA IZAZAGA, GRO.",0,1,1,1,0,1,
12-ago-15,TAMPS.,"NUEVO LAREDO, TAMPS.",1,0,1,5,0,329,
12-ago-15,TAMPS.,"EL MANTE, TAMPS.",1,0,1,0,0,0,
13-ago-15,HGO.,"APAN, HGO.",1,0,1,0,4,0,
13-ago-15,HGO.,"HUEHUETLA, HGO.",1,0,1,0,0,0,
13-ago-15,PUE.,"PUE., PUE.",1,0,1,0,0,26,
13-ago-15,CHIH.,"HGO. DEL PARRAL, CHIH.",1,0,1,0,0,13,
13-ago-15,B.C.S.,"LA PAZ, B.C.S.",1,0,1,0,0,0,
13-ago-15,DGO.,"TLAHUALILO, DGO.",0,1,1,1,0,0,
13-ago-15,CHIH.,"JULIMES, CHIH.",1,0,1,0,0,0,
13-ago-15,CHIH.,"JANOS, CHIH.",1,0,1,0,0,0,
13-ago-15,TLAX.,"TLAX., TLAX.",1,0,1,0,0,0,
13-ago-15,SON.,"CAJEME, SON.",1,0,1,0,0,0,
14-ago-15,VER.,"PAPANTLA, VER.",0,1,1,0,0,93,
14-ago-15,ZAC.,"JEREZ, ZAC.",0,1,1,0,0,0,
14-ago-15,HGO.,"APAN, HGO.",1,0,1,0,0,517,
14-ago-15,GRO.,"COAHUAYUTLA DE JOSE MARIA IZAZAGA, GRO.",0,1,1,0,0,0,
14-ago-15,VER.,"NARANJOS AMATLAN, VER.",1,0,1,0,0,0,
14-ago-15,COAH.,"SABINAS, COAH.",0,1,1,0,0,0,
14-ago-15,TAMPS.,"EL MANTE, TAMPS.",1,0,1,0,0,0,
14-ago-15,PUE.,"PUE., PUE.",1,0,1,1,0,46,
15-ago-15,YUC.,"IZAMAL, YUC.",0,1,1,0,0,0,
15-ago-15,CHIH.,"HGO. DEL PARRAL, CHIH.",1,0,1,0,0,0,
15-ago-15,PUE.,"PUE., PUE.",1,0,1,1,0,0,
15-ago-15,DGO.,"LERDO, DGO.",1,0,1,0,0,0,
15-ago-15,ZAC.,"GUADALUPE, ZAC.",0,1,1,0,0,0,
15-ago-15,TAMPS.,"NUEVO LAREDO, TAMPS.",0,1,1,7,0,637,
15-ago-15,TAMPS.,"EL MANTE, TAMPS.",1,0,1,0,0,0,
16-ago-15,JAL.,"TOMATLAN, JAL.",0,1,1,0,0,0,
16-ago-15,CHIH.,"HGO. DEL PARRAL, CHIH.",1,0,1,0,0,0,
16-ago-15,DGO.,"GOMEZ PALACIO, DGO.",1,0,1,0,0,17,
16-ago-15,DGO.,"TLAHUALILO, DGO.",0,1,1,0,0,0,
16-ago-15,TLAX.,"APIZACO, TLAX.",0,1,1,0,1,0,
16-ago-15,TLAX.,"CALPULALPAN, TLAX.",0,1,1,0,0,0,
16-ago-15,TAB.,"CENTRO, TAB.",1,0,1,0,0,0,
17-ago-15,VER.,"XALAPA, VER.",0,1,1,0,0,0,
17-ago-15,VER.,"JUCHIQUE DE FERRER, VER.",1,0,1,0,0,0,
17-ago-15,OAX.,"SAN JUAN BAUTISTA TUXTEPEC, OAX.",1,0,1,0,0,0,
17-ago-15,COAH.,"MÚZQUIZ, COAH.",0,1,1,0,0,200,
17-ago-15,DGO.,"GOMEZ PALACIO, DGO.",1,0,1,0,0,0,
17-ago-15,DGO.,"TLAHUALILO, DGO.",1,0,1,0,0,0,
18-ago-15,OAX.,"SANTA MARIA ZACATEPEC, OAX.",1,0,1,0,0,0,
18-ago-15,VER.,"PAPANTLA, VER.",0,1,1,0,0,0,
18-ago-15,VER.,"VILLA ALDAMA, VER.",0,1,1,0,0,0,
18-ago-15,CHIS.,"BENEMÉRITO DE LAS AMÉRICAS, CHIS.",1,0,1,0,0,0,
18-ago-15,COAH.,"MÚZQUIZ, COAH.",1,0,1,0,0,0,
18-ago-15,COAH.,"SABINAS, COAH.",0,1,1,0,0,0,
18-ago-15,COAH.,"ACUÑA, COAH.",0,1,1,3,0,0,
18-ago-15,TAMPS.,"TAMPICO, TAMPS.",1,0,1,0,0,0,
18-ago-15,ZAC.,"GUADALUPE, ZAC.",0,1,1,0,0,107,
18-ago-15,MEX.,"IXTAPAN DE LA SAL, MEX.",1,0,1,1,0,0,
19-ago-15,SON.,"CAJEME, SON.",1,0,1,0,0,300,
19-ago-15,COAH.,"RAMOS ARIZPE, COAH.",0,1,1,0,0,0,
19-ago-15,HGO.,"EMILIANO ZAPATA, HGO.",1,0,1,0,0,0,
19-ago-15,MEX.,"IXTAPAN DE LA SAL, MEX.",1,0,1,0,0,0,
19-ago-15,TLAX.,"TLAX., TLAX.",1,0,1,2,0,0,
19-ago-15,PUE.,"PUE., PUE.",1,0,1,1,0,0,
19-ago-15,OAX.,"PINOTEPA DE DON LUIS, OAX.",1,0,1,3,0,0,
19-ago-15,DGO.,"LERDO, DGO.",0,1,1,1,0,0,
19-ago-15,TAMPS.,"EL MANTE, TAMPS.",1,0,1,1,0,50,
20-ago-15,TAMPS.,"EL MANTE, TAMPS.",0,1,1,1,0,0,
20-ago-15,SON.,"CAJEME, SON.",1,0,1,0,0,500,
20-ago-15,TAMPS.,"MIER, TAMPS.",0,1,1,0,0,0,
20-ago-15,DGO.,"LERDO, DGO.",1,0,1,1,0,0,
20-ago-15,DGO.,"TLAHUALILO, DGO.",0,1,1,0,0,0,
20-ago-15,COAH.,"ACUÑA, COAH.",1,0,1,0,0,0,
20-ago-15,MEX.,"IXTAPAN DE LA SAL, MEX.",1,0,1,1,0,0,
20-ago-15,TLAX.,"TLAX., TLAX.",1,0,1,0,0,0,
20-ago-15,CHIH.,"CASAS GRANDES, CHIH.",1,0,1,0,0,9,
20-ago-15,COAH.,"SABINAS, COAH.",0,1,1,0,0,0,
20-ago-15,COAH.,"RAMOS ARIZPE, COAH.",1,0,1,0,0,0,
20-ago-15,COAH.,"ACUÑA, COAH.",1,0,1,1,0,0,
20-ago-15,CAMP.,"CAMP., CAMP.",1,0,1,0,0,0,
20-ago-15,GRO.,"TECPAN DE GALEANA, GRO.",0,1,1,0,0,0,
20-ago-15,VER.,"PAPANTLA, VER.",0,1,1,0,0,0,
21-ago-15,VER.,"NARANJOS AMATLAN, VER.",0,1,1,0,0,0,
21-ago-15,VER.,"TANTOYUCA, VER.",0,1,1,0,0,0,
21-ago-15,OAX.,"PINOTEPA DE DON LUIS, OAX.",1,0,1,3,0,0,
21-ago-15,TAB.,"BALANCAN, TAB.",0,1,1,0,0,0,
21-ago-15,CHIS.,"TAPACHULA, CHIS.",1,0,1,0,0,47,
21-ago-15,CHIH.,"NUEVO CASAS GRANDES, CHIH.",1,0,1,0,0,50,
22-ago-15,VER.,"NARANJOS AMATLAN, VER.",0,1,1,1,0,0,
22-ago-15,VER.,"TEMPOAL, VER.",1,0,1,0,0,0,
22-ago-15,GRO.,"TECPAN DE GALEANA, GRO.",0,1,1,0,0,0,
22-ago-15,TAMPS.,"VICTORIA, TAMPS.",1,0,1,0,0,103,
23-ago-15,DGO.,"LERDO, DGO.",1,0,1,0,0,0,
23-ago-15,TLAX.,"TLAX., TLAX.",1,0,1,0,0,0,
23-ago-15,CHIH.,"HGO. DEL PARRAL, CHIH.",1,0,1,0,0,0,
24-ago-15,MEX.,"MEXICALTZINGO, MEX.",1,0,1,0,0,0,
24-ago-15,DGO.,"GOMEZ PALACIO, DGO.",0,1,1,1,0,0,
24-ago-15,TLAX.,"TLAX., TLAX.",0,1,1,0,0,0,
24-ago-15,CHIS.,"BENEMÉRITO DE LAS AMÉRICAS, CHIS.",1,0,1,0,0,0,
24-ago-15,TAB.,"CARDENAS, TAB.",0,1,1,1,0,0,
24-ago-15,VER.,"TUXPAM, VER.",1,0,1,0,0,0,
24-ago-15,CHIH.,"NUEVO CASAS GRANDES, CHIH.",1,0,1,0,0,0,
24-ago-15,QRO.,"CORREGIDORA, QRO.",1,0,1,0,0,0,
24-ago-15,SON.,"HERMOSILLO, SON.",1,0,1,0,0,0,
24-ago-15,SON.,"CAJEME, SON.",1,0,1,0,0,0,
24-ago-15,DGO.,"LERDO, DGO.",0,1,1,0,0,0,
24-ago-15,DGO.,"MAPIMI, DGO.",1,0,1,0,0,0,
25-ago-15,COL.,"TECOMÁN, COL.",1,0,1,0,0,0,
25-ago-15,VER.,"TUXPAM, VER.",1,0,1,0,0,0,
25-ago-15,VER.,"NARANJOS AMATLAN, VER.",1,0,1,2,0,0,
25-ago-15,TAB.,"CENTRO, TAB.",1,0,1,0,0,0,
25-ago-15,DGO.,"LERDO, DGO.",1,0,1,0,0,0,
25-ago-15,DGO.,"TLAHUALILO, DGO.",0,1,1,0,0,0,
25-ago-15,MEX.,"MEXICALTZINGO, MEX.",0,1,1,0,0,0,
26-ago-15,VER.,"TIHUATLAN, VER.",0,1,1,0,0,0,
26-ago-15,VER.,"CAMERINO Z. MENDOZA, VER.",1,0,1,0,0,0,
26-ago-15,TAB.,"BALANCAN, TAB.",0,1,1,0,0,0,
26-ago-15,CHIH.,"HGO. DEL PARRAL, CHIH.",1,0,1,0,0,0,
26-ago-15,OAX.,"SANTIAGO JAMILTEPEC, OAX.",1,0,1,4,0,0,
26-ago-15,COAH.,"TORREÓN, COAH.",1,0,1,0,0,35,
26-ago-15,N.L.,"GARCIA, N.L.",1,0,1,0,2,98,
26-ago-15,TAMPS.,"MIER, TAMPS.",0,1,1,0,0,0,
26-ago-15,TAMPS.,"RIO BRAVO, TAMPS.",1,0,1,0,0,0,
26-ago-15,B.C.,"TIJUANA, B.C.",1,0,1,0,0,0,
26-ago-15,SON.,"CAJEME, SON.",0,1,1,0,0,122,
26-ago-15,ZAC.,"JEREZ, ZAC.",0,1,1,0,0,0,
26-ago-15,PUE.,"PUE., PUE.",1,0,1,0,0,0,
26-ago-15,B.C.S.,"COMONDÚ, B.C.S.",0,1,1,0,0,0,
26-ago-15,VER.,"CAMERINO Z. MENDOZA, VER.",1,0,1,0,0,0,
26-ago-15,TAB.,"BALANCAN, TAB.",0,1,1,0,0,0,
27-ago-15,COAH.,"RAMOS ARIZPE, COAH.",1,0,1,0,0,0,
27-ago-15,COAH.,"ACUÑA, COAH.",1,0,1,0,0,0,
27-ago-15,QRO.,"CORREGIDORA, QRO.",1,0,1,0,0,0,
27-ago-15,VER.,"TUXPAM, VER.",1,0,1,0,0,0,
27-ago-15,CHIH.,"HGO. DEL PARRAL, CHIH.",0,1,1,0,0,30,
27-ago-15,PUE.,"PUE., PUE.",0,1,1,0,0,0,
27-ago-15,MEX.,"SAN MATEO ATENCO, MEX.",1,0,1,1,0,0,
28-ago-15,COAH.,"MÚZQUIZ, COAH.",1,0,1,0,1,0,
28-ago-15,OAX.,"SANTIAGO JAMILTEPEC, OAX.",0,1,1,0,0,0,
28-ago-15,CHIS.,"BENEMÉRITO DE LAS AMÉRICAS, CHIS.",1,0,1,0,0,0,
28-ago-15,TAB.,"JONUTA, TAB.",1,0,1,0,0,0,
28-ago-15,VER.,"ALAMO, VER.",0,1,1,0,0,0,
28-ago-15,CHIH.,"GUADALUPE, CHIH.",1,0,1,0,0,0,
28-ago-15,PUE.,"PUE., PUE.",1,0,1,0,0,0,
28-ago-15,TAB.,"CENTRO, TAB.",1,0,1,0,0,0,
28-ago-15,DGO.,"LERDO, DGO.",0,1,1,0,0,0,
29-ago-15,TAB.,"CENTRO, TAB.",1,0,1,0,0,0,
29-ago-15,GRO.,"PUNGARABATO, GRO.",1,0,1,0,0,0,
29-ago-15,ZAC.,"ZAC., ZAC.",1,0,1,0,0,0,
29-ago-15,GRO.,"ACAPULCO DE JUAREZ, GRO.",1,0,1,0,0,0,
29-ago-15,N.L.,"MONTERREY, N.L.",1,0,1,0,0,350,
30-ago-15,TAMPS.,"MIGUEL ALEMAN, TAMPS.",0,1,1,0,0,0,
31-ago-15,DGO.,"DGO., DGO.",1,0,1,0,0,0,
31-ago-15,CHIH.,"GUADALUPE, CHIH.",1,0,1,0,0,8,
31-ago-15,SIN.,"CULIACAN, SIN.",0,1,1,0,0,0,
31-ago-15,COAH.,"PIEDRAS NEGRAS, COAH.",1,0,1,0,0,0,
31-ago-15,TAB.,"TENOSIQUE, TAB.",1,0,1,0,0,0,
31-ago-15,GRO.,"PUNGARABATO, GRO.",1,0,1,0,0,0,
31-ago-15,GRO.,"GENERAL HELIODORO CASTILLO, GRO.",0,1,1,0,0,0,
31-ago-15,VER.,"ALAMO, VER.",1,0,1,0,0,0,
31-ago-15,VER.,"TANTOYUCA, VER.",0,1,1,0,0,0,
31-ago-15,COL.,"TECOMÁN, COL.",1,0,1,0,0,0,
31-ago-15,MEX.,"COACALCO DE BERRIOZABAL, MEX.",1,0,1,0,5,0,
01-sep-15,COAH.,"MÚZQUIZ, COAH.",0,1,1,0,0,0,
01-sep-15,COAH.,"ACUÑA, COAH.",1,0,1,0,0,10,
01-sep-15,OAX.,"MIAHUATLAN DE PORFIRIO DIAZ, OAX.",0,1,1,0,0,0,
01-sep-15,CHIS.,"BENEMÉRITO DE LAS AMÉRICAS, CHIS.",0,1,1,0,0,0,
01-sep-15,N.L.,"GRAL. ESCOBEDO, N.L.",1,0,1,0,0,0,
01-sep-15,SIN.,"ANGOSTURA, SIN.",1,0,1,0,0,0,
01-sep-15,SIN.,"CULIACAN, SIN.",0,1,1,0,5,0,
02-sep-15,VER.,"PAPANTLA, VER.",1,0,1,2,0,50,
02-sep-15,OAX.,"MIAHUATLAN DE PORFIRIO DIAZ, OAX.",1,0,1,4,0,139,
02-sep-15,GRO.,"TLAPEHUALA, GRO.",1,0,1,0,0,0,
02-sep-15,CHIH.,"HGO. DEL PARRAL, CHIH.",1,0,1,0,0,100,
02-sep-15,GRO.,"ZIHUATANEJO DE AZUETA, GRO.",1,0,1,0,0,0,
02-sep-15,TAMPS.,"VICTORIA, TAMPS.",1,0,1,0,0,170,
02-sep-15,TAMPS.,"EL MANTE, TAMPS.",1,0,1,0,0,110,
02-sep-15,CHIH.,"NUEVO CASAS GRANDES, CHIH.",1,0,1,0,0,6,
02-sep-15,N.L.,"MONTERREY, N.L.",0,1,1,29,0,1150,
02-sep-15,N.L.,"GRAL. ESCOBEDO, N.L.",1,0,1,1,0,0,
02-sep-15,SON.,"HERMOSILLO, SON.",1,0,1,0,0,0,
02-sep-15,SON.,"CAJEME, SON.",1,0,1,0,0,0,
02-sep-15,COAH.,"RAMOS ARIZPE, COAH.",1,0,1,0,0,0,
03-sep-15,VER.,"TIERRA BLANCA, VER.",0,1,1,0,0,0,
03-sep-15,OAX.,"SALINA CRUZ, OAX.",0,1,1,0,0,0,
03-sep-15,DGO.,"TLAHUALILO, DGO.",0,1,1,0,0,0,
03-sep-15,COL.,"COL., COL.",1,0,1,0,0,0,
03-sep-15,MEX.,"HUIXQUILUCAN, MEX.",1,0,1,0,0,0,
03-sep-15,GRO.,"ZIHUATANEJO DE AZUETA, GRO.",1,0,1,0,0,41,
03-sep-15,N.L.,"MONTERREY, N.L.",0,1,1,117,0,450,
03-sep-15,N.L.,"GRAL. ESCOBEDO, N.L.",0,1,1,0,0,0,
03-sep-15,N.L.,"SANTA CATARINA, N.L.",0,1,1,0,0,0,
03-sep-15,N.L.,"GARCIA, N.L.",0,1,1,0,0,0,
03-sep-15,TLAX.,"TLAX., TLAX.",1,0,1,0,0,0,
03-sep-15,COAH.,"SABINAS, COAH.",1,0,1,0,0,0,
03-sep-15,TAB.,"CENTLA, TAB.",1,0,1,0,0,0,
04-sep-15,TAB.,"CARDENAS, TAB.",1,0,1,1,0,15,
04-sep-15,SON.,"HERMOSILLO, SON.",0,1,1,0,0,0,
04-sep-15,AGS.,"JESÚS MARÍA, AGS.",1,0,1,98,0,1,
04-sep-15,ZAC.,"JEREZ, ZAC.",1,0,1,0,0,0,
04-sep-15,DGO.,"DGO., DGO.",1,0,1,47,0,0,
04-sep-15,SIN.,"ROSARIO, SIN.",1,0,1,0,0,0,
04-sep-15,SIN.,"COSALA, SIN.",1,0,1,0,0,0,
04-sep-15,MEX.,"ATIZAPAN DE ZARAGOZA, MEX.",0,1,1,0,1,0,
05-sep-15,N.L.,"GRAL. ESCOBEDO, N.L.",1,0,1,0,0,0,
05-sep-15,N.L.,"GARCIA, N.L.",1,0,1,31,0,119,
05-sep-15,TLAX.,"EL CARMEN TEQUEXQUITLA, TLAX.",1,0,1,0,0,0,
05-sep-15,DGO.,"TLAHUALILO, DGO.",0,1,1,0,0,0,
05-sep-15,MEX.,"COACALCO DE BERRIOZABAL, MEX.",1,0,1,0,4,0,
05-sep-15,TAMPS.,"VICTORIA, TAMPS.",1,0,1,0,0,17,
05-sep-15,COAH.,"MONCLOVA, COAH.",1,0,1,0,0,0,
05-sep-15,B.C.,"ENSENADA, B.C.",1,0,1,0,0,0,
06-sep-15,TLAX.,"EL CARMEN TEQUEXQUITLA, TLAX.",1,0,1,0,0,0,
06-sep-15,GRO.,"ZIHUATANEJO DE AZUETA, GRO.",0,1,1,0,0,0,
06-sep-15,N.L.,"MONTERREY, N.L.",0,1,1,6,0,7000,
06-sep-15,N.L.,"SANTA CATARINA, N.L.",1,0,1,0,0,0,
06-sep-15,DGO.,"GOMEZ PALACIO, DGO.",0,1,1,0,0,0,
06-sep-15,B.C.,"MEXICALI, B.C.",0,1,1,0,0,0,
07-sep-15,VER.,"JAMAPA, VER.",1,0,1,0,0,0,
07-sep-15,SIN.,"ANGOSTURA, SIN.",0,1,1,0,0,0,
07-sep-15,COL.,"COL., COL.",0,1,1,0,0,0,
07-sep-15,OAX.,"MIAHUATLAN DE PORFIRIO DIAZ, OAX.",0,1,1,2,0,123,
07-sep-15,DGO.,"TLAHUALILO, DGO.",1,0,1,0,0,0,
07-sep-15,AGS.,"JESÚS MARÍA, AGS.",1,0,1,0,0,79,
07-sep-15,CHIH.,"ASCENSIÓN, CHIH.",0,1,1,0,0,0,
07-sep-15,N.L.,"GRAL. ESCOBEDO, N.L.",0,1,1,0,0,100,
07-sep-15,N.L.,"SANTA CATARINA, N.L.",0,1,1,3,0,0,
08-sep-15,VER.,"JAMAPA, VER.",1,0,1,0,0,0,
08-sep-15,HGO.,"MIXQUIAHUALA DE JUAREZ, HGO.",1,0,1,0,0,0,
08-sep-15,CHIH.,"ASCENSIÓN, CHIH.",1,0,1,0,0,0,
08-sep-15,PUE.,"PUE., PUE.",1,0,1,0,0,24,
08-sep-15,SIN.,"CULIACAN, SIN.",0,1,1,0,10,0,
09-sep-15,VER.,"PEROTE, VER.",1,0,1,0,0,0,
09-sep-15,TAB.,"BALANCAN, TAB.",0,1,1,0,0,0,
09-sep-15,N.L.,"MONTERREY, N.L.",1,0,1,6,0,450,
09-sep-15,N.L.,"GRAL. ESCOBEDO, N.L.",1,0,1,0,0,0,
09-sep-15,TAMPS.,"TAMPICO, TAMPS.",1,0,1,4,0,0,
09-sep-15,S.L.P.,"CIUDAD VALLES, S.L.P.",1,0,1,0,0,0,
09-sep-15,SIN.,"ROSARIO, SIN.",1,0,1,0,2,0,
09-sep-15,SIN.,"ANGOSTURA, SIN.",0,1,1,0,0,0,
09-sep-15,SIN.,"CULIACAN, SIN.",1,0,1,0,3,0,
09-sep-15,TLAX.,"TLAX., TLAX.",0,1,1,0,0,0,
09-sep-15,COAH.,"MÚZQUIZ, COAH.",1,0,1,0,1,0,
09-sep-15,MEX.,"TULTITLAN, MEX.",1,0,1,0,0,0,
10-sep-15,DGO.,"TLAHUALILO, DGO.",1,0,1,0,0,0,
10-sep-15,N.L.,"GRAL. ESCOBEDO, N.L.",1,0,1,0,0,2850,
10-sep-15,SIN.,"ROSARIO, SIN.",0,1,1,0,0,0,
10-sep-15,SIN.,"SAN IGNACIO, SIN.",1,0,1,1,0,0,
10-sep-15,SIN.,"CULIACAN, SIN.",0,1,1,0,1,0,
10-sep-15,SIN.,"COSALA, SIN.",0,1,1,0,0,0,
10-sep-15,B.C.,"ENSENADA, B.C.",0,1,1,0,0,0,
10-sep-15,MEX.,"CHAPULTEPEC, MEX.",1,0,1,0,0,41,
11-sep-15,SIN.,"ANGOSTURA, SIN.",1,0,1,0,0,0,
11-sep-15,SIN.,"SAN IGNACIO, SIN.",1,0,1,0,0,0,
11-sep-15,SIN.,"CULIACAN, SIN.",0,1,1,0,29,0,
11-sep-15,TLAX.,"HUAMANTLA, TLAX.",1,0,1,0,0,0,
11-sep-15,OAX.,"MIAHUATLAN DE PORFIRIO DIAZ, OAX.",0,1,1,3,0,479,
11-sep-15,S.L.P.,"RIOVERDE, S.L.P.",1,0,1,0,0,0,
11-sep-15,COAH.,"MONCLOVA, COAH.",1,0,1,0,0,0,
11-sep-15,COAH.,"ACUÑA, COAH.",0,1,1,0,0,0,
11-sep-15,AGS.,"JESÚS MARÍA, AGS.",1,0,1,0,0,0,
11-sep-15,ZAC.,"JEREZ, ZAC.",1,0,1,0,0,0,
11-sep-15,N.L.,"SANTA CATARINA, N.L.",1,0,1,10,0,2500,
11-sep-15,MEX.,"CHAPULTEPEC, MEX.",1,0,1,1,0,0,
12-sep-15,SON.,"CAJEME, SON.",1,0,1,0,0,0,
12-sep-15,MEX.,"CHAPULTEPEC, MEX.",1,0,1,1,0,0,
12-sep-15,ZAC.,"JEREZ, ZAC.",1,0,1,0,0,0,
12-sep-15,B.C.,"ENSENADA, B.C.",1,0,1,0,0,0,
12-sep-15,COAH.,"MONCLOVA, COAH.",1,0,1,0,0,21,
12-sep-15,CHIH.,"CHIH., CHIH.",1,0,1,0,0,0,
13-sep-15,CHIH.,"HGO. DEL PARRAL, CHIH.",1,0,1,0,0,0,
13-sep-15,TLAX.,"HUAMANTLA, TLAX.",0,1,1,0,0,0,
13-sep-15,GRO.,"COPANATOYAC, GRO.",1,0,1,0,0,0,
14-sep-15,OAX.,"MIAHUATLAN DE PORFIRIO DIAZ, OAX.",1,0,1,1,0,37,
14-sep-15,CHIH.,"HGO. DEL PARRAL, CHIH.",1,0,1,0,0,0,
14-sep-15,COAH.,"ACUÑA, COAH.",0,1,1,0,0,0,
14-sep-15,DGO.,"MAPIMI, DGO.",1,0,1,0,0,0,
14-sep-15,SON.,"HERMOSILLO, SON.",0,1,1,0,0,0,
15-sep-15,TLAX.,"TLAXCO, TLAX.",0,1,1,0,0,0,
15-sep-15,B.C.,"ENSENADA, B.C.",0,1,1,0,0,0,
16-sep-15,N.L.,"MONTERREY, N.L.",1,0,1,22,0,100,
16-sep-15,B.C.,"TIJUANA, B.C.",0,1,1,0,0,0,
17-sep-15,DGO.,"TLAHUALILO, DGO.",0,1,1,0,0,0,
17-sep-15,TLAX.,"TLAXCO, TLAX.",1,0,1,0,0,0,
17-sep-15,OAX.,"CIUDAD IXTEPEC, OAX.",1,0,1,0,0,0,
18-sep-15,VER.,"PUEBLO VIEJO, VER.",1,0,1,0,0,0,
18-sep-15,OAX.,"MIAHUATLAN DE PORFIRIO DIAZ, OAX.",1,0,1,1,0,0,
18-sep-15,TLAX.,"TLAX., TLAX.",0,1,1,0,0,0,
18-sep-15,QRO.,"QUERETARO, QRO.",0,1,1,0,0,0,
18-sep-15,GRO.,"OLINALA, GRO.",1,0,1,0,0,0,
18-sep-15,TAMPS.,"ALTAMIRA, TAMPS.",1,0,1,0,0,33,
18-sep-15,DGO.,"LERDO, DGO.",0,1,1,0,0,0,
18-sep-15,N.L.,"MONTERREY, N.L.",0,1,1,9,0,167,
18-sep-15,COAH.,"MÚZQUIZ, COAH.",0,1,1,0,0,0,
19-sep-15,TLAX.,"TLAX., TLAX.",0,1,1,0,0,0,
19-sep-15,DGO.,"TLAHUALILO, DGO.",0,1,1,0,0,0,
19-sep-15,N.L.,"MONTERREY, N.L.",1,0,1,50,0,0,
19-sep-15,QRO.,"QUERETARO, QRO.",1,0,1,0,0,0,
20-sep-15,TLAX.,"TLAX., TLAX.",1,0,1,1,0,3,
20-sep-15,N.L.,"MONTERREY, N.L.",0,1,1,2,0,1065,
20-sep-15,QRO.,"QUERETARO, QRO.",1,0,1,0,1,0,
21-sep-15,TLAX.,"TLAXCO, TLAX.",1,0,1,0,0,0,
21-sep-15,GRO.,"BENITO JUAREZ, GRO.",1,0,1,0,0,30,
21-sep-15,GRO.,"OLINALA, GRO.",0,1,1,0,0,0,
21-sep-15,COAH.,"ACUÑA, COAH.",1,0,1,0,0,0,
21-sep-15,SIN.,"SAN IGNACIO, SIN.",1,0,1,0,0,0,
21-sep-15,SIN.,"COSALA, SIN.",0,1,1,0,0,0,
22-sep-15,COAH.,"MÚZQUIZ, COAH.",1,0,1,0,0,0,
22-sep-15,COAH.,"ACUÑA, COAH.",0,1,1,0,0,0,
22-sep-15,TLAX.,"TLAX., TLAX.",1,0,1,0,0,0,
23-sep-15,SIN.,"ANGOSTURA, SIN.",1,0,1,0,0,0,
23-sep-15,TLAX.,"TLAX., TLAX.",1,0,1,1,0,0,
23-sep-15,TLAX.,"TLAXCO, TLAX.",1,0,1,0,0,0,
23-sep-15,COAH.,"MONCLOVA, COAH.",1,0,1,0,0,40,
23-sep-15,COAH.,"ACUÑA, COAH.",1,0,1,0,0,0,
23-sep-15,DGO.,"LERDO, DGO.",0,1,1,0,0,0,
23-sep-15,DGO.,"TLAHUALILO, DGO.",1,0,1,0,0,0,
23-sep-15,MEX.,"TEZOYUCA, MEX.",1,0,1,0,0,0,
24-sep-15,SIN.,"ROSARIO, SIN.",0,1,1,0,0,0,
24-sep-15,SIN.,"ANGOSTURA, SIN.",0,1,1,0,0,0,
24-sep-15,COAH.,"ACUÑA, COAH.",0,1,1,0,0,2,
24-sep-15,VER.,"PUEBLO VIEJO, VER.",1,0,1,0,0,0,
24-sep-15,TLAX.,"TLAX., TLAX.",1,0,1,0,0,0,
25-sep-15,OAX.,"SALINA CRUZ, OAX.",1,0,1,0,0,0,
25-sep-15,VER.,"ALVARADO, VER.",1,0,1,0,0,0,
25-sep-15,GRO.,"ARCELIA, GRO.",1,0,1,0,0,0,
25-sep-15,COL.,"COL., COL.",1,0,1,0,1,4,
25-sep-15,ZAC.,"JEREZ, ZAC.",1,0,1,0,0,0,
25-sep-15,DGO.,"GOMEZ PALACIO, DGO.",1,0,1,0,0,0,
25-sep-15,COAH.,"MONCLOVA, COAH.",1,0,1,0,0,0,
25-sep-15,SON.,"HERMOSILLO, SON.",1,0,1,39,0,0,
25-sep-15,SIN.,"ANGOSTURA, SIN.",0,1,1,0,0,0,
25-sep-15,SIN.,"SAN IGNACIO, SIN.",0,1,1,0,0,0,
26-sep-15,SON.,"CAJEME, SON.",1,0,1,0,0,0,
26-sep-15,MEX.,"TENANGO DEL VALLE, MEX.",0,1,1,0,1,0,
26-sep-15,TAMPS.,"ALTAMIRA, TAMPS.",1,0,1,0,0,58,
26-sep-15,TLAX.,"TLAXCO, TLAX.",1,0,1,0,0,0,
26-sep-15,COAH.,"MONCLOVA, COAH.",1,0,1,1,0,27,
27-sep-15,CHIH.,"HGO. DEL PARRAL, CHIH.",1,0,1,0,0,0,
28-sep-15,SIN.,"ELOTA, SIN.",0,1,1,0,10,0,
28-sep-15,MEX.,"NICOLAS ROMERO, MEX.",0,1,1,1,0,0,
28-sep-15,CHIS.,"BENEMÉRITO DE LAS AMÉRICAS, CHIS.",1,0,1,0,0,0,
29-sep-15,CHIH.,"HGO. DEL PARRAL, CHIH.",1,0,1,0,0,0,
29-sep-15,VER.,"TANTOYUCA, VER.",0,1,1,0,0,0,
29-sep-15,TLAX.,"NATIVITAS, TLAX.",0,1,1,0,0,0,
29-sep-15,DGO.,"DGO., DGO.",1,0,1,0,0,0,
29-sep-15,GRO.,"FLORENCIO VILLARREAL, GRO.",1,0,1,0,0,0,
29-sep-15,COAH.,"RAMOS ARIZPE, COAH.",1,0,1,0,0,0,
29-sep-15,SIN.,"ELOTA, SIN.",1,0,1,0,6,0,
29-sep-15,B.C.,"ENSENADA, B.C.",1,0,1,0,0,0,
29-sep-15,MEX.,"OCOYOACAC, MEX.",0,1,1,1,0,0,
29-sep-15,TAMPS.,"MATAMOROS, TAMPS.",0,1,1,0,0,0,
30-sep-15,GRO.,"FLORENCIO VILLARREAL, GRO.",1,0,1,0,0,0,
30-sep-15,TLAX.,"TLAX., TLAX.",1,0,1,0,0,0,
30-sep-15,TAB.,"BALANCAN, TAB.",0,1,1,0,0,0,
30-sep-15,HGO.,"TULANCINGO DE BRAVO, HGO.",0,1,1,0,0,0,
30-sep-15,COAH.,"ACUÑA, COAH.",0,1,1,0,0,0,
30-sep-15,MEX.,"TEPOTZOTLAN, MEX.",1,0,1,0,0,0,
30-sep-15,TAB.,"HUIMANGUILLO, TAB.",1,0,1,0,0,0,
01-oct-15,SIN.,"ELOTA, SIN.",0,1,1,0,0,0,
01-oct-15,MEX.,"TEPOTZOTLAN, MEX.",1,0,1,0,0,0,
02-oct-15,GRO.,"SAN MIGUEL TOTOLAPAN, GRO.",0,1,1,0,0,0,
02-oct-15,SIN.,"ESCUINAPA, SIN.",0,1,1,0,0,0,
02-oct-15,SIN.,"NAVOLATO, SIN.",0,1,1,0,11,0,
02-oct-15,DGO.,"LERDO, DGO.",0,1,1,0,1,0,
02-oct-15,SON.,"HERMOSILLO, SON.",1,0,1,2,0,0,
02-oct-15,TLAX.,"TLAX., TLAX.",1,0,1,0,0,0,
02-oct-15,COAH.,"PIEDRAS NEGRAS, COAH.",0,1,1,0,0,0,
02-oct-15,COAH.,"RAMOS ARIZPE, COAH.",0,1,1,0,0,0,
03-oct-15,HGO.,"HUICHAPAN, HGO.",0,1,1,0,0,0,
03-oct-15,TLAX.,"ZACATELCO, TLAX.",0,1,1,0,0,0,
03-oct-15,MEX.,"TEPOTZOTLAN, MEX.",1,0,1,0,0,0,
03-oct-15,N.L.,"ABASOLO, N.L.",1,0,1,6,0,0,
03-oct-15,GRO.,"SAN MIGUEL TOTOLAPAN, GRO.",0,1,1,0,0,0,
04-oct-15,TLAX.,"TLAX., TLAX.",1,0,1,0,0,0,
04-oct-15,GRO.,"SAN MIGUEL TOTOLAPAN, GRO.",0,1,1,0,0,0,
04-oct-15,GRO.,"HUAMUXTITLAN, GRO.",1,0,1,0,0,0,
05-oct-15,SIN.,"ELOTA, SIN.",0,1,1,0,0,0,
05-oct-15,COAH.,"SABINAS, COAH.",1,0,1,0,0,0,
05-oct-15,DGO.,"DGO., DGO.",1,0,1,1,0,0,
06-oct-15,OAX.,"CIUDAD IXTEPEC, OAX.",1,0,1,1,0,7,
06-oct-15,SIN.,"BADIRAGUATO, SIN.",0,1,1,0,0,0,
06-oct-15,GRO.,"HUAMUXTITLAN, GRO.",1,0,1,0,0,0,
06-oct-15,SON.,"CAJEME, SON.",1,0,1,0,0,0,
06-oct-15,COAH.,"TORREÓN, COAH.",1,0,1,0,0,0,
06-oct-15,TLAX.,"APIZACO, TLAX.",0,1,1,0,0,0,
06-oct-15,TLAX.,"ZACATELCO, TLAX.",1,0,1,0,0,0,
07-oct-15,COAH.,"MONCLOVA, COAH.",1,0,1,1,0,6,
07-oct-15,VER.,"IGNACIO DE LA LLAVE, VER.",1,0,1,0,0,0,
07-oct-15,VER.,"MARTINEZ DE LA TORRE, VER.",1,0,1,0,0,0,
07-oct-15,ZAC.,"ZAC., ZAC.",0,1,1,0,0,0,
07-oct-15,CHIH.,"OJINAGA, CHIH.",1,0,1,0,0,0,
07-oct-15,SON.,"HERMOSILLO, SON.",1,0,1,0,0,0,
07-oct-15,COL.,"COL., COL.",1,0,1,0,0,0,
07-oct-15,MEX.,"TONANITLA, MEX.",0,1,1,0,0,0,
08-oct-15,COAH.,"PIEDRAS NEGRAS, COAH.",0,1,1,0,0,0,
08-oct-15,TAMPS.,"NUEVO LAREDO, TAMPS.",0,1,1,0,0,158,
08-oct-15,MEX.,"ATIZAPAN, MEX.",0,1,1,0,0,124,
08-oct-15,PUE.,"PUE., PUE.",0,1,1,0,0,0,
08-oct-15,VER.,"MARTINEZ DE LA TORRE, VER.",0,1,1,0,0,0,
09-oct-15,HGO.,"TULANCINGO DE BRAVO, HGO.",0,1,1,0,0,466,
09-oct-15,YUC.,"UMAN, YUC.",1,0,1,0,0,0,
09-oct-15,DGO.,"DGO., DGO.",1,0,1,5,0,0,
09-oct-15,TAB.,"BALANCAN, TAB.",1,0,1,0,0,0,
09-oct-15,MEX.,"TONANITLA, MEX.",1,0,1,1,0,0,
09-oct-15,COAH.,"SABINAS, COAH.",0,1,1,0,0,0,
09-oct-15,DGO.,"MAPIMI, DGO.",0,1,1,0,0,0,
09-oct-15,SON.,"CAJEME, SON.",1,0,1,0,0,60,
09-oct-15,S.L.P.,"CIUDAD VALLES, S.L.P.",0,1,1,0,0,0,
09-oct-15,SIN.,"ELOTA, SIN.",0,1,1,0,0,0,
09-oct-15,TLAX.,"APIZACO, TLAX.",0,1,1,0,0,0,
09-oct-15,TLAX.,"ZACATELCO, TLAX.",0,1,1,0,0,0,
09-oct-15,GRO.,"COYUCA DE CATALAN, GRO.",1,0,1,0,0,0,
10-oct-15,HGO.,"HUICHAPAN, HGO.",0,1,1,0,0,200,
10-oct-15,B.C.,"ENSENADA, B.C.",0,1,1,0,0,0,
11-oct-15,MEX.,"TONANITLA, MEX.",1,0,1,0,0,0,
12-oct-15,HGO.,"IXMIQUILPAN, HGO.",1,0,1,0,1,0,
12-oct-15,SIN.,"NAVOLATO, SIN.",0,1,1,0,12,0,
12-oct-15,COAH.,"TORREÓN, COAH.",1,0,1,0,0,0,
12-oct-15,COAH.,"MÚZQUIZ, COAH.",0,1,1,3,0,0,
12-oct-15,GRO.,"COYUCA DE BENITEZ, GRO.",1,0,1,1,0,0,
12-oct-15,VER.,"MARTINEZ DE LA TORRE, VER.",1,0,1,0,0,0,
13-oct-15,SIN.,"ELOTA, SIN.",0,1,1,0,5,0,
13-oct-15,TAB.,"BALANCAN, TAB.",0,1,1,0,0,0,
13-oct-15,COAH.,"MONCLOVA, COAH.",1,0,1,0,0,0,
13-oct-15,COAH.,"SABINAS, COAH.",1,0,1,0,0,0,
13-oct-15,COAH.,"ACUÑA, COAH.",1,0,1,0,0,0,
13-oct-15,GRO.,"ATOYAC DE ALVAREZ, GRO.",1,0,1,0,1,0,
13-oct-15,SON.,"HERMOSILLO, SON.",1,0,1,0,0,0,
13-oct-15,N.L.,"CARMEN, N.L.",1,0,1,0,0,0,
14-oct-15,N.L.,"CARMEN, N.L.",0,1,1,0,0,0,
14-oct-15,CHIH.,"NUEVO CASAS GRANDES, CHIH.",1,0,1,0,0,0,
14-oct-15,CHIH.,"HGO. DEL PARRAL, CHIH.",0,1,1,0,0,0,
15-oct-15,HGO.,"HUAUTLA, HGO.",0,1,1,0,0,0,
15-oct-15,SIN.,"NAVOLATO, SIN.",1,0,1,0,0,0,
15-oct-15,MEX.,"SAN ANTONIO LA ISLA, MEX.",0,1,1,0,0,0,
16-oct-15,HGO.,"IXMIQUILPAN, HGO.",0,1,1,0,0,0,
16-oct-15,HGO.,"HUAUTLA, HGO.",1,0,1,0,0,0,
16-oct-15,HGO.,"ZEMPOALA, HGO.",1,0,1,0,0,0,
16-oct-15,SIN.,"ELOTA, SIN.",1,0,1,0,6,0,
16-oct-15,GRO.,"PUNGARABATO, GRO.",1,0,1,0,0,0,
16-oct-15,YUC.,"TINUM, YUC.",1,0,1,0,0,0,
16-oct-15,CHIH.,"HGO. DEL PARRAL, CHIH.",0,1,1,0,0,0,
16-oct-15,TAB.,"BALANCAN, TAB.",1,0,1,0,0,0,
16-oct-15,OAX.,"SALINA CRUZ, OAX.",1,0,1,0,0,10,
16-oct-15,TAMPS.,"CIUDAD MADERO, TAMPS.",1,0,1,0,0,3,
16-oct-15,NAY.,"AHUACATLAN, NAY.",1,0,1,0,0,0,
17-oct-15,B.C.,"ENSENADA, B.C.",0,1,1,0,0,0,
17-oct-15,MEX.,"NEXTLALPAN, MEX., MEX.",1,0,1,0,0,0,
19-oct-15,GRO.,"PUNGARABATO, GRO.",0,1,1,0,0,0,
19-oct-15,MEX.,"XONACATLAN, MEX.",1,0,1,0,0,0,
19-oct-15,CHIH.,"HGO. DEL PARRAL, CHIH.",0,1,1,0,0,0,
19-oct-15,MEX.,"TEOTIHUACAN, MEX.",1,0,1,0,0,209,
20-oct-15,OAX.,"CIUDAD IXTEPEC, OAX.",1,0,1,0,0,0,
20-oct-15,COAH.,"MÚZQUIZ, COAH.",1,0,1,0,0,0,
20-oct-15,TAMPS.,"NUEVO LAREDO, TAMPS.",1,0,1,0,0,981,
21-oct-15,COAH.,"PIEDRAS NEGRAS, COAH.",1,0,1,0,0,0,
21-oct-15,COAH.,"TORREÓN, COAH.",1,0,1,1,0,40,
21-oct-15,COAH.,"MÚZQUIZ, COAH.",0,1,1,0,0,0,
21-oct-15,CHIS.,"BENEMÉRITO DE LAS AMÉRICAS, CHIS.",1,0,1,2,0,0,
21-oct-15,HGO.,"ZEMPOALA, HGO.",0,1,1,0,0,0,
21-oct-15,Q. ROO,"COZUMEL, Q. ROO",0,1,1,2,0,175,
21-oct-15,B.C.,"ENSENADA, B.C.",0,1,1,0,0,0,
21-oct-15,DGO.,"GOMEZ PALACIO, DGO.",0,1,1,0,0,0,
23-oct-15,SIN.,"CONCORDIA, SIN.",1,0,1,0,0,0,
23-oct-15,COAH.,"ACUÑA, COAH.",0,1,1,0,0,0,
24-oct-15,B.C.,"ENSENADA, B.C.",0,1,1,0,0,0,
24-oct-15,B.C.,"MEXICALI, B.C.",0,1,1,0,0,0,
24-oct-15,HGO.,"IXMIQUILPAN, HGO.",1,0,1,0,0,0,
24-oct-15,HGO.,"TULANCINGO DE BRAVO, HGO.",0,1,1,0,0,59,
26-oct-15,VER.,"ATZALAN, VER.",0,1,1,0,0,0,
26-oct-15,GRO.,"GENERAL HELIODORO CASTILLO, GRO.",0,1,1,2,0,0,
26-oct-15,COAH.,"MÚZQUIZ, COAH.",0,1,1,0,0,0,
27-oct-15,CHIH.,"HGO. DEL PARRAL, CHIH.",1,0,1,0,0,0,
27-oct-15,DGO.,"DGO., DGO.",1,0,1,21,0,0,
27-oct-15,CHIS.,"BENEMÉRITO DE LAS AMÉRICAS, CHIS.",1,0,1,0,0,0,
28-oct-15,SON.,"CAJEME, SON.",1,0,1,0,0,0,
28-oct-15,CHIH.,"HGO. DEL PARRAL, CHIH.",1,0,1,0,0,0,
28-oct-15,CHIS.,"BENEMÉRITO DE LAS AMÉRICAS, CHIS.",0,1,1,0,0,0,
28-oct-15,COAH.,"SAN PEDRO, COAH.",1,0,1,0,0,0,
28-oct-15,GRO.,"ATOYAC DE ALVAREZ, GRO.",1,0,1,0,0,0,
29-oct-15,MEX.,"COCOTITLAN, MEX.",1,0,1,0,6,0,
29-oct-15,MEX.,"CALIMAYA, MEX.",1,0,1,1,0,18,
29-oct-15,B.C.,"MEXICALI, B.C.",0,1,1,0,0,0,
29-oct-15,SON.,"CAJEME, SON.",1,0,1,0,0,0,
29-oct-15,DGO.,"TLAHUALILO, DGO.",0,1,1,0,0,0,
29-oct-15,VER.,"ATZALAN, VER.",1,0,1,0,0,0,
29-oct-15,CHIS.,"BENEMÉRITO DE LAS AMÉRICAS, CHIS.",0,1,1,0,0,0,
29-oct-15,GRO.,"ATOYAC DE ALVAREZ, GRO.",1,0,1,0,0,0,
29-oct-15,COAH.,"ACUÑA, COAH.",1,0,1,0,0,0,
29-oct-15,COAH.,"SAN PEDRO, COAH.",1,0,1,0,0,0,
29-oct-15,N.L.,"CERRALVO, N.L.",1,0,1,1,0,0,
30-oct-15,CHIS.,"BENEMÉRITO DE LAS AMÉRICAS, CHIS.",1,0,1,0,0,0,
30-oct-15,SON.,"CAJEME, SON.",1,0,1,0,0,0,
30-oct-15,TAMPS.,"EL MANTE, TAMPS.",1,0,1,0,0,0,
31-oct-15,COAH.,"ACUÑA, COAH.",1,0,1,0,0,0,
31-oct-15,MEX.,"COCOTITLAN, MEX.",1,0,1,0,8,0,
01-nov-15,DGO.,"TLAHUALILO, DGO.",1,0,1,0,0,0,
01-nov-15,DGO.,"DGO., DGO.",1,0,1,0,0,0,
03-nov-15,HGO.,"ATOTONILCO EL GRANDE, HGO.",1,0,1,2,0,47,
03-nov-15,MEX.,"VALLE DE CHALCO SOLIDARIDAD, MEX.",1,0,1,0,0,0,
03-nov-15,TAMPS.,"TAMPICO, TAMPS.",1,0,1,3,0,449,
04-nov-15,N.L.,"GRAL. ESCOBEDO, N.L.",1,0,1,151,0,500,
04-nov-15,TAMPS.,"MATAMOROS, TAMPS.",1,0,1,0,0,0,
04-nov-15,COAH.,"MATAMOROS, COAH.",1,0,1,0,0,0,
05-nov-15,TAMPS.,"NUEVO LAREDO, TAMPS.",1,0,1,2,0,53,
05-nov-15,COAH.,"MATAMOROS, COAH.",0,1,1,0,0,0,
06-nov-15,SIN.,"MOCORITO, SIN.",1,0,1,0,7,0,
06-nov-15,COAH.,"TORREÓN, COAH.",1,0,1,1,0,0,
06-nov-15,COAH.,"SAN PEDRO, COAH.",1,0,1,1,0,5,
06-nov-15,COAH.,"MÚZQUIZ, COAH.",0,1,1,0,0,0,
06-nov-15,COAH.,"SABINAS, COAH.",1,0,1,0,0,0,
06-nov-15,SON.,"HERMOSILLO, SON.",1,0,1,0,0,0,
06-nov-15,GRO.,"ALPOYECA, GRO.",0,1,1,0,0,0,
06-nov-15,DGO.,"DGO., DGO.",1,0,1,1,0,0,
07-nov-15,MEX.,"PAPALOTLA, MEX.",1,0,1,0,0,0,
08-nov-15,TAMPS.,"MATAMOROS, TAMPS.",0,1,1,0,0,0,
08-nov-15,B.C.,"ENSENADA, B.C.",1,0,1,0,0,0,
08-nov-15,MOR.,"CUERNAVACA, MOR.",0,1,1,0,0,0,
09-nov-15,HGO.,"TEPEAPULCO, HGO.",1,0,1,0,0,0,
09-nov-15,COAH.,"ACUÑA, COAH.",1,0,1,0,0,0,
09-nov-15,MOR.,"CUERNAVACA, MOR.",0,1,1,0,0,0,
10-nov-15,MOR.,"CUERNAVACA, MOR.",0,1,1,0,0,0,
10-nov-15,HGO.,"TLANCHINOL, HGO.",1,0,1,0,0,0,
10-nov-15,VER.,"ALTOTONGA, VER.",1,0,1,0,0,0,
10-nov-15,CHIH.,"HGO. DEL PARRAL, CHIH.",1,0,1,0,0,0,
10-nov-15,GRO.,"ALPOYECA, GRO.",0,1,1,0,0,0,
10-nov-15,B.C.,"ENSENADA, B.C.",0,1,1,0,0,0,
10-nov-15,COAH.,"MATAMOROS, COAH.",0,1,1,0,0,0,
10-nov-15,COAH.,"SAN PEDRO, COAH.",0,1,1,0,0,0,
10-nov-15,COAH.,"RAMOS ARIZPE, COAH.",1,0,1,0,0,0,
11-nov-15,DGO.,"DGO., DGO.",1,0,1,0,0,0,
11-nov-15,B.C.,"MEXICALI, B.C.",0,1,1,0,0,0,
11-nov-15,TAMPS.,"TAMPICO, TAMPS.",1,0,1,1,0,501,
12-nov-15,TAB.,"BALANCAN, TAB.",1,0,1,0,0,0,
12-nov-15,PUE.,"PUE., PUE.",1,0,1,1,0,7,
12-nov-15,MEX.,"MALINALCO, MEX.",1,0,1,0,0,0,
12-nov-15,TAMPS.,"EL MANTE, TAMPS.",1,0,1,0,0,0,
12-nov-15,MOR.,"CUERNAVACA, MOR.",0,1,1,0,0,0,
12-nov-15,HGO.,"TLAXCOAPAN, HGO.",0,1,1,0,0,0,
12-nov-15,COAH.,"SAN PEDRO, COAH.",1,0,1,0,0,0,
12-nov-15,YUC.,"MERIDA, YUC.",1,0,1,0,0,1620,
12-nov-15,B.C.,"ENSENADA, B.C.",0,1,1,0,0,0,
13-nov-15,N.L.,"GRAL. ESCOBEDO, N.L.",0,1,1,201,0,0,
13-nov-15,COAH.,"MATAMOROS, COAH.",1,0,1,0,0,0,
13-nov-15,TAB.,"JONUTA, TAB.",1,0,1,0,0,0,
13-nov-15,PUE.,"PUE., PUE.",1,0,1,0,0,50,
13-nov-15,B.C.,"ENSENADA, B.C.",0,1,1,0,0,0,
13-nov-15,B.C.,"MEXICALI, B.C.",0,1,1,0,0,0,
13-nov-15,CHIS.,"TUXTLA CHICO, CHIS.",0,1,1,0,0,0,
13-nov-15,CHIS.,"MOTOZINTLA, CHIS.",0,1,1,0,0,214,
14-nov-15,GRO.,"TLALIXTAQUILLA DE MALDONADO, GRO.",1,0,1,0,0,0,
14-nov-15,MOR.,"CUERNAVACA, MOR.",1,0,1,0,1,0,
14-nov-15,GRO.,"TLALIXTAQUILLA DE MALDONADO, GRO.",1,0,1,0,0,0,
14-nov-15,TAMPS.,"MATAMOROS, TAMPS.",1,0,1,0,2,0,
15-nov-15,CHIH.,"HGO. DEL PARRAL, CHIH.",1,0,1,0,0,0,
15-nov-15,MOR.,"CUERNAVACA, MOR.",1,0,1,1,0,0,
16-nov-15,TAB.,"BALANCAN, TAB.",0,1,1,0,0,0,
16-nov-15,N.L.,"MONTERREY, N.L.",0,1,1,0,0,0,
17-nov-15,YUC.,"PROGRESO, YUC.",0,1,1,0,0,370,
17-nov-15,GRO.,"AJUCHITLAN DEL PROGRESO, GRO.",1,0,1,0,0,0,
17-nov-15,COAH.,"MÚZQUIZ, COAH.",1,0,1,0,0,0,
18-nov-15,COAH.,"MONCLOVA, COAH.",1,0,1,1,0,0,
18-nov-15,COAH.,"SALTILLO, COAH.",1,0,1,0,0,0,
18-nov-15,SON.,"HERMOSILLO, SON.",1,0,1,0,0,0,
18-nov-15,COAH.,"PIEDRAS NEGRAS, COAH.",1,0,1,0,0,0,
18-nov-15,HGO.,"TLANCHINOL, HGO.",1,0,1,0,0,0,
18-nov-15,MOR.,"CUERNAVACA, MOR.",1,0,1,0,0,0,
19-nov-15,S.L.P.,"AXTLA DE TERRAZAS, S.L.P.",1,0,1,0,0,0,
19-nov-15,B.C.,"MEXICALI, B.C.",0,1,1,0,0,0,
19-nov-15,HGO.,"TLAXCOAPAN, HGO.",0,1,1,0,0,0,
19-nov-15,HGO.,"TLANCHINOL, HGO.",1,0,1,0,0,0,
19-nov-15,MEX.,"RAYON, MEX.",0,1,1,0,0,0,
19-nov-15,COL.,"COL., COL.",0,1,1,0,0,0,
19-nov-15,SON.,"CAJEME, SON.",0,1,1,0,0,500,
19-nov-15,TAB.,"BALANCAN, TAB.",1,0,1,0,0,0,
19-nov-15,COAH.,"SABINAS, COAH.",1,0,1,0,0,0,
19-nov-15,MEX.,"NOPALTEPEC, MEX.",1,0,1,0,0,0,
20-nov-15,HGO.,"TEPEAPULCO, HGO.",1,0,1,0,0,0,
20-nov-15,COAH.,"SALTILLO, COAH.",1,0,1,0,2,0,
20-nov-15,B.C.,"ENSENADA, B.C.",0,1,1,0,0,0,
20-nov-15,B.C.,"MEXICALI, B.C.",0,1,1,0,0,0,
20-nov-15,MEX.,"NOPALTEPEC, MEX.",0,1,1,0,0,0,
20-nov-15,MOR.,"CUERNAVACA, MOR.",0,1,1,0,1,48,
21-nov-15,B.C.,"MEXICALI, B.C.",1,0,1,0,0,0,
22-nov-15,GRO.,"TELOLOAPAN, GRO.",0,1,1,0,0,0,
22-nov-15,MEX.,"NOPALTEPEC, MEX.",1,0,1,0,0,35,
23-nov-15,COAH.,"MATAMOROS, COAH.",1,0,1,0,0,0,
23-nov-15,COAH.,"ACUÑA, COAH.",1,0,1,0,0,2,
23-nov-15,GRO.,"CUALAC, GRO.",1,0,1,0,0,0,
23-nov-15,MEX.,"AXAPUSCO, MEX.",1,0,1,1,0,0,
23-nov-15,MEX.,"NOPALTEPEC, MEX.",1,0,1,0,0,0,
23-nov-15,MEX.,"ALMOLOYA DE JUAREZ, MEX.",0,1,1,0,0,0,
24-nov-15,B.C.,"MEXICALI, B.C.",1,0,1,0,0,0,
24-nov-15,TAB.,"BALANCAN, TAB.",1,0,1,0,0,0,
24-nov-15,YUC.,"TIXKOKOB, YUC.",1,0,1,1,0,249,
24-nov-15,HGO.,"TEPETITLAN, HGO.",0,1,1,0,0,0,
24-nov-15,COAH.,"MONCLOVA, COAH.",1,0,1,1,0,49,
24-nov-15,COAH.,"SAN PEDRO, COAH.",1,0,1,1,0,0,
24-nov-15,PUE.,"PUE., PUE.",1,0,1,4,0,0,
24-nov-15,SON.,"MAGDALENA, SON.",0,1,1,1,0,0,
24-nov-15,SON.,"PITIQUITO, SON.",0,1,1,0,0,0,
24-nov-15,SON.,"PUERTO PEÑASCO, SON.",1,0,1,1,0,14,
24-nov-15,SON.,"GENERAL PLUTARCO ELIAS CALLES, SON.",0,1,1,0,0,0,
24-nov-15,SON.,"BENITO JUAREZ, SON.",0,1,1,0,0,29,
24-nov-15,MEX.,"AXAPUSCO, MEX.",1,0,1,0,0,0,
24-nov-15,MEX.,"TEMASCALAPA, MEX.",1,0,1,1,6,1009,
25-nov-15,N.L.,"GARCIA, N.L.",1,0,1,2,0,0,
25-nov-15,MEX.,"ALMOLOYA DE JUAREZ, MEX.",1,0,1,1,0,116,
25-nov-15,SON.,"HERMOSILLO, SON.",1,0,1,0,0,0,
25-nov-15,SON.,"ALAMOS, SON.",1,0,1,1,0,0,
25-nov-15,SON.,"MAGDALENA, SON.",1,0,1,0,0,10,
25-nov-15,SON.,"CANANEA, SON.",1,0,1,0,0,0,
25-nov-15,SON.,"AGUA PRIETA, SON.",1,0,1,0,0,8,
25-nov-15,SON.,"PUERTO PEÑASCO, SON.",0,1,1,0,0,0,
25-nov-15,SON.,"GENERAL PLUTARCO ELIAS CALLES, SON.",0,1,1,0,0,0,
26-nov-15,YUC.,"VALLADOLID, YUC.",1,0,1,0,0,120,
26-nov-15,SON.,"YECORA, SON.",1,0,1,0,0,0,
26-nov-15,SON.,"NAVOJOA, SON.",1,0,1,0,0,0,
26-nov-15,SON.,"ALAMOS, SON.",0,1,1,0,0,0,
26-nov-15,COAH.,"SAN PEDRO, COAH.",1,0,1,0,0,0,
26-nov-15,COAH.,"SABINAS, COAH.",0,1,1,1,0,0,
26-nov-15,MEX.,"TEMASCALAPA, MEX.",1,0,1,0,0,79,
26-nov-15,SON.,"GENERAL PLUTARCO ELIAS CALLES, SON.",1,0,1,0,0,0,
27-nov-15,SON.,"SAN MIGUEL DE HORCASITAS, SON.",0,1,1,0,0,0,
27-nov-15,SON.,"NAVOJOA, SON.",0,1,1,0,0,0,
27-nov-15,SON.,"BENITO JUAREZ, SON.",1,0,1,0,0,0,
27-nov-15,MEX.,"COATEPEC HARINAS, MEX.",1,0,1,1,0,0,
27-nov-15,SON.,"MAGDALENA, SON.",0,1,1,0,0,0,
27-nov-15,SON.,"SAN LUIS RIO COLORADO, SON.",1,0,1,0,0,0,
27-nov-15,SON.,"PUERTO PEÑASCO, SON.",1,0,1,0,0,0,
27-nov-15,COAH.,"SAN PEDRO, COAH.",1,0,1,1,0,55,
27-nov-15,COAH.,"SABINAS, COAH.",0,1,1,0,0,0,
27-nov-15,COAH.,"ACUÑA, COAH.",1,0,1,0,0,0,
27-nov-15,PUE.,"PUE., PUE.",1,0,1,0,0,0,
27-nov-15,DGO.,"DGO., DGO.",1,0,1,0,0,0,
27-nov-15,MEX.,"AXAPUSCO, MEX.",0,1,1,0,0,0,
27-nov-15,MEX.,"TEMASCALAPA, MEX.",0,1,1,0,5,0,
27-nov-15,SON.,"MAGDALENA, SON.",1,0,1,0,0,0,
28-nov-15,PUE.,"PUE., PUE.",1,0,1,0,0,0,
28-nov-15,B.C.,"MEXICALI, B.C.",0,1,1,0,0,0,
28-nov-15,SON.,"GUAYMAS, SON.",1,0,1,1,0,0,
28-nov-15,SON.,"ALAMOS, SON.",1,0,1,1,0,0,
29-nov-15,N.L.,"MONTERREY, N.L.",1,0,1,17,0,600,
30-nov-15,AGS.,"AGS., AGS.",0,1,1,44,0,0,
01-dic-15,GRO.,"IXCATEOPAN DE CUAUHTEMOC, GRO.",0,1,1,0,0,0,
01-dic-15,B.C.,"MEXICALI, B.C.",1,0,1,0,0,0,
01-dic-15,DGO.,"DGO., DGO.",1,0,1,0,0,0,
01-dic-15,COAH.,"PIEDRAS NEGRAS, COAH.",0,1,1,0,0,70,
01-dic-15,COAH.,"MATAMOROS, COAH.",1,0,1,0,0,0,
01-dic-15,COAH.,"SAN PEDRO, COAH.",1,0,1,0,1,0,
01-dic-15,MOR.,"CUERNAVACA, MOR.",1,0,1,0,0,0,
01-dic-15,SON.,"NAVOJOA, SON.",0,1,1,0,0,0,
01-dic-15,AGS.,"AGS., AGS.",1,0,1,1,0,0,
01-dic-15,SON.,"SAN LUIS RIO COLORADO, SON.",0,1,1,1,0,0,
01-dic-15,SON.,"PUERTO PEÑASCO, SON.",0,1,1,0,0,0,
01-dic-15,VER.,"PAPANTLA, VER.",1,0,1,0,0,0,
02-dic-15,S.L.P.,"CIUDAD VALLES, S.L.P.",1,0,1,0,1,0,
02-dic-15,SON.,"NOGALES, SON.",1,0,1,0,0,22,
02-dic-15,SON.,"CABORCA, SON.",0,1,1,1,0,0,
02-dic-15,SON.,"PUERTO PEÑASCO, SON.",1,0,1,2,0,0,
02-dic-15,PUE.,"PUE., PUE.",1,0,1,0,0,0,
02-dic-15,COAH.,"MATAMOROS, COAH.",1,0,1,0,0,6,
02-dic-15,COAH.,"RAMOS ARIZPE, COAH.",1,0,1,0,0,0,
02-dic-15,COAH.,"MATAMOROS, COAH.",1,0,1,0,0,6,
02-dic-15,CHIS.,"REFORMA, CHIS.",1,0,1,1,0,0,
03-dic-15,N.L.,"SAN NICOLAS DE LOS GARZA, N.L.",1,0,1,0,0,280,
03-dic-15,COAH.,"SAN PEDRO, COAH.",1,0,1,0,0,0,
03-dic-15,GRO.,"TAXCO DE ALARCON, GRO.",1,0,1,0,0,0,
03-dic-15,N.L.,"SAN NICOLAS DE LOS GARZA, N.L.",0,1,1,1,0,350,
04-dic-15,COAH.,"ACUÑA, COAH.",0,1,1,0,0,0,
04-dic-15,N.L.,"SAN NICOLAS DE LOS GARZA, N.L.",1,0,1,0,0,0,
04-dic-15,CHIH.,"OJINAGA, CHIH.",0,1,1,0,0,0,
04-dic-15,B.C.,"MEXICALI, B.C.",1,0,1,0,0,0,
04-dic-15,SON.,"CABORCA, SON.",1,0,1,0,0,0,
04-dic-15,SON.,"AGUA PRIETA, SON.",0,1,1,0,0,0,
04-dic-15,SON.,"PUERTO PEÑASCO, SON.",1,0,1,3,0,0,
04-dic-15,DGO.,"DGO., DGO.",1,0,1,0,0,0,
04-dic-15,TAB.,"JONUTA, TAB.",1,0,1,0,0,0,
04-dic-15,S.L.P.,"RIOVERDE, S.L.P.",1,0,1,0,0,100,
04-dic-15,TAB.,"TENOSIQUE, TAB.",1,0,1,0,0,0,
05-dic-15,GRO.,"PEDRO ASCENCIO ALQUISIRAS, GRO.",0,1,1,0,0,0,
05-dic-15,CHIH.,"OJINAGA, CHIH.",1,0,1,0,0,0,
05-dic-15,SON.,"NOGALES, SON.",0,1,1,2,0,0,
05-dic-15,SON.,"SANTA ANA, SON.",0,1,1,0,0,0,
05-dic-15,SON.,"CANANEA, SON.",1,0,1,5,0,0,
05-dic-15,SON.,"CABORCA, SON.",1,0,1,0,0,0,
05-dic-15,SON.,"PUERTO PEÑASCO, SON.",0,1,1,0,0,38,
05-dic-15,COAH.,"PIEDRAS NEGRAS, COAH.",1,0,1,24,0,30,
05-dic-15,COAH.,"ACUÑA, COAH.",0,1,1,0,0,0,
05-dic-15,S.L.P.,"RIOVERDE, S.L.P.",1,0,1,1,0,0,
05-dic-15,S.L.P.,"SALINAS, S.L.P.",1,0,1,0,0,0,
05-dic-15,N.L.,"SAN NICOLAS DE LOS GARZA, N.L.",1,0,1,0,0,0,
06-dic-15,GRO.,"TAXCO DE ALARCON, GRO.",1,0,1,0,0,0,
06-dic-15,GRO.,"PEDRO ASCENCIO ALQUISIRAS, GRO.",0,1,1,0,0,0,
06-dic-15,B.C.,"ENSENADA, B.C.",0,1,1,0,0,0,
06-dic-15,SON.,"HERMOSILLO, SON.",1,0,1,0,0,0,
06-dic-15,COAH.,"PIEDRAS NEGRAS, COAH.",1,0,1,0,0,70,
06-dic-15,COAH.,"MONCLOVA, COAH.",1,0,1,0,0,0,
06-dic-15,TAMPS.,"NUEVO LAREDO, TAMPS.",1,0,1,0,1,0,
07-dic-15,SON.,"ALTAR, SON.",0,1,1,0,0,0,
07-dic-15,SON.,"CANANEA, SON.",1,0,1,0,0,0,
07-dic-15,SON.,"CABORCA, SON.",1,0,1,0,0,0,
07-dic-15,SON.,"GENERAL PLUTARCO ELIAS CALLES, SON.",0,1,1,0,1,0,
07-dic-15,MOR.,"CUERNAVACA, MOR.",0,1,1,0,0,0,
07-dic-15,SON.,"EMPALME, SON.",0,1,1,0,0,0,
08-dic-15,S.L.P.,"SALINAS, S.L.P.",1,0,1,0,0,0,
08-dic-15,QRO.,"SAN JUAN DEL RIO, QRO.",0,1,1,0,0,0,
08-dic-15,SON.,"ALAMOS, SON.",1,0,1,0,0,0,
08-dic-15,SON.,"NAVOJOA, SON.",0,1,1,1,0,0,
08-dic-15,SON.,"BENITO JUAREZ, SON.",1,0,1,0,0,0,
08-dic-15,MOR.,"CUERNAVACA, MOR.",0,1,1,0,0,0,
08-dic-15,B.C.,"TIJUANA, B.C.",1,0,1,0,0,0,
08-dic-15,SON.,"SANTA ANA, SON.",1,0,1,0,0,0,
08-dic-15,SON.,"SAN LUIS RIO COLORADO, SON.",0,1,1,0,0,0,
08-dic-15,SON.,"AGUA PRIETA, SON.",0,1,1,0,0,43,
09-dic-15,S.L.P.,"SALINAS, S.L.P.",1,0,1,0,0,0,
09-dic-15,Q. ROO,"COZUMEL, Q. ROO",1,0,1,0,0,184,
09-dic-15,SON.,"SAN LUIS RIO COLORADO, SON.",0,1,1,0,0,0,
09-dic-15,SON.,"PUERTO PEÑASCO, SON.",0,1,1,0,0,250,
09-dic-15,S.L.P.,"RIOVERDE, S.L.P.",0,1,1,1,0,0,
09-dic-15,CHIS.,"JUÁREZ, CHIS.",0,1,1,0,0,0,
10-dic-15,SON.,"NOGALES, SON.",1,0,1,0,0,0,
10-dic-15,SON.,"SANTA ANA, SON.",1,0,1,0,0,0,
10-dic-15,SON.,"CANANEA, SON.",1,0,1,0,0,0,
10-dic-15,SON.,"SAN LUIS RIO COLORADO, SON.",0,1,1,1,0,0,
10-dic-15,SON.,"CABORCA, SON.",1,0,1,1,0,0,
10-dic-15,QRO.,"SAN JUAN DEL RIO, QRO.",1,0,1,0,1,0,
10-dic-15,S.L.P.,"RIOVERDE, S.L.P.",1,0,1,0,0,0,
10-dic-15,SON.,"SAN MIGUEL DE HORCASITAS, SON.",0,1,1,7,0,0,
10-dic-15,SON.,"EMPALME, SON.",1,0,1,0,0,0,
10-dic-15,SON.,"HUATABAMPO, SON.",1,0,1,0,0,0,
10-dic-15,TAB.,"TENOSIQUE, TAB.",0,1,1,0,0,0,
11-dic-15,TAB.,"BALANCAN, TAB.",1,0,1,0,0,0,
11-dic-15,SON.,"HERMOSILLO, SON.",1,0,1,0,0,23,
11-dic-15,SON.,"ETCHOJOA, SON.",0,1,1,0,0,0,
11-dic-15,SON.,"ALTAR, SON.",0,1,1,0,0,0,
11-dic-15,SON.,"AGUA PRIETA, SON.",0,1,1,0,0,0,
11-dic-15,SON.,"GENERAL PLUTARCO ELIAS CALLES, SON.",0,1,1,0,0,99,
11-dic-15,B.C.,"ENSENADA, B.C.",0,1,1,0,0,0,
11-dic-15,TAMPS.,"MATAMOROS, TAMPS.",1,0,1,0,0,0,
11-dic-15,PUE.,"PUE., PUE.",1,0,1,0,0,0,
11-dic-15,ZAC.,"ZAC., ZAC.",0,1,1,0,0,74,
11-dic-15,QRO.,"SAN JUAN DEL RIO, QRO.",1,0,1,0,0,0,
11-dic-15,S.L.P.,"SALINAS, S.L.P.",1,0,1,0,0,0,
12-dic-15,S.L.P.,"CIUDAD VALLES, S.L.P.",1,0,1,0,0,0,
12-dic-15,SON.,"CANANEA, SON.",1,0,1,1,0,30,
12-dic-15,SON.,"CABORCA, SON.",1,0,1,1,0,0,
12-dic-15,SON.,"PITIQUITO, SON.",1,0,1,1,0,0,
12-dic-15,SON.,"PUERTO PEÑASCO, SON.",1,0,1,2,0,31,
12-dic-15,MOR.,"CUERNAVACA, MOR.",1,0,1,0,8,1017,
12-dic-15,N.L.,"MONTERREY, N.L.",1,0,1,0,0,0,
12-dic-15,SON.,"GUAYMAS, SON.",0,1,1,0,0,0,
12-dic-15,SON.,"EMPALME, SON.",1,0,1,2,0,124,
13-dic-15,S.L.P.,"CIUDAD VALLES, S.L.P.",1,0,1,0,0,0,
14-dic-15,N.L.,"MONTERREY, N.L.",0,1,1,0,0,0,
15-dic-15,GRO.,"GENERAL CANUTO A. NERI, GRO.",0,1,1,0,0,0,
15-dic-15,QRO.,"SAN JUAN DEL RIO, QRO.",1,0,1,0,0,0,
15-dic-15,QRO.,"SAN JUAN DEL RIO, QRO.",1,0,1,0,0,0,
16-dic-15,N.L.,"SAN NICOLAS DE LOS GARZA, N.L.",1,0,1,243,0,12100,
16-dic-15,N.L.,"MONTERREY, N.L.",1,0,1,1,0,0,
17-dic-15,N.L.,"SAN NICOLAS DE LOS GARZA, N.L.",0,1,1,274,0,39,
17-dic-15,YUC.,"ABALA, YUC.",0,1,1,0,0,319,
17-dic-15,B.C.,"TIJUANA, B.C.",0,1,1,0,0,0,
17-dic-15,B.C.,"MEXICALI, B.C.",1,0,1,0,0,0,
18-dic-15,B.C.,"TIJUANA, B.C.",1,0,1,0,0,0,
18-dic-15,B.C.,"ENSENADA, B.C.",0,1,1,0,0,0,
18-dic-15,GRO.,"COAHUAYUTLA DE JOSE MARIA IZAZAGA, GRO.",0,1,1,0,0,219,
18-dic-15,DGO.,"LERDO, DGO.",1,0,1,0,0,0,
19-dic-15,DGO.,"LERDO, DGO.",1,0,1,1,0,0,
19-dic-15,TAMPS.,"REYNOSA, TAMPS.",0,1,1,0,0,0,
19-dic-15,N.L.,"SAN NICOLAS DE LOS GARZA, N.L.",0,1,1,120,0,0,
19-dic-15,N.L.,"MONTERREY, N.L.",0,1,1,172,0,2600,
19-dic-15,B.C.,"ENSENADA, B.C.",1,0,1,0,0,0,
19-dic-15,B.C.,"MEXICALI, B.C.",1,0,1,0,0,0,
21-dic-15,NAY.,"TEPIC, NAY.",1,0,1,2,0,0,
21-dic-15,NAY.,"XALISCO, NAY.",0,1,1,0,0,0,
21-dic-15,B.C.,"MEXICALI, B.C.",1,0,1,0,0,0,
21-dic-15,DGO.,"DGO., DGO.",0,1,1,0,0,0,
23-dic-15,B.C.,"TIJUANA, B.C.",0,1,1,0,0,0,
23-dic-15,VER.,"TANTOYUCA, VER.",1,0,1,0,0,0,
24-dic-15,VER.,"TANTOYUCA, VER.",1,0,1,0,0,0,
25-dic-15,VER.,"TANTOYUCA, VER.",1,0,1,0,0,0,
27-dic-15,B.C.,"ENSENADA, B.C.",0,1,1,0,0,0,
30-dic-15,B.C.,"ENSENADA, B.C.",0,1,1,0,0,0,
30-dic-15,B.C.,"ENSENADA, B.C.",0,1,1,0,0,0,
02-ene-16,B.C.,"MEXICALI, B.C.",0,1,1,0,0,0,
04-ene-16,DGO.,"DGO., DGO.",0,1,1,0,0,0,
07-ene-16,B.C.,"TIJUANA, B.C.",1,0,1,0,0,0,
07-ene-16,DGO.,"DGO., DGO.",0,1,1,3,0,0,
08-ene-16,ZAC.,"ZAC., ZAC.",0,1,1,3,0,141,
11-ene-16,DGO.,"DGO., DGO.",1,0,1,0,0,0,
11-ene-16,COAH.,"MATAMOROS, COAH.",1,0,1,0,0,0,
11-ene-16,CHIS.,"REFORMA, CHIS.",0,1,1,0,0,0,
12-ene-16,B.C.,"ENSENADA, B.C.",0,1,1,0,0,0,
12-ene-16,COAH.,"MONCLOVA, COAH.",1,0,1,1,0,0,
13-ene-16,COAH.,"TORREÓN, COAH.",1,0,1,0,0,0,
13-ene-16,COAH.,"SAN PEDRO, COAH.",1,0,1,0,0,0,
13-ene-16,COAH.,"SALTILLO, COAH.",1,0,1,0,0,0,
13-ene-16,COAH.,"MONCLOVA, COAH.",0,1,1,0,0,0,
13-ene-16,COAH.,"MÚZQUIZ, COAH.",1,0,1,3,0,0,
14-ene-16,COAH.,"SAN PEDRO, COAH.",1,0,1,0,0,0,
14-ene-16,COAH.,"MONCLOVA, COAH.",0,1,1,0,0,705,
14-ene-16,COAH.,"MÚZQUIZ, COAH.",0,1,1,6,0,0,
14-ene-16,COAH.,"SABINAS, COAH.",0,1,1,0,0,400,
15-ene-16,COAH.,"TORREÓN, COAH.",1,0,1,0,0,0,
15-ene-16,DGO.,"DGO., DGO.",1,0,1,0,0,0,
16-ene-16,COAH.,"TORREÓN, COAH.",1,0,1,0,0,0,
16-ene-16,COAH.,"MÚZQUIZ, COAH.",0,1,1,0,0,0,
18-ene-16,COAH.,"TORREÓN, COAH.",1,0,1,0,0,0,
18-ene-16,COAH.,"SAN PEDRO, COAH.",1,0,1,0,0,0,
18-ene-16,COAH.,"TORREÓN, COAH.",1,0,1,0,0,0,
18-ene-16,COAH.,"SAN PEDRO, COAH.",1,0,1,0,0,0,
19-ene-16,OAX.,"MIAHUATLAN DE PORFIRIO DIAZ, OAX.",1,0,1,3,0,0,
19-ene-16,COAH.,"TORREÓN, COAH.",1,0,1,0,0,0,
19-ene-16,COAH.,"MATAMOROS, COAH.",1,0,1,0,0,0,
19-ene-16,COAH.,"SALTILLO, COAH.",1,0,1,0,0,0,
19-ene-16,B.C.,"TIJUANA, B.C.",0,1,1,0,0,0,
20-ene-16,COAH.,"MATAMOROS, COAH.",1,0,1,0,0,0,
20-ene-16,COAH.,"RAMOS ARIZPE, COAH.",0,1,1,0,0,0,
20-ene-16,B.C.,"TIJUANA, B.C.",1,0,1,0,0,0,
20-ene-16,OAX.,"MIAHUATLAN DE PORFIRIO DIAZ, OAX.",0,1,1,15,0,0,
21-ene-16,COAH.,"MONCLOVA, COAH.",1,0,1,0,0,0,
22-ene-16,NAY.,"TEPIC, NAY.",1,0,1,0,0,0,
22-ene-16,COL.,"COL., COL.",1,0,1,1,0,0,
22-ene-16,OAX.,"MIAHUATLAN DE PORFIRIO DIAZ, OAX.",0,1,1,8,0,0,
22-ene-16,OAX.,"OAX. DE JUAREZ, OAX.",1,0,1,0,0,300,
22-ene-16,COAH.,"PIEDRAS NEGRAS, COAH.",0,1,1,0,0,20,
22-ene-16,COAH.,"TORREÓN, COAH.",1,0,1,0,0,0,
22-ene-16,COAH.,"MATAMOROS, COAH.",1,0,1,0,0,0,
22-ene-16,COAH.,"ACUÑA, COAH.",1,0,1,0,0,0,
22-ene-16,CHIH.,"NUEVO CASAS GRANDES, CHIH.",1,0,1,6,0,375,
23-ene-16,TAMPS.,"NUEVO LAREDO, TAMPS.",0,1,1,0,0,32,
25-ene-16,OAX.,"OAX. DE JUAREZ, OAX.",1,0,1,0,0,0,
25-ene-16,GRO.,"EDUARDO NERI, GRO.",1,0,1,0,3,0,
25-ene-16,COAH.,"PIEDRAS NEGRAS, COAH.",1,0,1,6,0,0,
25-ene-16,COAH.,"ACUÑA, COAH.",1,0,1,2,0,35,
25-ene-16,CHIH.,"NAMIQUIPA, CHIH.",1,0,1,0,0,1219,
25-ene-16,DGO.,"DGO., DGO.",0,1,1,1,0,0,
26-ene-16,B.C.,"TIJUANA, B.C.",0,1,1,0,0,0,
27-ene-16,OAX.,"OAX. DE JUAREZ, OAX.",1,0,1,0,0,86,
27-ene-16,CAMP.,"CAMP., CAMP.",0,1,1,0,0,14,
27-ene-16,OAX.,"MIAHUATLAN DE PORFIRIO DIAZ, OAX.",0,1,1,3,0,0,
27-ene-16,COAH.,"PIEDRAS NEGRAS, COAH.",1,0,1,0,0,15,
27-ene-16,COAH.,"MATAMOROS, COAH.",1,0,1,0,0,0,
27-ene-16,COAH.,"SAN PEDRO, COAH.",1,0,1,2,0,9,
27-ene-16,COAH.,"ACUÑA, COAH.",1,0,1,0,0,0,
28-ene-16,OAX.,"MIAHUATLAN DE PORFIRIO DIAZ, OAX.",0,1,1,3,0,0,
28-ene-16,B.C.,"TIJUANA, B.C.",1,0,1,0,0,0,
28-ene-16,COAH.,"MONCLOVA, COAH.",1,0,1,0,0,0,
28-ene-16,COAH.,"ACUÑA, COAH.",0,1,1,0,0,0,
29-ene-16,OAX.,"OAX. DE JUAREZ, OAX.",1,0,1,2,0,20,
29-ene-16,B.C.,"TIJUANA, B.C.",0,1,1,0,0,0,
29-ene-16,COAH.,"TORREÓN, COAH.",1,0,1,0,0,0,
29-ene-16,COAH.,"SAN PEDRO, COAH.",1,0,1,0,0,0,
31-ene-16,TAMPS.,"MATAMOROS, TAMPS.",1,0,1,0,0,0,
31-ene-16,COAH.,"TORREÓN, COAH.",1,0,1,0,0,0,
01-feb-16,GRO.,"ARCELIA, GRO.",1,0,1,0,0,0,
01-feb-16,TAB.,"CARDENAS, TAB.",1,0,1,0,0,0,
02-feb-16,COAH.,"SABINAS, COAH.",0,1,1,0,0,0,
02-feb-16,COAH.,"RAMOS ARIZPE, COAH.",0,1,1,0,0,32,
03-feb-16,DGO.,"DGO., DGO.",1,0,1,0,0,0,
03-feb-16,OAX.,"OAX. DE JUAREZ, OAX.",1,0,1,1,0,0,
03-feb-16,COAH.,"PIEDRAS NEGRAS, COAH.",0,1,1,3,1,178,
03-feb-16,COAH.,"SABINAS, COAH.",0,1,1,0,0,0,
03-feb-16,OAX.,"SAN JUAN BAUTISTA TUXTEPEC, OAX.",1,0,1,1,0,0,
03-feb-16,GRO.,"COYUCA DE CATALAN, GRO.",1,0,1,0,0,0,
04-feb-16,COAH.,"TORREÓN, COAH.",1,0,1,0,0,0,
04-feb-16,COAH.,"MONCLOVA, COAH.",1,0,1,0,0,0,
04-feb-16,COAH.,"TORREÓN, COAH.",1,0,1,0,0,0,
04-feb-16,COAH.,"SABINAS, COAH.",1,0,1,0,0,0,
04-feb-16,GRO.,"ARCELIA, GRO.",0,1,1,0,0,0,
05-feb-16,DGO.,"DGO., DGO.",0,1,1,0,0,0,
05-feb-16,TAB.,"CARDENAS, TAB.",1,0,1,0,0,0,
05-feb-16,GRO.,"ARCELIA, GRO.",0,1,1,0,0,0,
06-feb-16,OAX.,"OAX. DE JUAREZ, OAX.",1,0,1,0,0,0,
06-feb-16,COAH.,"GENERAL CEPEDA, COAH.",1,0,1,0,0,0,
08-feb-16,TAB.,"CARDENAS, TAB.",1,0,1,0,0,0,
08-feb-16,COAH.,"SAN PEDRO, COAH.",1,0,1,0,0,0,
08-feb-16,COAH.,"SABINAS, COAH.",0,1,1,0,0,0,
08-feb-16,COAH.,"RAMOS ARIZPE, COAH.",1,0,1,0,0,0,
09-feb-16,DGO.,"SANTIAGO PAPASQUIARO, DGO.",1,0,1,0,0,0,
09-feb-16,COAH.,"SAN PEDRO, COAH.",1,0,1,0,0,0,
09-feb-16,COAH.,"MÚZQUIZ, COAH.",1,0,1,0,0,0,
09-feb-16,TAB.,"CARDENAS, TAB.",0,1,1,0,0,0,
10-feb-16,COAH.,"SABINAS, COAH.",0,1,1,0,0,0,
10-feb-16,COAH.,"MÚZQUIZ, COAH.",0,1,1,0,0,0,
10-feb-16,COAH.,"ACUÑA, COAH.",1,0,1,1,0,0,
11-feb-16,GRO.,"ARCELIA, GRO.",1,0,1,0,0,0,
11-feb-16,COL.,"COL., COL.",1,0,1,0,0,0,
11-feb-16,CHIH.,"ASCENSIÓN, CHIH.",1,0,1,0,0,5796,
12-feb-16,DGO.,"DGO., DGO.",0,1,1,2,0,0,
12-feb-16,COAH.,"MÚZQUIZ, COAH.",1,0,1,0,0,0,
13-feb-16,OAX.,"SAN JUAN BAUTISTA TUXTEPEC, OAX.",1,0,1,0,0,0,
14-feb-16,TAMPS.,"NUEVO LAREDO, TAMPS.",1,0,1,0,0,0,
15-feb-16,OAX.,"SAN JUAN BAUTISTA TUXTEPEC, OAX.",0,1,1,0,0,0,
15-feb-16,COAH.,"TORREÓN, COAH.",1,0,1,0,0,0,
15-feb-16,COAH.,"SAN PEDRO, COAH.",0,1,1,0,0,0,
15-feb-16,COAH.,"SABINAS, COAH.",0,1,1,0,0,0,
15-feb-16,COAH.,"SALTILLO, COAH.",0,1,1,0,0,98,
15-feb-16,CHIH.,"ASCENSIÓN, CHIH.",1,0,1,0,6,0,
16-feb-16,COAH.,"TORREÓN, COAH.",1,0,1,1,0,0,
16-feb-16,HGO.,"TEPEJI DEL RIO DE OCAMPO, HGO.",0,1,1,0,0,0,
16-feb-16,OAX.,"OAX. DE JUAREZ, OAX.",1,0,1,0,0,0,
17-feb-16,DGO.,"DGO., DGO.",1,0,1,2,0,0,
17-feb-16,OAX.,"SAN JUAN BAUTISTA TUXTEPEC, OAX.",0,1,1,0,0,0,
17-feb-16,COAH.,"TORREÓN, COAH.",0,1,1,0,0,0,
17-feb-16,COAH.,"SABINAS, COAH.",1,0,1,0,0,0,
18-feb-16,CHIH.,"NUEVO CASAS GRANDES, CHIH.",1,0,1,0,0,5,
18-feb-16,CHIH.,"OJINAGA, CHIH.",0,1,1,0,0,150,
19-feb-16,HGO.,"PACHUCA DE SOTO, HGO.",1,0,1,0,0,576,
21-feb-16,TAB.,"TACOTALPA, TAB.",1,0,1,0,0,25,
21-feb-16,DGO.,"DGO., DGO.",1,0,1,0,0,0,
22-feb-16,HGO.,"TULANCINGO DE BRAVO, HGO.",1,0,1,1,0,0,
23-feb-16,COAH.,"MATAMOROS, COAH.",1,0,1,0,0,0,
23-feb-16,HGO.,"TEPEJI DEL RIO DE OCAMPO, HGO.",1,0,1,0,0,0,
23-feb-16,DGO.,"DGO., DGO.",1,0,1,4,1,0,
23-feb-16,COAH.,"MONCLOVA, COAH.",1,0,1,0,0,0,
23-feb-16,COAH.,"SAN PEDRO, COAH.",0,1,1,0,0,0,
23-feb-16,COAH.,"ACUÑA, COAH.",1,0,1,0,0,0,
23-feb-16,COAH.,"SALTILLO, COAH.",1,0,1,7,0,83,
23-feb-16,CHIH.,"NUEVO CASAS GRANDES, CHIH.",1,0,1,1,0,11,
24-feb-16,COAH.,"MONCLOVA, COAH.",1,0,1,0,1,0,
25-feb-16,YUC.,"TICUL, YUC.",1,0,1,0,0,0,
25-feb-16,DGO.,"DGO., DGO.",0,1,1,0,0,0,
25-feb-16,TAB.,"TENOSIQUE, TAB.",1,0,1,0,0,0,
25-feb-16,COAH.,"MONCLOVA, COAH.",1,0,1,0,0,39,
25-feb-16,COAH.,"MATAMOROS, COAH.",1,0,1,0,0,0,
25-feb-16,COAH.,"SALTILLO, COAH.",1,0,1,5,0,450,
25-feb-16,COAH.,"ACUÑA, COAH.",1,0,1,0,0,0,
26-feb-16,HGO.,"TULANCINGO DE BRAVO, HGO.",1,0,1,0,0,0,
26-feb-16,HGO.,"TEPEJI DEL RIO DE OCAMPO, HGO.",1,0,1,0,0,0,
28-feb-16,TAMPS.,"MATAMOROS, TAMPS.",1,0,1,1,0,95,
01-mar-16,COAH.,"MONCLOVA, COAH.",1,0,1,0,0,27,
01-mar-16,COAH.,"MÚZQUIZ, COAH.",0,1,1,0,0,0,
01-mar-16,COAH.,"RAMOS ARIZPE, COAH.",1,0,1,0,0,0,
01-mar-16,COAH.,"ACUÑA, COAH.",1,0,1,0,0,0,
01-mar-16,HGO.,"PACHUCA DE SOTO, HGO.",1,0,1,0,0,0,
01-mar-16,GRO.,"CHILAPA DE ALVAREZ, GRO.",1,0,1,1,0,0,
01-mar-16,GRO.,"CHILAPA DE ALVAREZ, GRO.",1,0,1,0,0,0,
03-mar-16,COAH.,"SAN PEDRO, COAH.",1,0,1,0,0,0,
04-mar-16,COAH.,"SAN PEDRO, COAH.",1,0,1,0,0,0,
04-mar-16,COAH.,"SALTILLO, COAH.",1,0,1,0,0,2330,
07-mar-16,OAX.,"OAX. DE JUAREZ, OAX.",1,0,1,1,0,5,
07-mar-16,HGO.,"YAHUALICA, HGO.",1,0,1,0,0,0,
07-mar-16,COAH.,"MONCLOVA, COAH.",1,0,1,0,0,0,
07-mar-16,COAH.,"SALTILLO, COAH.",1,0,1,0,0,0,
08-mar-16,COAH.,"TORREÓN, COAH.",1,0,1,0,0,0,
08-mar-16,COAH.,"TORREÓN, COAH.",1,0,1,0,0,54,
08-mar-16,COAH.,"TORREÓN, COAH.",1,0,1,0,0,0,
09-mar-16,COAH.,"MATAMOROS, COAH.",1,0,1,0,0,53,
09-mar-16,B.C.S.,"MULEGÉ, B.C.S.",0,1,1,0,0,0,
10-mar-16,CHIS.,"BENEMÉRITO DE LAS AMÉRICAS, CHIS.",1,0,1,0,0,0,
10-mar-16,HGO.,"VILLA DE TEZONTEPEC, HGO.",1,0,1,0,0,0,
12-mar-16,COAH.,"MATAMOROS, COAH.",1,0,1,0,0,42,
13-mar-16,B.C.S.,"MULEGÉ, B.C.S.",0,1,1,0,0,0,
14-mar-16,COAH.,"MONCLOVA, COAH.",1,0,1,1,0,37,
14-mar-16,COAH.,"TORREÓN, COAH.",1,0,1,0,0,0,
14-mar-16,COAH.,"MATAMOROS, COAH.",1,0,1,1,0,0,
15-mar-16,HGO.,"VILLA DE TEZONTEPEC, HGO.",0,1,1,0,0,200,
15-mar-16,OAX.,"CIUDAD IXTEPEC, OAX.",1,0,1,5,0,0,
15-mar-16,COAH.,"TORREÓN, COAH.",1,0,1,0,0,0,
15-mar-16,COAH.,"SAN PEDRO, COAH.",1,0,1,0,0,0,
15-mar-16,COAH.,"SABINAS, COAH.",1,0,1,0,0,0,
15-mar-16,COAH.,"SALTILLO, COAH.",1,0,1,2,0,61,
15-mar-16,GRO.,"COYUCA DE BENITEZ, GRO.",0,1,1,0,0,0,
15-mar-16,COAH.,"MATAMOROS, COAH.",1,0,1,0,0,0,
16-mar-16,COAH.,"MONCLOVA, COAH.",1,0,1,0,0,66,
16-mar-16,COAH.,"MATAMOROS, COAH.",0,1,1,0,0,0,
16-mar-16,COAH.,"SAN PEDRO, COAH.",0,1,1,0,0,0,
16-mar-16,HGO.,"VILLA DE TEZONTEPEC, HGO.",0,1,1,0,0,0,
16-mar-16,GRO.,"AJUCHITLAN DEL PROGRESO, GRO.",0,1,1,0,0,0,
17-mar-16,COAH.,"PIEDRAS NEGRAS, COAH.",1,0,1,0,0,0,
17-mar-16,COAH.,"ACUÑA, COAH.",0,1,1,0,0,0,
18-mar-16,COAH.,"TORREÓN, COAH.",1,0,1,0,0,50,
18-mar-16,COAH.,"SABINAS, COAH.",0,1,1,0,0,0,
18-mar-16,COAH.,"SALTILLO, COAH.",1,0,1,0,0,46,
18-mar-16,COAH.,"GENERAL CEPEDA, COAH.",1,0,1,0,0,0,
19-mar-16,HGO.,"PACHUCA DE SOTO, HGO.",1,0,1,0,1,0,
19-mar-16,HGO.,"VILLA DE TEZONTEPEC, HGO.",1,0,1,0,0,0,
19-mar-16,B.C.S.,"MULEGÉ, B.C.S.",0,1,1,0,0,0,
19-mar-16,HGO.,"NOPALA DE VILLAGRAN, HGO.",1,0,1,0,0,0,
20-mar-16,GTO.,"SALAMANCA, GTO.",1,0,1,0,0,0,
21-mar-16,ZAC.,"RIO GRANDE, ZAC.",1,0,1,0,0,0,
21-mar-16,GTO.,"SALAMANCA, GTO.",1,0,1,0,4,0,
22-mar-16,GRO.,"IGUALA DE LA INDEPENDENCIA, GRO.",1,0,1,1,0,0,
24-mar-16,GRO.,"TELOLOAPAN, GRO.",0,1,1,0,0,0,
25-mar-16,COAH.,"SABINAS, COAH.",1,0,1,0,0,0,
28-mar-16,COAH.,"TORREÓN, COAH.",0,1,1,1,0,40,
28-mar-16,COAH.,"SAN PEDRO, COAH.",1,0,1,0,0,0,
28-mar-16,COAH.,"MONCLOVA, COAH.",1,0,1,3,1,69,
28-mar-16,COAH.,"GENERAL CEPEDA, COAH.",1,0,1,0,0,0,
29-mar-16,OAX.,"CIUDAD IXTEPEC, OAX.",0,1,1,0,1,0,
29-mar-16,COAH.,"MATAMOROS, COAH.",1,0,1,0,0,0,
29-mar-16,COAH.,"SABINAS, COAH.",0,1,1,0,0,0,
30-mar-16,COAH.,"MONCLOVA, COAH.",0,1,1,0,0,0,
30-mar-16,COAH.,"SABINAS, COAH.",1,0,1,0,0,0,
30-mar-16,OAX.,"MIAHUATLAN DE PORFIRIO DIAZ, OAX.",0,1,1,0,0,0,
30-mar-16,GRO.,"IGUALA DE LA INDEPENDENCIA, GRO.",0,1,1,0,0,0,
31-mar-16,COAH.,"SAN PEDRO, COAH.",1,0,1,0,0,0,
01-abr-16,GRO.,"IGUALA DE LA INDEPENDENCIA, GRO.",1,0,1,0,0,0,
01-abr-16,OAX.,"MIAHUATLAN DE PORFIRIO DIAZ, OAX.",0,1,1,0,0,20,
02-abr-16,CHIH.,"AHUMADA, CHIH.",1,0,1,0,0,0,
02-abr-16,TAMPS.,"REYNOSA, TAMPS.",0,1,1,0,0,0,
03-abr-16,GRO.,"TELOLOAPAN, GRO.",1,0,1,0,0,0,
03-abr-16,GRO.,"IGUALA DE LA INDEPENDENCIA, GRO.",1,0,1,0,0,0,
04-abr-16,GTO.,"SALAMANCA, GTO.",1,0,1,0,0,0,
05-abr-16,TAB.,"CUNDUACAN, TAB.",1,0,1,0,0,0,
05-abr-16,COAH.,"MONCLOVA, COAH.",1,0,1,0,0,0,
05-abr-16,COAH.,"SAN PEDRO, COAH.",1,0,1,0,0,0,
05-abr-16,COAH.,"SABINAS, COAH.",1,0,1,0,2,0,
05-abr-16,COAH.,"SALTILLO, COAH.",1,0,1,0,0,200,
05-abr-16,COAH.,"SAN PEDRO, COAH.",1,0,1,0,0,0,
06-abr-16,S.L.P.,"SAN LUIS POTOSI, S.L.P.",1,0,1,0,0,0,
06-abr-16,COAH.,"MONCLOVA, COAH.",1,0,1,0,0,0,
06-abr-16,COAH.,"SAN PEDRO, COAH.",1,0,1,0,0,0,
07-abr-16,CHIS.,"CATAZAJÁ, CHIS.",1,0,1,0,0,0,
08-abr-16,S.L.P.,"SOLEDAD DE GRACIANO SANCHEZ, S.L.P.",1,0,1,0,8,0,
08-abr-16,TAB.,"TENOSIQUE, TAB.",1,0,1,0,0,0,
08-abr-16,COAH.,"MONCLOVA, COAH.",0,1,1,0,0,16,
08-abr-16,COAH.,"ACUÑA, COAH.",1,0,1,0,0,0,
09-abr-16,TAMPS.,"MATAMOROS, TAMPS.",0,1,1,0,0,140,
09-abr-16,S.L.P.,"CIUDAD VALLES, S.L.P.",1,0,1,1,0,0,
11-abr-16,S.L.P.,"CIUDAD VALLES, S.L.P.",1,0,1,0,0,3,
11-abr-16,COAH.,"FRANCISCO I. MADERO, COAH.",1,0,1,0,0,0,
11-abr-16,COAH.,"RAMOS ARIZPE, COAH.",1,0,1,0,0,0,
12-abr-16,S.L.P.,"CIUDAD VALLES, S.L.P.",1,0,1,0,0,0,
12-abr-16,S.L.P.,"SAN LUIS POTOSI, S.L.P.",1,0,1,0,0,0,
12-abr-16,S.L.P.,"SAN LUIS POTOSI, S.L.P.",1,0,1,0,1,0,
13-abr-16,S.L.P.,"SAN LUIS POTOSI, S.L.P.",1,0,1,0,0,0,
13-abr-16,COAH.,"MONCLOVA, COAH.",0,1,1,1,0,64,
14-abr-16,YUC.,"MUNA, YUC.",1,0,1,0,0,0,
14-abr-16,COAH.,"FRANCISCO I. MADERO, COAH.",1,0,1,0,0,0,
14-abr-16,COAH.,"MATAMOROS, COAH.",1,0,1,0,0,0,
14-abr-16,COAH.,"ACUÑA, COAH.",1,0,1,0,0,0,
16-abr-16,S.L.P.,"CIUDAD VALLES, S.L.P.",1,0,1,0,1,0,
16-abr-16,S.L.P.,"SOLEDAD DE GRACIANO SANCHEZ, S.L.P.",1,0,1,0,0,0,
16-abr-16,DGO.,"DGO., DGO.",1,0,1,0,0,0,
16-abr-16,COAH.,"SALTILLO, COAH.",1,0,1,19,0,0,
17-abr-16,S.L.P.,"EBANO, S.L.P.",1,0,1,0,1,0,
17-abr-16,S.L.P.,"SAN LUIS POTOSI, S.L.P.",1,0,1,3,0,0,
18-abr-16,COAH.,"SAN PEDRO, COAH.",1,0,1,0,0,0,
18-abr-16,COAH.,"SAN PEDRO, COAH.",1,0,1,0,0,0,
18-abr-16,COAH.,"SALTILLO, COAH.",1,0,1,0,0,0,
18-abr-16,COAH.,"ACUÑA, COAH.",1,0,1,0,0,0,
19-abr-16,TAB.,"CUNDUACAN, TAB.",1,0,1,0,0,0,
19-abr-16,GRO.,"PEDRO ASCENCIO ALQUISIRAS, GRO.",1,0,1,0,0,0,
19-abr-16,COAH.,"MATAMOROS, COAH.",1,0,1,0,0,0,
19-abr-16,COAH.,"RAMOS ARIZPE, COAH.",1,0,1,0,0,0,
20-abr-16,GRO.,"PEDRO ASCENCIO ALQUISIRAS, GRO.",1,0,1,0,0,0,
20-abr-16,COAH.,"MATAMOROS, COAH.",1,0,1,0,0,0,
20-abr-16,COAH.,"ACUÑA, COAH.",1,0,1,0,0,0,
21-abr-16,GRO.,"CHILPANCINGO DE LOS BRAVO, GRO.",1,0,1,0,0,0,
21-abr-16,COAH.,"TORREÓN, COAH.",0,1,1,0,0,0,
21-abr-16,COAH.,"FRANCISCO I. MADERO, COAH.",0,1,1,0,0,0,
21-abr-16,COAH.,"ACUÑA, COAH.",0,1,1,0,0,0,
22-abr-16,COAH.,"TORREÓN, COAH.",0,1,1,0,0,0,
22-abr-16,COAH.,"FRANCISCO I. MADERO, COAH.",1,0,1,0,0,0,
22-abr-16,COAH.,"ACUÑA, COAH.",0,1,1,0,0,0,
25-abr-16,COAH.,"MONCLOVA, COAH.",0,1,1,0,0,51,
25-abr-16,COAH.,"SALTILLO, COAH.",1,0,1,1,0,190,
26-abr-16,COAH.,"ACUÑA, COAH.",1,0,1,0,0,0,
27-abr-16,GRO.,"ATOYAC DE ALVAREZ, GRO.",0,1,1,0,0,0,
27-abr-16,CHIS.,"MAZATÁN, CHIS.",0,1,1,0,0,0,
27-abr-16,COAH.,"PIEDRAS NEGRAS, COAH.",0,1,1,0,0,0,
27-abr-16,COAH.,"MONCLOVA, COAH.",1,0,1,0,0,0,
27-abr-16,COAH.,"SALTILLO, COAH.",1,0,1,0,0,50,
27-abr-16,COAH.,"ACUÑA, COAH.",1,0,1,0,0,0,
28-abr-16,COAH.,"TORREÓN, COAH.",1,0,1,0,0,0,
28-abr-16,GRO.,"ATOYAC DE ALVAREZ, GRO.",1,0,1,0,0,0,
28-abr-16,GRO.,"CHILPANCINGO DE LOS BRAVO, GRO.",1,0,1,0,0,0,
29-abr-16,GRO.,"PUNGARABATO, GRO.",1,0,1,0,0,0,
30-abr-16,COAH.,"FRANCISCO I. MADERO, COAH.",1,0,1,0,0,0,
01-may-16,COAH.,"FRANCISCO I. MADERO, COAH.",0,1,1,0,0,0,
02-may-16,COAH.,"RAMOS ARIZPE, COAH.",1,0,1,0,0,0,
02-may-16,GTO.,"MANUEL DOBLADO, GTO.",0,1,1,0,0,0,
03-may-16,COAH.,"TORREÓN, COAH.",1,0,1,0,0,0,
03-may-16,COAH.,"SALTILLO, COAH.",1,0,1,0,0,0,
03-may-16,DGO.,"DGO., DGO.",1,0,1,0,0,0,
04-may-16,GTO.,"MANUEL DOBLADO, GTO.",0,1,1,0,0,0,
05-may-16,COAH.,"SABINAS, COAH.",1,0,1,0,0,0,
05-may-16,GRO.,"COYUCA DE BENITEZ, GRO.",1,0,1,0,0,0,
05-may-16,TAB.,"TENOSIQUE, TAB.",1,0,1,0,0,0,
06-may-16,COAH.,"MONCLOVA, COAH.",1,0,1,0,0,0,
06-may-16,COAH.,"SAN PEDRO, COAH.",1,0,1,0,0,0,
06-may-16,COAH.,"SABINAS, COAH.",1,0,1,0,0,0,
06-may-16,COAH.,"SALTILLO, COAH.",1,0,1,0,0,0,
06-may-16,COAH.,"ACUÑA, COAH.",0,1,1,0,0,0,
06-may-16,GTO.,"ROMITA, GTO.",1,0,1,0,0,0,
06-may-16,GRO.,"CHILPANCINGO DE LOS BRAVO, GRO.",1,0,1,0,0,0,
07-may-16,GTO.,"ROMITA, GTO.",0,1,1,0,0,0,
07-may-16,GRO.,"COYUCA DE CATALAN, GRO.",0,1,1,0,0,0,
07-may-16,COAH.,"SAN PEDRO, COAH.",0,1,1,0,0,0,
07-may-16,COAH.,"SALTILLO, COAH.",1,0,1,0,0,0,
08-may-16,DGO.,"DGO., DGO.",0,1,1,0,0,0,
09-may-16,GTO.,"ROMITA, GTO.",1,0,1,0,0,0,
10-may-16,DGO.,"DGO., DGO.",1,0,1,0,0,0,
10-may-16,GRO.,"COYUCA DE CATALAN, GRO.",0,1,1,0,0,0,
10-may-16,COAH.,"TORREÓN, COAH.",1,0,1,1,0,28,
11-may-16,COAH.,"SALTILLO, COAH.",1,0,1,0,0,0,
11-may-16,COAH.,"ACUÑA, COAH.",0,1,1,0,0,0,
12-may-16,COAH.,"PIEDRAS NEGRAS, COAH.",0,1,1,2,0,10,
12-may-16,COAH.,"SABINAS, COAH.",0,1,1,0,0,0,
12-may-16,COAH.,"ACUÑA, COAH.",0,1,1,0,0,0,
12-may-16,GRO.,"CHILPANCINGO DE LOS BRAVO, GRO.",1,0,1,0,0,0,
12-may-16,GRO.,"COYUCA DE CATALAN, GRO.",0,1,1,0,0,0,
13-may-16,GTO.,"ROMITA, GTO.",1,0,1,0,0,0,
14-may-16,COAH.,"MATAMOROS, COAH.",1,0,1,0,0,0,
16-may-16,COAH.,"TORREÓN, COAH.",1,0,1,0,0,0,
16-may-16,COAH.,"FRANCISCO I. MADERO, COAH.",0,1,1,0,0,0,
16-may-16,COAH.,"SALTILLO, COAH.",1,0,1,0,0,0,
17-may-16,COAH.,"TORREÓN, COAH.",1,0,1,0,0,0,
17-may-16,COAH.,"SALTILLO, COAH.",1,0,1,0,0,0,
18-may-16,COAH.,"MONCLOVA, COAH.",1,0,1,0,0,38,
18-may-16,COAH.,"TORREÓN, COAH.",0,1,1,0,0,0,
18-may-16,GRO.,"BUENAVISTA DE CUELLAR, GRO.",1,0,1,0,0,0,
18-may-16,DGO.,"DGO., DGO.",0,1,1,0,0,0,
19-may-16,COAH.,"TORREÓN, COAH.",1,0,1,0,0,0,
19-may-16,COAH.,"TORREÓN, COAH.",1,0,1,0,0,0,
19-may-16,N.L.,"MONTERREY, N.L.",1,0,1,50,0,100,
19-may-16,CHIS.,"MAZATÁN, CHIS.",1,0,1,0,0,0,
20-may-16,COAH.,"SABINAS, COAH.",1,0,1,0,0,0,
21-may-16,DGO.,"DGO., DGO.",1,0,1,0,0,0,
21-may-16,COAH.,"TORREÓN, COAH.",1,0,1,0,0,0,
23-may-16,GRO.,"CUTZAMALA DE PINZON, GRO.",1,0,1,0,0,0,
25-may-16,COAH.,"FRANCISCO I. MADERO, COAH.",1,0,1,1,0,18,
25-may-16,COAH.,"SALTILLO, COAH.",0,1,1,0,0,0,
27-may-16,COAH.,"RAMOS ARIZPE, COAH.",0,1,1,0,0,165,
27-may-16,DGO.,"DGO., DGO.",1,0,1,1,0,0,
28-may-16,COAH.,"FRANCISCO I. MADERO, COAH.",1,0,1,0,0,0,
28-may-16,COAH.,"FRANCISCO I. MADERO, COAH.",0,1,1,0,0,0,
30-may-16,GTO.,"MANUEL DOBLADO, GTO.",0,1,1,0,0,0,
30-may-16,COAH.,"FRANCISCO I. MADERO, COAH.",1,0,1,0,0,0,
30-may-16,COAH.,"SALTILLO, COAH.",1,0,1,0,0,0,
30-may-16,N.L.,"MONTERREY, N.L.",1,0,1,0,0,404,
01-jun-16,COAH.,"FRANCISCO I. MADERO, COAH.",0,1,1,0,0,0,
02-jun-16,N.L.,"APODACA, N.L.",1,0,1,0,0,100,
02-jun-16,COAH.,"FRANCISCO I. MADERO, COAH.",0,1,1,0,0,0,
02-jun-16,COAH.,"MATAMOROS, COAH.",1,0,1,0,0,0,
02-jun-16,COAH.,"SABINAS, COAH.",1,0,1,0,0,0,
02-jun-16,N.L.,"APODACA, N.L.",0,1,1,0,0,350,
04-jun-16,COAH.,"SAN PEDRO, COAH.",1,0,1,0,0,0,
04-jun-16,COAH.,"SAN PEDRO, COAH.",1,0,1,0,0,0,
05-jun-16,N.L.,"APODACA, N.L.",1,0,1,0,1,89,
06-jun-16,COAH.,"TORREÓN, COAH.",0,1,1,0,0,0,
07-jun-16,COAH.,"FRANCISCO I. MADERO, COAH.",1,0,1,0,0,0,
07-jun-16,COAH.,"MONCLOVA, COAH.",1,0,1,0,1,33,
08-jun-16,COAH.,"MONCLOVA, COAH.",1,0,1,0,0,0,
08-jun-16,N.L.,"APODACA, N.L.",1,0,1,0,0,0,
09-jun-16,COAH.,"TORREÓN, COAH.",0,1,1,0,0,0,
09-jun-16,COAH.,"FRANCISCO I. MADERO, COAH.",1,0,1,0,0,0,
09-jun-16,COAH.,"SABINAS, COAH.",0,1,1,2,0,0,
10-jun-16,GRO.,"ALPOYECA, GRO.",0,1,1,0,0,0,
10-jun-16,N.L.,"SAN NICOLAS DE LOS GARZA, N.L.",1,0,1,0,2,3000,
10-jun-16,COAH.,"TORREÓN, COAH.",1,0,1,0,0,0,
10-jun-16,COAH.,"TORREÓN, COAH.",1,0,1,0,0,0,
10-jun-16,COAH.,"SALTILLO, COAH.",1,0,1,0,0,0,
12-jun-16,N.L.,"SAN NICOLAS DE LOS GARZA, N.L.",1,0,1,0,0,103,
13-jun-16,COAH.,"FRANCISCO I. MADERO, COAH.",1,0,1,0,0,0,
13-jun-16,COAH.,"MONCLOVA, COAH.",1,0,1,0,0,0,
13-jun-16,COAH.,"FRANCISCO I. MADERO, COAH.",1,0,1,3,0,0,
13-jun-16,COAH.,"SALTILLO, COAH.",1,0,1,0,0,0,
14-jun-16,COAH.,"TORREÓN, COAH.",1,0,1,0,0,0,
14-jun-16,COAH.,"SAN PEDRO, COAH.",0,1,1,0,0,0,
14-jun-16,COAH.,"RAMOS ARIZPE, COAH.",0,1,1,2,0,0,
15-jun-16,COAH.,"TORREÓN, COAH.",0,1,1,0,0,0,
15-jun-16,COAH.,"SABINAS, COAH.",1,0,1,0,0,0,
15-jun-16,N.L.,"CADEREYTA JIMENEZ, N.L.",1,0,1,0,0,25,
17-jun-16,COAH.,"TORREÓN, COAH.",0,1,1,0,0,0,
17-jun-16,COAH.,"FRANCISCO I. MADERO, COAH.",1,0,1,0,0,0,
17-jun-16,PUE.,"XICOTEPEC, PUE.",1,0,1,0,0,0,
18-jun-16,COAH.,"SABINAS, COAH.",1,0,1,0,0,0,
18-jun-16,VER.,"TANTOYUCA, VER.",0,1,1,0,0,0,
19-jun-16,N.L.,"SAN PEDRO GARZA GARCIA, N.L.",1,0,1,0,0,4116,
20-jun-16,COAH.,"FRANCISCO I. MADERO, COAH.",0,1,1,0,0,0,
20-jun-16,COAH.,"SAN PEDRO, COAH.",0,1,1,0,0,0,
20-jun-16,N.L.,"SANTA CATARINA, N.L.",1,0,1,0,0,0,
21-jun-16,N.L.,"SANTA CATARINA, N.L.",0,1,1,0,0,0,
21-jun-16,COAH.,"SABINAS, COAH.",1,0,1,0,0,0,
21-jun-16,COAH.,"SALTILLO, COAH.",1,0,1,0,0,0,
21-jun-16,PUE.,"PUE., PUE.",1,0,1,0,0,0,
22-jun-16,COAH.,"SALTILLO, COAH.",0,1,1,0,0,0,
22-jun-16,COAH.,"SABINAS, COAH.",1,0,1,0,0,0,
22-jun-16,YUC.,"KANTUNIL, YUC.",1,0,1,0,0,0,
23-jun-16,SIN.,"MAZATLAN, SIN.",1,0,1,0,9,0,
23-jun-16,PUE.,"PUE., PUE.",1,0,1,0,0,0,
23-jun-16,COAH.,"SALTILLO, COAH.",1,0,1,0,0,104,
23-jun-16,COAH.,"RAMOS ARIZPE, COAH.",1,0,1,0,0,0,
23-jun-16,VER.,"COATZACOALCOS, VER.",0,1,1,0,0,0,
24-jun-16,VER.,"TANTOYUCA, VER.",1,0,1,0,0,0,
24-jun-16,COAH.,"SAN PEDRO, COAH.",0,1,1,0,0,0,
24-jun-16,COAH.,"SALTILLO, COAH.",0,1,1,0,0,0,
24-jun-16,COAH.,"SABINAS, COAH.",1,0,1,0,0,0,
25-jun-16,VER.,"TUXPAM, VER.",1,0,1,0,0,0,
26-jun-16,GRO.,"HUAMUXTITLAN, GRO.",0,1,1,0,0,0,
26-jun-16,N.L.,"GARCIA, N.L.",1,0,1,0,0,0,
27-jun-16,COAH.,"TORREÓN, COAH.",0,1,1,0,0,0,
28-jun-16,COAH.,"MONCLOVA, COAH.",0,1,1,0,0,96,
28-jun-16,COAH.,"FRANCISCO I. MADERO, COAH.",0,1,1,0,0,0,
28-jun-16,COAH.,"SALTILLO, COAH.",1,0,1,0,0,50,
28-jun-16,COAH.,"RAMOS ARIZPE, COAH.",1,0,1,0,0,0,
28-jun-16,COAH.,"MÚZQUIZ, COAH.",0,1,1,0,0,0,
28-jun-16,CHIH.,"HGO. DEL PARRAL, CHIH.",0,1,1,0,0,0,
28-jun-16,COAH.,"TORREÓN, COAH.",0,1,1,0,0,0,
28-jun-16,HGO.,"PACHUCA DE SOTO, HGO.",1,0,1,0,0,0,
29-jun-16,N.L.,"SABINAS HGO., N.L.",1,0,1,0,0,0,
29-jun-16,COAH.,"SALTILLO, COAH.",1,0,1,1,0,0,
29-jun-16,COAH.,"ACUÑA, COAH.",0,1,1,0,0,0,
30-jun-16,N.L.,"GARCIA, N.L.",1,0,1,0,0,95,
01-jul-16,COAH.,"FRANCISCO I. MADERO, COAH.",1,0,1,0,0,0,
01-jul-16,COAH.,"MONCLOVA, COAH.",1,0,1,0,0,0,
01-jul-16,COAH.,"SABINAS, COAH.",1,0,1,0,0,0,
02-jul-16,COAH.,"NUEVA ROSITA, COAH.",1,0,1,0,0,0,
04-jul-16,COAH.,"SAN PEDRO, COAH.",1,0,1,0,0,0,
04-jul-16,COAH.,"RAMOS ARIZPE, COAH.",1,0,1,0,0,41,
04-jul-16,COAH.,"MONCLOVA, COAH.",0,1,1,0,0,1,
05-jul-16,COAH.,"FRANCISCO I. MADERO, COAH.",1,0,1,0,0,0,
05-jul-16,COAH.,"SAN PEDRO, COAH.",1,0,1,0,0,0,
05-jul-16,COAH.,"MATAMOROS, COAH.",1,0,1,0,0,0,
06-jul-16,COAH.,"MÚZQUIZ, COAH.",1,0,1,0,0,73,
06-jul-16,YUC.,"KANTUNIL, YUC.",1,0,1,0,0,4,
07-jul-16,SIN.,"COSALA, SIN.",0,1,1,0,0,0,
08-jul-16,ZAC.,"CALERA, ZAC.",1,0,1,0,0,0,
08-jul-16,COAH.,"SALTILLO, COAH.",1,0,1,0,0,50,
08-jul-16,COAH.,"MONCLOVA, COAH.",0,1,1,0,0,0,
08-jul-16,HGO.,"ZEMPOALA, HGO.",1,0,1,0,0,0,
09-jul-16,COAH.,"SAN PEDRO, COAH.",1,0,1,0,0,0,
11-jul-16,N.L.,"SALINAS VICTORIA, N.L.",1,0,1,0,0,533,
11-jul-16,N.L.,"VALLECILLO, N.L.",1,0,1,0,0,0,
11-jul-16,SIN.,"SAN IGNACIO, SIN.",0,1,1,0,0,0,
11-jul-16,N.L.,"SALINAS VICTORIA, N.L.",0,1,1,0,0,0,
12-jul-16,SIN.,"SAN IGNACIO, SIN.",1,0,1,0,0,0,
13-jul-16,SIN.,"SAN IGNACIO, SIN.",1,0,1,0,0,0,
13-jul-16,COAH.,"MONCLOVA, COAH.",1,0,1,0,0,0,
14-jul-16,ZAC.,"GUADALUPE, ZAC.",1,0,1,0,0,750,
14-jul-16,COAH.,"RAMOS ARIZPE, COAH.",1,0,1,0,0,0,
14-jul-16,COAH.,"FRANCISCO I. MADERO, COAH.",0,1,1,0,0,0,
14-jul-16,COAH.,"MONCLOVA, COAH.",0,1,1,0,0,36,
15-jul-16,COAH.,"TORREÓN, COAH.",1,0,1,1,0,23,
15-jul-16,COAH.,"SAN PEDRO, COAH.",1,0,1,0,0,31,
15-jul-16,COAH.,"SALTILLO, COAH.",1,0,1,0,0,0,
15-jul-16,ZAC.,"GUADALUPE, ZAC.",1,0,1,0,0,36,
15-jul-16,SIN.,"COSALA, SIN.",1,0,1,0,0,0,
18-jul-16,COAH.,"SAN PEDRO, COAH.",1,0,1,0,0,0,
18-jul-16,COAH.,"SALTILLO, COAH.",1,0,1,0,0,0,
19-jul-16,COAH.,"MONCLOVA, COAH.",0,1,1,0,0,50,
19-jul-16,COAH.,"PIEDRAS NEGRAS, COAH.",0,1,1,0,0,0,
19-jul-16,COAH.,"ACUÑA, COAH.",0,1,1,0,0,0,
19-jul-16,TAB.,"TEAPA, TAB.",1,0,1,0,0,0,
21-jul-16,B.C.,"TIJUANA, B.C.",1,0,1,0,0,0,
21-jul-16,B.C.,"MEXICALI, B.C.",1,0,1,0,0,0,
21-jul-16,COAH.,"FRANCISCO I. MADERO, COAH.",1,0,1,1,0,0,
21-jul-16,COAH.,"SALTILLO, COAH.",1,0,1,5,1,267,
21-jul-16,B.C.,"TIJUANA, B.C.",0,1,1,0,0,0,
21-jul-16,B.C.,"TIJUANA, B.C.",1,0,1,0,0,0,
22-jul-16,CHIS.,"CATAZAJÁ, CHIS.",1,0,1,0,0,0,
22-jul-16,TLAX.,"TLAX., TLAX.",0,1,1,0,0,0,
22-jul-16,N.L.,"GUADALUPE, N.L.",1,0,1,0,0,11,
23-jul-16,CHIH.,"HGO. DEL PARRAL, CHIH.",1,0,1,0,0,0,
23-jul-16,N.L.,"GUADALUPE, N.L.",1,0,1,0,0,55,
23-jul-16,COAH.,"FRANCISCO I. MADERO, COAH.",1,0,1,0,0,0,
24-jul-16,TLAX.,"HUAMANTLA, TLAX.",0,1,1,0,0,0,
25-jul-16,TLAX.,"CHIAUTEMPAN, TLAX.",0,1,1,0,0,0,
25-jul-16,ZAC.,"GUADALUPE, ZAC.",1,0,1,0,0,1748,
25-jul-16,CAMP.,"PALIZADA, CAMP.",1,0,1,0,0,0,
25-jul-16,N.L.,"GUADALUPE, N.L.",0,1,1,0,0,82,
26-jul-16,COAH.,"TORREÓN, COAH.",1,0,1,0,0,0,
26-jul-16,COAH.,"MONCLOVA, COAH.",0,1,1,0,0,0,
26-jul-16,COAH.,"TORREÓN, COAH.",1,0,1,0,0,0,
26-jul-16,COAH.,"PIEDRAS NEGRAS, COAH.",0,1,1,0,0,0,
26-jul-16,B.C.,"TIJUANA, B.C.",0,1,1,0,0,0,
26-jul-16,HGO.,"PACHUCA DE SOTO, HGO.",0,1,1,0,3,0,
26-jul-16,HGO.,"APAN, HGO.",0,1,1,0,0,0,
26-jul-16,TLAX.,"CHIAUTEMPAN, TLAX.",1,0,1,0,0,0,
26-jul-16,CHIH.,"HGO. DEL PARRAL, CHIH.",1,0,1,0,0,0,
27-jul-16,COAH.,"MONCLOVA, COAH.",1,0,1,0,0,40,
27-jul-16,N.L.,"MONTERREY, N.L.",1,0,1,0,0,0,
27-jul-16,HGO.,"YAHUALICA, HGO.",1,0,1,0,0,0,
28-jul-16,N.L.,"MONTERREY, N.L.",1,0,1,0,0,0,
28-jul-16,HGO.,"APAN, HGO.",0,1,1,0,0,0,
28-jul-16,ZAC.,"GUADALUPE, ZAC.",1,0,1,0,0,181,
28-jul-16,COAH.,"MONCLOVA, COAH.",1,0,1,0,1,0,
28-jul-16,COAH.,"ACUÑA, COAH.",0,1,1,0,0,0,
29-jul-16,TLAX.,"CUAPIAXTLA, TLAX.",1,0,1,0,0,0,
29-jul-16,COAH.,"MONCLOVA, COAH.",1,0,1,0,0,25,
29-jul-16,COAH.,"MÚZQUIZ, COAH.",1,0,1,1,0,0,
29-jul-16,N.L.,"MONTERREY, N.L.",1,0,1,0,0,0,
29-jul-16,ZAC.,"CALERA, ZAC.",1,0,1,0,0,1000,
29-jul-16,TLAX.,"CUAPIAXTLA, TLAX.",1,0,1,0,0,0,
01-ago-16,B.C.,"TIJUANA, B.C.",0,1,1,0,0,0,
01-ago-16,ZAC.,"GUADALUPE, ZAC.",1,0,1,0,0,0,
01-ago-16,COAH.,"SABINAS, COAH.",1,0,1,0,0,0,
01-ago-16,COAH.,"ACUÑA, COAH.",0,1,1,0,0,0,
02-ago-16,COAH.,"TORREÓN, COAH.",1,0,1,0,0,0,
02-ago-16,COAH.,"FRANCISCO I. MADERO, COAH.",1,0,1,0,0,0,
02-ago-16,COAH.,"SAN PEDRO, COAH.",1,0,1,0,0,0,
02-ago-16,COAH.,"SALTILLO, COAH.",1,0,1,0,0,0,
02-ago-16,COAH.,"MONCLOVA, COAH.",0,1,1,0,0,213,
02-ago-16,SIN.,"ELOTA, SIN.",1,0,1,0,1,0,
03-ago-16,COAH.,"SALTILLO, COAH.",1,0,1,0,0,20,
04-ago-16,B.C.,"TIJUANA, B.C.",0,1,1,0,0,0,
04-ago-16,COAH.,"SALTILLO, COAH.",1,0,1,0,0,0,
04-ago-16,N.L.,"GRAL. ESCOBEDO, N.L.",1,0,1,0,0,0,
04-ago-16,TLAX.,"APIZACO, TLAX.",1,0,1,0,0,0,
05-ago-16,COAH.,"SALTILLO, COAH.",1,0,1,2,1,0,
05-ago-16,COAH.,"RAMOS ARIZPE, COAH.",0,1,1,0,0,0,
06-ago-16,SON.,"HERMOSILLO, SON.",1,0,1,0,0,20,
06-ago-16,N.L.,"GRAL. ESCOBEDO, N.L.",1,0,1,0,0,0,
07-ago-16,TLAX.,"APIZACO, TLAX.",1,0,1,0,0,0,
07-ago-16,S.L.P.,"SAN LUIS POTOSI, S.L.P.",1,0,1,0,0,107,
08-ago-16,MEX.,"METEPEC, MEX.",1,0,1,0,0,0,
08-ago-16,MEX.,"LERMA, MEX.",1,0,1,0,0,0,
08-ago-16,B.C.,"TIJUANA, B.C.",1,0,1,0,0,0,
08-ago-16,COAH.,"SAN PEDRO, COAH.",1,0,1,0,0,0,
08-ago-16,COAH.,"MONCLOVA, COAH.",1,0,1,1,0,180,
08-ago-16,S.L.P.,"CIUDAD VALLES, S.L.P.",0,1,1,0,0,0,
09-ago-16,HGO.,"PACHUCA DE SOTO, HGO.",0,1,1,0,0,0,
09-ago-16,SIN.,"NAVOLATO, SIN.",0,1,1,0,0,0,
09-ago-16,B.C.,"MEXICALI, B.C.",0,1,1,0,0,0,
09-ago-16,S.L.P.,"CIUDAD VALLES, S.L.P.",1,0,1,1,1,0,
10-ago-16,SIN.,"ELOTA, SIN.",1,0,1,0,0,0,
10-ago-16,HGO.,"PACHUCA DE SOTO, HGO.",0,1,1,0,0,0,
10-ago-16,COAH.,"SALTILLO, COAH.",1,0,1,0,0,0,
10-ago-16,COAH.,"PIEDRAS NEGRAS, COAH.",0,1,1,0,0,0,
10-ago-16,COAH.,"MÚZQUIZ, COAH.",1,0,1,0,0,0,
10-ago-16,SON.,"GUAYMAS, SON.",1,0,1,1,0,38,
11-ago-16,SON.,"GUAYMAS, SON.",1,0,1,0,0,82,
11-ago-16,SON.,"CAJEME, SON.",1,0,1,0,0,0,
11-ago-16,CHIH.,"HGO. DEL PARRAL, CHIH.",1,0,1,0,0,95,
12-ago-16,TLAX.,"TLAXCO, TLAX.",0,1,1,0,0,0,
12-ago-16,B.C.,"MEXICALI, B.C.",0,1,1,0,0,0,
12-ago-16,TAB.,"TEAPA, TAB.",1,0,1,1,0,1,
12-ago-16,SON.,"HERMOSILLO, SON.",1,0,1,1,0,0,
12-ago-16,SON.,"GUAYMAS, SON.",1,0,1,0,0,0,
12-ago-16,SON.,"CAJEME, SON.",1,0,1,0,0,0,
12-ago-16,SIN.,"NAVOLATO, SIN.",1,0,1,0,3,0,
14-ago-16,TLAX.,"ZACATELCO, TLAX.",1,0,1,1,0,0,
14-ago-16,Q. ROO,"BACALAR, Q. ROO",1,0,1,0,2,101,
16-ago-16,CHIH.,"GUADALUPE, CHIH.",0,1,1,0,0,0,
16-ago-16,COAH.,"SALTILLO, COAH.",1,0,1,0,0,0,
16-ago-16,COAH.,"RAMOS ARIZPE, COAH.",1,0,1,0,0,0,
16-ago-16,COAH.,"ACUÑA, COAH.",0,1,1,0,0,0,
16-ago-16,N.L.,"SAN NICOLAS DE LOS GARZA, N.L.",1,0,1,0,0,264,
16-ago-16,CHIH.,"HGO. DEL PARRAL, CHIH.",1,0,1,0,0,14,
17-ago-16,CHIH.,"HGO. DEL PARRAL, CHIH.",1,0,1,0,0,212,
17-ago-16,TLAX.,"CALPULALPAN, TLAX.",0,1,1,0,0,0,
18-ago-16,N.L.,"SAN NICOLAS DE LOS GARZA, N.L.",1,0,1,0,0,0,
18-ago-16,B.C.,"ENSENADA, B.C.",0,1,1,0,0,0,
18-ago-16,SON.,"CAJEME, SON.",0,1,1,0,0,0,
18-ago-16,COAH.,"MATAMOROS, COAH.",1,0,1,0,0,0,
18-ago-16,COAH.,"MONCLOVA, COAH.",1,0,1,0,0,0,
18-ago-16,COAH.,"PIEDRAS NEGRAS, COAH.",0,1,1,0,0,0,
18-ago-16,N.L.,"SAN NICOLAS DE LOS GARZA, N.L.",1,0,1,0,0,0,
18-ago-16,SIN.,"BADIRAGUATO, SIN.",1,0,1,0,0,0,
19-ago-16,SIN.,"BADIRAGUATO, SIN.",0,1,1,0,0,0,
19-ago-16,CHIH.,"HGO. DEL PARRAL, CHIH.",1,0,1,0,1,362,
19-ago-16,Q. ROO,"BENITO JUAREZ, Q. ROO",1,0,1,0,0,453,
19-ago-16,B.C.,"ENSENADA, B.C.",1,0,1,0,0,0,
19-ago-16,COAH.,"TORREÓN, COAH.",0,1,1,0,0,0,
19-ago-16,COAH.,"SAN PEDRO, COAH.",1,0,1,0,0,0,
19-ago-16,COAH.,"RAMOS ARIZPE, COAH.",1,0,1,0,0,0,
20-ago-16,B.C.S.,"COMONDÚ, B.C.S.",0,1,1,0,0,0,
20-ago-16,N.L.,"SAN NICOLAS DE LOS GARZA, N.L.",1,0,1,0,0,0,
20-ago-16,COAH.,"ALLENDE, COAH.",0,1,1,0,0,0,
20-ago-16,TAMPS.,"MATAMOROS, TAMPS.",0,1,1,4,0,40,
21-ago-16,TLAX.,"CALPULALPAN, TLAX.",1,0,1,0,0,0,
21-ago-16,MEX.,"ZUMPANGO, MEX.",0,1,1,0,0,8,
21-ago-16,N.L.,"SAN NICOLAS DE LOS GARZA, N.L.",1,0,1,0,0,62,
21-ago-16,B.C.,"TIJUANA, B.C.",1,0,1,0,0,0,
23-ago-16,SON.,"GUAYMAS, SON.",1,0,1,0,0,0,
23-ago-16,N.L.,"CADEREYTA JIMENEZ, N.L.",1,0,1,0,0,0,
24-ago-16,SON.,"HERMOSILLO, SON.",1,0,1,11,0,0,
24-ago-16,N.L.,"SAN NICOLAS DE LOS GARZA, N.L.",0,1,1,0,0,151,
25-ago-16,SIN.,"BADIRAGUATO, SIN.",1,0,1,0,0,0,
25-ago-16,B.C.,"MEXICALI, B.C.",0,1,1,0,0,0,
26-ago-16,SON.,"CAJEME, SON.",1,0,1,0,0,0,
26-ago-16,B.C.,"TIJUANA, B.C.",1,0,1,2,0,0,
26-ago-16,B.C.,"ENSENADA, B.C.",1,0,1,0,0,0,
26-ago-16,B.C.,"TIJUANA, B.C.",0,1,1,0,0,0,
27-ago-16,CHIH.,"HGO. DEL PARRAL, CHIH.",1,0,1,0,0,0,
27-ago-16,TLAX.,"PANOTLA, TLAX.",1,0,1,0,0,0,
28-ago-16,TAMPS.,"MATAMOROS, TAMPS.",1,0,1,0,0,0,
29-ago-16,COAH.,"SALTILLO, COAH.",1,0,1,0,0,0,
29-ago-16,COAH.,"MONCLOVA, COAH.",1,0,1,0,0,30,
29-ago-16,COAH.,"TORREÓN, COAH.",1,0,1,0,1,0,
29-ago-16,COAH.,"SAN PEDRO, COAH.",1,0,1,0,0,0,
29-ago-16,COAH.,"ACUÑA, COAH.",1,0,1,0,0,0,
29-ago-16,TAB.,"CARDENAS, TAB.",1,0,1,0,0,0,
30-ago-16,SON.,"HERMOSILLO, SON.",1,0,1,25,0,0,
30-ago-16,COL.,"COL., COL.",1,0,1,0,0,335,
30-ago-16,OAX.,"OAX. DE JUAREZ, OAX.",0,1,1,0,0,0,
30-ago-16,SON.,"GUAYMAS, SON.",1,0,1,24,0,0,
30-ago-16,CHIS.,"TUXTLA GUTIÉRREZ, CHIS.",1,0,1,0,0,0,
30-ago-16,TAB.,"COMALCALCO, TAB.",1,0,1,1,0,2,
30-ago-16,COAH.,"SAN PEDRO, COAH.",0,1,1,0,0,0,
30-ago-16,COAH.,"SALTILLO, COAH.",0,1,1,0,0,0,
30-ago-16,B.C.,"ENSENADA, B.C.",1,0,1,0,0,0,
30-ago-16,TAMPS.,"NUEVO LAREDO, TAMPS.",1,0,1,0,0,0,
31-ago-16,COAH.,"TORREÓN, COAH.",1,0,1,0,0,0,
31-ago-16,COAH.,"SAN PEDRO, COAH.",0,1,1,0,0,0,
31-ago-16,COAH.,"SALTILLO, COAH.",1,0,1,0,0,0,
31-ago-16,COAH.,"MÚZQUIZ, COAH.",0,1,1,0,0,0,
31-ago-16,CHIH.,"HGO. DEL PARRAL, CHIH.",1,0,1,22,0,0,
01-sep-16,MEX.,"OTZOLOTEPEC, MEX.",0,1,1,0,0,0,
01-sep-16,OAX.,"SAN JUAN BAUTISTA TUXTEPEC, OAX.",1,0,1,0,0,0,
01-sep-16,COAH.,"SAN PEDRO, COAH.",1,0,1,1,0,0,
02-sep-16,COAH.,"ACUÑA, COAH.",0,1,1,0,0,0,
02-sep-16,N.L.,"SAN PEDRO GARZA GARCIA, N.L.",1,0,1,0,0,400,
02-sep-16,OAX.,"SAN JUAN BAUTISTA TUXTEPEC, OAX.",0,1,1,0,0,0,
02-sep-16,MEX.,"CHICONCUAC, MEX.",1,0,1,0,0,216,
03-sep-16,GRO.,"IGUALA DE LA INDEPENDENCIA, GRO.",0,1,1,0,0,0,
03-sep-16,MEX.,"OTZOLOTEPEC, MEX.",0,1,1,0,0,3,
03-sep-16,MEX.,"SAN MATEO ATENCO, MEX.",0,1,1,0,0,3,
03-sep-16,OAX.,"OAX. DE JUAREZ, OAX.",1,0,1,0,0,0,
04-sep-16,N.L.,"SAN PEDRO GARZA GARCIA, N.L.",1,0,1,0,0,0,
04-sep-16,N.L.,"SANTA CATARINA, N.L.",1,0,1,1,0,1944,
04-sep-16,SON.,"HERMOSILLO, SON.",1,0,1,34,0,0,
04-sep-16,SON.,"CAJEME, SON.",1,0,1,0,0,0,
04-sep-16,COAH.,"MATAMOROS, COAH.",1,0,1,0,0,0,
04-sep-16,CHIH.,"HGO. DEL PARRAL, CHIH.",0,1,1,0,0,0,
04-sep-16,MEX.,"CHICONCUAC, MEX.",0,1,1,0,0,0,
04-sep-16,B.C.,"ENSENADA, B.C.",1,0,1,0,1,0,
05-sep-16,OAX.,"OAX. DE JUAREZ, OAX.",1,0,1,0,0,0,
05-sep-16,OAX.,"SANTO DOMINGO TEPUXTEPEC, OAX.",1,0,1,0,0,0,
05-sep-16,MEX.,"VILLA GRO., MEX.",1,0,1,0,0,0,
05-sep-16,COAH.,"SALTILLO, COAH.",1,0,1,7,0,0,
06-sep-16,SON.,"HERMOSILLO, SON.",1,0,1,73,0,933,
06-sep-16,SON.,"CAJEME, SON.",1,0,1,0,0,0,
06-sep-16,COAH.,"TORREÓN, COAH.",1,0,1,0,0,0,
06-sep-16,N.L.,"SAN PEDRO GARZA GARCIA, N.L.",1,0,1,0,0,0,
07-sep-16,COAH.,"MÚZQUIZ, COAH.",0,1,1,0,0,0,
07-sep-16,OAX.,"CIUDAD IXTEPEC, OAX.",1,0,1,0,0,0,
08-sep-16,OAX.,"SAN JUAN BAUTISTA TUXTEPEC, OAX.",1,0,1,1,0,49,
08-sep-16,MEX.,"VILLA GRO., MEX.",0,1,1,0,0,0,
09-sep-16,MEX.,"VILLA GRO., MEX.",1,0,1,0,0,0,
09-sep-16,SON.,"HERMOSILLO, SON.",1,0,1,59,0,219,
09-sep-16,N.L.,"SANTA CATARINA, N.L.",1,0,1,0,0,50,
09-sep-16,OAX.,"SAN JUAN BAUTISTA TUXTEPEC, OAX.",1,0,1,0,0,0,
10-sep-16,SON.,"HERMOSILLO, SON.",1,0,1,0,0,40,
10-sep-16,TAMPS.,"MATAMOROS, TAMPS.",1,0,1,2,0,109,
10-sep-16,GRO.,"TEPECOACUILCO DE TRUJANO, GRO.",1,0,1,0,0,0,
12-sep-16,OAX.,"CIUDAD IXTEPEC, OAX.",0,1,1,0,0,0,
12-sep-16,OAX.,"SAN JUAN BAUTISTA TUXTEPEC, OAX.",0,1,1,0,0,0,
12-sep-16,CHIH.,"HGO. DEL PARRAL, CHIH.",1,0,1,0,0,277,
12-sep-16,B.C.,"TIJUANA, B.C.",0,1,1,0,0,0,
13-sep-16,SON.,"HERMOSILLO, SON.",0,1,1,1,0,800,
14-sep-16,B.C.,"TIJUANA, B.C.",0,1,1,0,0,0,
14-sep-16,B.C.,"MEXICALI, B.C.",0,1,1,0,0,0,
14-sep-16,OAX.,"SAN JUAN BAUTISTA TUXTEPEC, OAX.",1,0,1,1,0,0,
14-sep-16,B.C.,"TIJUANA, B.C.",0,1,1,0,0,0,
15-sep-16,B.C.,"MEXICALI, B.C.",0,1,1,0,0,0,
15-sep-16,OAX.,"SAN JUAN BAUTISTA TUXTEPEC, OAX.",0,1,1,1,0,0,
15-sep-16,PUE.,"PUE., PUE.",1,0,1,0,0,0,
15-sep-16,SON.,"HERMOSILLO, SON.",1,0,1,0,0,0,
19-sep-16,SIN.,"CONCORDIA, SIN.",0,1,1,0,3,0,
19-sep-16,COAH.,"ACUÑA, COAH.",0,1,1,0,0,7,
19-sep-16,SON.,"CAJEME, SON.",1,0,1,0,0,0,
20-sep-16,OAX.,"OAX. DE JUAREZ, OAX.",1,0,1,0,0,0,
20-sep-16,OAX.,"SAN JUAN BAUTISTA TUXTEPEC, OAX.",0,1,1,0,0,0,
20-sep-16,GRO.,"PUNGARABATO, GRO.",1,0,1,0,0,0,
20-sep-16,COAH.,"MATAMOROS, COAH.",1,0,1,0,0,139,
20-sep-16,MEX.,"VILLA DEL CARBON, MEX.",0,1,1,0,0,0,
21-sep-16,SON.,"GUAYMAS, SON.",1,0,1,1,0,5,
21-sep-16,B.C.,"TIJUANA, B.C.",1,0,1,0,0,0,
21-sep-16,PUE.,"PUE., PUE.",1,0,1,12,0,101,
22-sep-16,SON.,"HERMOSILLO, SON.",1,0,1,36,0,65,
22-sep-16,MEX.,"TULTITLAN, MEX.",1,0,1,0,0,0,
22-sep-16,SIN.,"CONCORDIA, SIN.",0,1,1,0,0,0,
22-sep-16,GRO.,"PUNGARABATO, GRO.",1,0,1,0,0,0,
23-sep-16,VER.,"TANTOYUCA, VER.",1,0,1,0,0,0,
24-sep-16,COAH.,"JIMÉNEZ, COAH.",0,1,1,0,0,0,
26-sep-16,COAH.,"FRANCISCO I. MADERO, COAH.",0,1,1,0,0,0,
26-sep-16,COAH.,"SAN PEDRO, COAH.",0,1,1,0,0,0,
26-sep-16,COAH.,"MONCLOVA, COAH.",1,0,1,0,0,0,
26-sep-16,COAH.,"SALTILLO, COAH.",0,1,1,0,0,0,
27-sep-16,SON.,"HERMOSILLO, SON.",0,1,1,0,0,0,
27-sep-16,MEX.,"TLALMANALCO, MEX.",0,1,1,0,1,0,
27-sep-16,MEX.,"TEMASCALCINGO, MEX.",1,0,1,0,0,0,
27-sep-16,COAH.,"SAN PEDRO, COAH.",1,0,1,0,0,0,
27-sep-16,COAH.,"MATAMOROS, COAH.",1,0,1,1,0,0,
27-sep-16,COAH.,"ACUÑA, COAH.",0,1,1,0,0,0,
27-sep-16,COAH.,"PIEDRAS NEGRAS, COAH.",1,0,1,0,0,0,
27-sep-16,VER.,"POZA RICA DE HGO., VER.",1,0,1,0,0,0,
28-sep-16,COAH.,"MONCLOVA, COAH.",1,0,1,0,0,42,
28-sep-16,PUE.,"PUE., PUE.",1,0,1,0,0,0,
29-sep-16,MOR.,"XOCHITEPEC, MOR.",1,0,1,2,2,106,
29-sep-16,SIN.,"CONCORDIA, SIN.",1,0,1,0,4,0,
30-sep-16,COAH.,"SAN PEDRO, COAH.",1,0,1,0,0,0,
30-sep-16,COAH.,"MATAMOROS, COAH.",0,1,1,0,0,0,
30-sep-16,COAH.,"MONCLOVA, COAH.",0,1,1,0,0,683,
01-oct-16,COAH.,"SABINAS, COAH.",1,0,1,0,0,0,
01-oct-16,COAH.,"MÚZQUIZ, COAH.",0,1,1,0,0,52,
01-oct-16,SON.,"GUAYMAS, SON.",0,1,1,0,0,0,
01-oct-16,MEX.,"CALIMAYA, MEX.",1,0,1,0,0,0,
01-oct-16,B.C.,"MEXICALI, B.C.",1,0,1,0,0,0,
03-oct-16,SON.,"HERMOSILLO, SON.",1,0,1,0,0,240,
03-oct-16,VER.,"MARTINEZ DE LA TORRE, VER.",1,0,1,0,0,0,
04-oct-16,B.C.,"TIJUANA, B.C.",0,1,1,0,0,0,
04-oct-16,B.C.,"MEXICALI, B.C.",0,1,1,0,0,0,
04-oct-16,VER.,"MARTINEZ DE LA TORRE, VER.",1,0,1,1,0,0,
04-oct-16,MEX.,"TEPOTZOTLAN, MEX.",1,0,1,1,0,34,
04-oct-16,COAH.,"FRANCISCO I. MADERO, COAH.",1,0,1,0,0,0,
05-oct-16,VER.,"MARTINEZ DE LA TORRE, VER.",0,1,1,0,0,0,
05-oct-16,COAH.,"MONCLOVA, COAH.",0,1,1,0,0,0,
05-oct-16,MEX.,"NICOLAS ROMERO, MEX.",1,0,1,1,0,0,
05-oct-16,COAH.,"MONCLOVA, COAH.",0,1,1,0,0,0,
06-oct-16,COAH.,"FRANCISCO I. MADERO, COAH.",1,0,1,0,0,0,
06-oct-16,COAH.,"SABINAS, COAH.",1,0,1,0,0,0,
06-oct-16,N.L.,"VALLECILLO, N.L.",1,0,1,0,0,0,
06-oct-16,PUE.,"PUE., PUE.",0,1,1,0,0,0,
06-oct-16,SON.,"CAJEME, SON.",1,0,1,0,0,0,
06-oct-16,MEX.,"TEPOTZOTLAN, MEX.",0,1,1,0,0,288,
06-oct-16,HGO.,"TEPEJI DEL RIO DE OCAMPO, HGO.",1,0,1,0,0,442,
07-oct-16,SON.,"HERMOSILLO, SON.",1,0,1,1,0,100,
07-oct-16,MEX.,"NICOLAS ROMERO, MEX.",1,0,1,1,0,0,
07-oct-16,N.L.,"VALLECILLO, N.L.",1,0,1,0,0,0,
08-oct-16,MEX.,"TEOLOYUCAN, MEX.",1,0,1,0,0,0,
10-oct-16,B.C.,"MEXICALI, B.C.",0,1,1,0,0,0,
10-oct-16,SON.,"HERMOSILLO, SON.",1,0,1,0,0,0,
10-oct-16,COAH.,"TORREÓN, COAH.",1,0,1,0,0,0,
10-oct-16,HGO.,"PACHUCA DE SOTO, HGO.",1,0,1,0,0,0,
10-oct-16,TAB.,"CENTRO, TAB.",1,0,1,0,0,0,
10-oct-16,SIN.,"SALVADOR ALVARADO, SIN.",1,0,1,0,0,0,
10-oct-16,MOR.,"XOCHITEPEC, MOR.",0,1,1,0,4,0,
11-oct-16,COAH.,"MONCLOVA, COAH.",1,0,1,1,0,7,
11-oct-16,MOR.,"XOCHITEPEC, MOR.",0,1,1,0,0,0,
11-oct-16,VER.,"CAMERINO Z. MENDOZA, VER.",1,0,1,0,0,19,
12-oct-16,CHIS.,"TAPACHULA, CHIS.",1,0,1,0,0,0,
12-oct-16,SIN.,"ROSARIO, SIN.",1,0,1,0,0,0,
13-oct-16,VER.,"CAMERINO Z. MENDOZA, VER.",0,1,1,0,0,0,
13-oct-16,MEX.,"TEQUIXQUIAC, MEX.",1,0,1,0,0,0,
13-oct-16,COAH.,"TORREÓN, COAH.",0,1,1,0,0,0,
13-oct-16,VER.,"POZA RICA DE HGO., VER.",1,0,1,0,0,0,
13-oct-16,MEX.,"TIANGUISTENCO, MEX.",1,0,1,15,0,0,
14-oct-16,N.L.,"MONTERREY, N.L.",1,0,1,0,0,0,
14-oct-16,VER.,"MARTINEZ DE LA TORRE, VER.",1,0,1,0,0,0,
14-oct-16,VER.,"CAMERINO Z. MENDOZA, VER.",1,0,1,0,0,0,
14-oct-16,OAX.,"OAX. DE JUAREZ, OAX.",1,0,1,1,0,0,
14-oct-16,SIN.,"ROSARIO, SIN.",1,0,1,0,0,0,
14-oct-16,HGO.,"TEPEJI DEL RIO DE OCAMPO, HGO.",0,1,1,0,0,0,
14-oct-16,HGO.,"TULANCINGO DE BRAVO, HGO.",1,0,1,0,0,0,
15-oct-16,HGO.,"MOLANGO DE ESCAMILLA, HGO.",0,1,1,0,0,0,
15-oct-16,B.C.,"TIJUANA, B.C.",1,0,1,0,0,0,
16-oct-16,VER.,"POZA RICA DE HGO., VER.",1,0,1,0,0,0,
17-oct-16,B.C.,"MEXICALI, B.C.",0,1,1,0,0,0,
18-oct-16,MEX.,"NEXTLALPAN, MEX., MEX.",1,0,1,0,0,0,
18-oct-16,COAH.,"MONCLOVA, COAH.",1,0,1,1,0,66,
18-oct-16,COAH.,"MATAMOROS, COAH.",1,0,1,0,0,0,
18-oct-16,COAH.,"TORREÓN, COAH.",0,1,1,0,0,0,
19-oct-16,HGO.,"TEPEJI DEL RIO DE OCAMPO, HGO.",1,0,1,0,0,0,
19-oct-16,MEX.,"NEXTLALPAN, MEX., MEX.",0,1,1,0,0,20,
19-oct-16,MOR.,"XOCHITEPEC, MOR.",1,0,1,2,0,0,
20-oct-16,MOR.,"XOCHITEPEC, MOR.",1,0,1,0,0,250,
20-oct-16,TAB.,"PARAISO, TAB.",0,1,1,2,0,0,
20-oct-16,N.L.,"MONTERREY, N.L.",1,0,1,0,0,1200,
20-oct-16,MEX.,"AYAPANGO, MEX.",0,1,1,0,0,0,
20-oct-16,OAX.,"OAX. DE JUAREZ, OAX.",0,1,1,0,0,0,
21-oct-16,TAB.,"TENOSIQUE, TAB.",1,0,1,0,0,0,
21-oct-16,TAB.,"BALANCAN, TAB.",0,1,1,0,0,0,
21-oct-16,SIN.,"ESCUINAPA, SIN.",0,1,1,0,0,0,
21-oct-16,B.C.,"ENSENADA, B.C.",0,1,1,0,0,0,
22-oct-16,MEX.,"JILOTEPEC, MEX.",1,0,1,0,0,0,
22-oct-16,MEX.,"POLOTITLAN, MEX.",1,0,1,0,0,0,
22-oct-16,SON.,"HERMOSILLO, SON.",1,0,1,0,0,0,
23-oct-16,MOR.,"XOCHITEPEC, MOR.",1,0,1,1,0,0,
23-oct-16,MEX.,"MEXICALTZINGO, MEX.",1,0,1,0,0,0,
24-oct-16,HGO.,"TULANCINGO DE BRAVO, HGO.",1,0,1,0,0,0,
24-oct-16,GRO.,"AJUCHITLAN DEL PROGRESO, GRO.",0,1,1,0,0,0,
25-oct-16,CHIS.,"PALENQUE, CHIS.",1,0,1,0,0,0,
25-oct-16,COAH.,"TORREÓN, COAH.",1,0,1,0,0,0,
25-oct-16,COAH.,"MATAMOROS, COAH.",1,0,1,1,0,0,
25-oct-16,VER.,"CORDOBA, VER.",1,0,1,0,0,0,
25-oct-16,B.C.,"ENSENADA, B.C.",0,1,1,0,0,0,
25-oct-16,SIN.,"ESCUINAPA, SIN.",0,1,1,0,4,0,
25-oct-16,TAB.,"CENTRO, TAB.",0,1,1,1,0,7,
25-oct-16,CHIS.,"TAPACHULA, CHIS.",0,1,1,0,0,0,
25-oct-16,MEX.,"XONACATLAN, MEX.",1,0,1,2,0,0,
25-oct-16,COAH.,"TORREÓN, COAH.",0,1,1,0,0,0,
26-oct-16,VER.,"CORDOBA, VER.",1,0,1,0,0,0,
26-oct-16,CHIS.,"TAPACHULA, CHIS.",0,1,1,0,0,0,
26-oct-16,SON.,"HERMOSILLO, SON.",1,0,1,0,0,0,
26-oct-16,COAH.,"TORREÓN, COAH.",0,1,1,0,0,0,
27-oct-16,GRO.,"AJUCHITLAN DEL PROGRESO, GRO.",1,0,1,0,0,0,
28-oct-16,N.L.,"GARCIA, N.L.",1,0,1,0,0,500,
28-oct-16,B.C.,"TIJUANA, B.C.",0,1,1,0,0,0,
28-oct-16,B.C.,"MEXICALI, B.C.",0,1,1,0,0,0,
28-oct-16,SIN.,"ESCUINAPA, SIN.",1,0,1,0,1,0,
29-oct-16,MEX.,"XONACATLAN, MEX.",1,0,1,0,2,0,
30-oct-16,GRO.,"SAN MIGUEL TOTOLAPAN, GRO.",0,1,1,0,0,0,
31-oct-16,B.C.,"TIJUANA, B.C.",1,0,1,0,0,0,
31-oct-16,SON.,"HERMOSILLO, SON.",1,0,1,8,0,0,
31-oct-16,SON.,"CAJEME, SON.",1,0,1,1,0,0,
31-oct-16,COAH.,"SALTILLO, COAH.",0,1,1,0,0,500,
31-oct-16,MEX.,"TEXCALYACAC, MEX.",1,0,1,0,0,0,
31-oct-16,MEX.,"COCOTITLAN, MEX.",1,0,1,0,0,0,
02-nov-16,N.L.,"GARCIA, N.L.",1,0,1,24,0,100,
03-nov-16,MEX.,"MELCHOR OCAMPO, MEX.",0,1,1,0,0,0,
03-nov-16,COAH.,"RAMOS ARIZPE, COAH.",1,0,1,0,0,0,
04-nov-16,MEX.,"COCOTITLAN, MEX.",1,0,1,0,0,0,
04-nov-16,SON.,"HERMOSILLO, SON.",1,0,1,40,0,250,
04-nov-16,COAH.,"SALTILLO, COAH.",1,0,1,0,0,0,
04-nov-16,COAH.,"ACUÑA, COAH.",1,0,1,0,0,0,
05-nov-16,MEX.,"MELCHOR OCAMPO, MEX.",0,1,1,1,0,23,
07-nov-16,CHIS.,"PALENQUE, CHIS.",0,1,1,0,0,0,
07-nov-16,SON.,"NOGALES, SON.",0,1,1,0,0,0,
07-nov-16,SON.,"SANTA ANA, SON.",0,1,1,0,0,0,
07-nov-16,SON.,"ALTAR, SON.",1,0,1,1,0,0,
07-nov-16,SON.,"SAN LUIS RIO COLORADO, SON.",1,0,1,0,0,0,
07-nov-16,SON.,"CABORCA, SON.",0,1,1,1,0,0,
07-nov-16,SON.,"PITIQUITO, SON.",1,0,1,0,0,0,
07-nov-16,SON.,"PUERTO PEÑASCO, SON.",1,0,1,0,0,0,
07-nov-16,SON.,"GENERAL PLUTARCO ELIAS CALLES, SON.",0,1,1,1,0,0,
07-nov-16,SON.,"SAHUARIPA, SON.",1,0,1,0,0,0,
07-nov-16,SON.,"BENITO JUAREZ, SON.",0,1,1,0,0,0,
07-nov-16,SON.,"ALAMOS, SON.",0,1,1,0,0,0,
07-nov-16,MOR.,"YAUTEPEC, MOR.",0,1,1,1,0,0,
07-nov-16,MEX.,"PAPALOTLA, MEX.",1,0,1,0,0,0,
08-nov-16,SON.,"NAVOJOA, SON.",1,0,1,0,0,0,
08-nov-16,SON.,"CABORCA, SON.",1,0,1,0,0,240,
08-nov-16,SON.,"AGUA PRIETA, SON.",1,0,1,0,0,0,
08-nov-16,B.C.,"ENSENADA, B.C.",0,1,1,0,0,0,
08-nov-16,MEX.,"PAPALOTLA, MEX.",0,1,1,0,0,0,
09-nov-16,SON.,"HERMOSILLO, SON.",1,0,1,1,0,0,
09-nov-16,SON.,"BENITO JUAREZ, SON.",1,0,1,0,0,0,
09-nov-16,SON.,"ETCHOJOA, SON.",1,0,1,1,0,0,
09-nov-16,VER.,"COATEPEC, VER.",0,1,1,0,0,0,
09-nov-16,CHIS.,"PALENQUE, CHIS.",1,0,1,0,0,0,
09-nov-16,SON.,"AGUA PRIETA, SON.",1,0,1,2,0,9,
09-nov-16,MOR.,"YAUTEPEC, MOR.",1,0,1,0,0,0,
09-nov-16,MEX.,"PAPALOTLA, MEX.",1,0,1,0,0,0,
10-nov-16,N.L.,"GARCIA, N.L.",0,1,1,0,0,0,
10-nov-16,OAX.,"OAX. DE JUAREZ, OAX.",1,0,1,0,0,0,
10-nov-16,VER.,"COATEPEC, VER.",0,1,1,0,0,10,
10-nov-16,SON.,"NAVOJOA, SON.",0,1,1,3,0,77,
10-nov-16,SON.,"CANANEA, SON.",0,1,1,0,0,0,
10-nov-16,SON.,"GENERAL PLUTARCO ELIAS CALLES, SON.",1,0,1,1,0,0,
11-nov-16,CHIS.,"PALENQUE, CHIS.",1,0,1,0,0,0,
11-nov-16,COAH.,"RAMOS ARIZPE, COAH.",0,1,1,0,0,0,
11-nov-16,SON.,"CANANEA, SON.",0,1,1,0,0,0,
11-nov-16,SON.,"BENITO JUAREZ, SON.",1,0,1,0,0,0,
11-nov-16,OAX.,"OAX. DE JUAREZ, OAX.",0,1,1,0,0,0,
12-nov-16,SON.,"CANANEA, SON.",1,0,1,1,0,26,
12-nov-16,SON.,"CABORCA, SON.",0,1,1,0,0,0,
12-nov-16,SON.,"BENITO JUAREZ, SON.",1,0,1,0,0,0,
12-nov-16,OAX.,"OAX. DE JUAREZ, OAX.",0,1,1,0,0,0,
12-nov-16,B.C.,"MEXICALI, B.C.",0,1,1,0,0,0,
13-nov-16,VER.,"TANTOYUCA, VER.",1,0,1,0,0,0,
14-nov-16,SON.,"HERMOSILLO, SON.",0,1,1,14,0,0,
14-nov-16,SON.,"HUATABAMPO, SON.",1,0,1,2,0,0,
14-nov-16,SON.,"ETCHOJOA, SON.",1,0,1,0,0,0,
15-nov-16,B.C.,"TIJUANA, B.C.",0,1,1,0,0,0,
15-nov-16,MOR.,"YAUTEPEC, MOR.",0,1,1,0,14,0,
15-nov-16,VER.,"CORDOBA, VER.",1,0,1,0,0,29,
15-nov-16,MEX.,"JALTENCO, MEX.",1,0,1,0,0,0,
15-nov-16,SON.,"CANANEA, SON.",1,0,1,0,0,25,
15-nov-16,SON.,"HERMOSILLO, SON.",0,1,1,0,0,200,
16-nov-16,MEX.,"DONATO GUERRA, MEX.",1,0,1,1,0,0,
16-nov-16,B.C.,"TIJUANA, B.C.",0,1,1,0,0,0,
16-nov-16,SON.,"NOGALES, SON.",0,1,1,1,0,27,
16-nov-16,SON.,"CANANEA, SON.",0,1,1,0,0,0,
16-nov-16,SON.,"SAN LUIS RIO COLORADO, SON.",1,0,1,0,0,0,
16-nov-16,SON.,"PITIQUITO, SON.",1,0,1,0,0,0,
16-nov-16,VER.,"CORDOBA, VER.",1,0,1,0,0,35,
17-nov-16,COAH.,"TORREÓN, COAH.",1,0,1,0,0,39,
17-nov-16,MEX.,"MALINALCO, MEX.",0,1,1,0,0,0,
17-nov-16,MEX.,"DONATO GUERRA, MEX.",1,0,1,0,0,0,
17-nov-16,SON.,"NOGALES, SON.",1,0,1,0,0,81,
17-nov-16,SON.,"AGUA PRIETA, SON.",1,0,1,1,0,0,
18-nov-16,TAB.,"CENTRO, TAB.",1,0,1,2,0,20,
18-nov-16,SON.,"HERMOSILLO, SON.",1,0,1,0,0,0,
18-nov-16,MEX.,"DONATO GUERRA, MEX.",1,0,1,0,0,0,
18-nov-16,MEX.,"JALTENCO, MEX.",1,0,1,0,0,0,
18-nov-16,MEX.,"LA PAZ, MEX.",1,0,1,0,0,0,
19-nov-16,MEX.,"MALINALCO, MEX.",1,0,1,0,0,0,
20-nov-16,MEX.,"LA PAZ, MEX.",1,0,1,2,1,0,
21-nov-16,B.C.,"TIJUANA, B.C.",0,1,1,0,0,0,
21-nov-16,SON.,"CAJEME, SON.",1,0,1,0,0,0,
21-nov-16,SON.,"HUATABAMPO, SON.",1,0,1,0,0,0,
22-nov-16,SON.,"NOGALES, SON.",1,0,1,2,0,0,
22-nov-16,COAH.,"TORREÓN, COAH.",1,0,1,0,0,0,
23-nov-16,SON.,"HERMOSILLO, SON.",1,0,1,5,0,50,
23-nov-16,SON.,"NOGALES, SON.",1,0,1,0,0,6,
23-nov-16,SON.,"PITIQUITO, SON.",1,0,1,1,0,0,
23-nov-16,MEX.,"NOPALTEPEC, MEX.",1,0,1,0,0,0,
23-nov-16,MEX.,"JUCHITEPEC, MEX.",1,0,1,0,0,0,
23-nov-16,MEX.,"XALATLACO, MEX.",0,1,1,0,0,0,
23-nov-16,MEX.,"RAYON, MEX.",1,0,1,0,0,0,
23-nov-16,MEX.,"XALATLACO, MEX.",0,1,1,0,0,0,
24-nov-16,SON.,"MAGDALENA, SON.",1,0,1,2,0,60,
24-nov-16,SON.,"CANANEA, SON.",0,1,1,0,0,31,
24-nov-16,SON.,"PUERTO PEÑASCO, SON.",1,0,1,0,0,0,
24-nov-16,TAB.,"JONUTA, TAB.",1,0,1,0,0,0,
24-nov-16,B.C.,"TIJUANA, B.C.",0,1,1,0,0,0,
24-nov-16,MEX.,"JUCHITEPEC, MEX.",1,0,1,0,8,0,
25-nov-16,MICH.,"PATZCUARO, MICH.",1,0,1,0,0,0,
25-nov-16,SON.,"EMPALME, SON.",1,0,1,0,0,0,
25-nov-16,MOR.,"YAUTEPEC, MOR.",0,1,1,0,0,515,
26-nov-16,MEX.,"XALATLACO, MEX.",1,0,1,1,0,0,
26-nov-16,MICH.,"PATZCUARO, MICH.",0,1,1,0,0,0,
26-nov-16,N.L.,"SAN NICOLAS DE LOS GARZA, N.L.",1,0,1,0,0,200,
27-nov-16,MEX.,"JOCOTITLAN, MEX.",0,1,1,0,0,0,
28-nov-16,CHIS.,"PALENQUE, CHIS.",1,0,1,0,0,0,
28-nov-16,MOR.,"YAUTEPEC, MOR.",0,1,1,0,0,51,
28-nov-16,COAH.,"SAN PEDRO, COAH.",1,0,1,0,0,0,
28-nov-16,D.F.,"ALVARO OBREGON, D.F.",0,1,1,0,0,0,
28-nov-16,SON.,"HERMOSILLO, SON.",1,0,1,3,0,46,
28-nov-16,SON.,"ALAMOS, SON.",1,0,1,0,0,0,
28-nov-16,TAB.,"HUIMANGUILLO, TAB.",1,0,1,0,2,0,
28-nov-16,SON.,"PITIQUITO, SON.",0,1,1,0,0,0,
28-nov-16,SON.,"PUERTO PEÑASCO, SON.",1,0,1,1,0,9,
28-nov-16,SON.,"GENERAL PLUTARCO ELIAS CALLES, SON.",0,1,1,1,0,9,
28-nov-16,N.L.,"GARCIA, N.L.",1,0,1,0,0,150,
28-nov-16,MEX.,"AXAPUSCO, MEX.",0,1,1,0,0,0,
29-nov-16,SON.,"HUATABAMPO, SON.",0,1,1,0,0,0,
29-nov-16,SON.,"NAVOJOA, SON.",1,0,1,6,0,0,
29-nov-16,GRO.,"COYUCA DE BENITEZ, GRO.",1,0,1,0,0,0,
29-nov-16,MICH.,"LA PIEDAD, MICH.",0,1,1,0,0,0,
29-nov-16,MEX.,"TEMASCALAPA, MEX.",0,1,1,1,0,0,
29-nov-16,MEX.,"AXAPUSCO, MEX.",0,1,1,0,0,0,
30-nov-16,MEX.,"ACAMBAY, MEX.",1,0,1,0,0,0,
30-nov-16,SON.,"NOGALES, SON.",0,1,1,0,0,14,
30-nov-16,SON.,"CARBO, SON.",0,1,1,14,0,0,
30-nov-16,SON.,"SAN MIGUEL DE HORCASITAS, SON.",0,1,1,6,0,0,
30-nov-16,SON.,"EMPALME, SON.",1,0,1,0,0,0,
30-nov-16,SON.,"HERMOSILLO, SON.",1,0,1,0,0,0,
30-nov-16,SON.,"NAVOJOA, SON.",0,1,1,3,0,0,
30-nov-16,SON.,"ALAMOS, SON.",1,0,1,1,0,0,
01-dic-16,MEX.,"AXAPUSCO, MEX.",1,0,1,0,1,0,
01-dic-16,S.L.P.,"CIUDAD VALLES, S.L.P.",1,0,1,0,0,0,
02-dic-16,MEX.,"AXAPUSCO, MEX.",1,0,1,1,0,0,
02-dic-16,B.C.,"ENSENADA, B.C.",0,1,1,0,0,0,
02-dic-16,S.L.P.,"CIUDAD VALLES, S.L.P.",1,0,1,0,0,0,
02-dic-16,COAH.,"SALTILLO, COAH.",1,0,1,0,0,0,
02-dic-16,MEX.,"COATEPEC HARINAS, MEX.",1,0,1,1,0,0,
03-dic-16,COAH.,"FRANCISCO I. MADERO, COAH.",1,0,1,0,0,0,
03-dic-16,B.C.,"TIJUANA, B.C.",0,1,1,0,0,0,
04-dic-16,S.L.P.,"CIUDAD VALLES, S.L.P.",1,0,1,0,0,0,
05-dic-16,COAH.,"SALTILLO, COAH.",1,0,1,0,3,0,
07-dic-16,D.F.,"IZTAPALAPA, D.F.",1,0,1,0,1,34,
08-dic-16,COAH.,"SALTILLO, COAH.",1,0,1,0,0,0,
08-dic-16,COAH.,"TORREÓN, COAH.",1,0,1,0,0,0,
08-dic-16,S.L.P.,"CIUDAD VALLES, S.L.P.",0,1,1,0,0,130,
08-dic-16,COAH.,"TORREÓN, COAH.",1,0,1,0,0,0,
09-dic-16,COAH.,"SALTILLO, COAH.",1,0,1,0,0,0,
09-dic-16,S.L.P.,"CIUDAD VALLES, S.L.P.",1,0,1,0,0,0,
12-dic-16,HGO.,"PACHUCA DE SOTO, HGO.",0,1,1,0,0,500,
12-dic-16,HGO.,"IXMIQUILPAN, HGO.",1,0,1,0,0,0,
12-dic-16,TAMPS.,"ALTAMIRA, TAMPS.",1,0,1,6,0,180,
13-dic-16,COAH.,"MATAMOROS, COAH.",0,1,1,3,0,0,
13-dic-16,B.C.,"MEXICALI, B.C.",1,0,1,0,0,0,
13-dic-16,D.F.,"VENUSTIANO CARRANZA, D.F.",1,0,1,0,0,0,
13-dic-16,TAB.,"CENTRO, TAB.",1,0,1,6,0,0,
14-dic-16,COAH.,"FRANCISCO I. MADERO, COAH.",1,0,1,0,0,0,
14-dic-16,N.L.,"GRAL. ESCOBEDO, N.L.",1,0,1,0,0,0,
15-dic-16,D.F.,"MIGUEL HGO., D.F.",0,1,1,0,0,0,
15-dic-16,N.L.,"APODACA, N.L.",1,0,1,0,0,0,
15-dic-16,N.L.,"APODACA, N.L.",1,0,1,0,0,0,
16-dic-16,S.L.P.,"SAN LUIS POTOSI, S.L.P.",1,0,1,0,0,0,
16-dic-16,N.L.,"APODACA, N.L.",0,1,1,0,0,0,
16-dic-16,HGO.,"CUAUTEPEC DE HINOJOSA, HGO.",1,0,1,18,0,0,
17-dic-16,TAB.,"CENTRO, TAB.",1,0,1,0,0,0,
18-dic-16,HGO.,"CUAUTEPEC DE HINOJOSA, HGO.",1,0,1,0,0,0,
18-dic-16,HGO.,"IXMIQUILPAN, HGO.",1,0,1,0,0,0,
21-dic-16,D.F.,"CUAUHTEMOC, D.F.",1,0,1,0,0,80,
21-dic-16,TAB.,"TENOSIQUE, TAB.",1,0,1,0,0,0,
21-dic-16,VER.,"TANTOYUCA, VER.",1,0,1,0,0,0,
22-dic-16,B.C.,"TIJUANA, B.C.",1,0,1,0,0,0,
22-dic-16,B.C.,"TIJUANA, B.C.",0,1,1,0,0,0,
23-dic-16,CHIS.,"PALENQUE, CHIS.",0,1,1,0,0,0,
23-dic-16,TAB.,"TENOSIQUE, TAB.",1,0,1,0,1,0,
23-dic-16,B.C.,"TIJUANA, B.C.",0,1,1,0,0,0,
23-dic-16,B.C.,"MEXICALI, B.C.",1,0,1,0,0,0,
27-dic-16,CHIS.,"PALENQUE, CHIS.",0,1,1,0,0,0,
01-ene-17,VER.,"TEMPOAL, VER.",1,0,1,0,0,0,
04-ene-17,B.C.,"TIJUANA, B.C.",1,0,1,0,3,0,
08-ene-17,VER.,"TEMPOAL, VER.",1,0,1,0,0,0,
10-ene-17,B.C.,"MEXICALI, B.C.",1,0,1,0,0,0,
11-ene-17,B.C.,"MEXICALI, B.C.",1,0,1,0,0,0,
12-ene-17,YUC.,"SUDZAL, YUC.",1,0,1,0,0,0,
12-ene-17,D.F.,"CUAUHTEMOC, D.F.",1,0,1,0,0,0,
12-ene-17,B.C.,"MEXICALI, B.C.",0,1,1,0,0,0,
14-ene-17,TAMPS.,"MATAMOROS, TAMPS.",1,0,1,0,0,0,
17-ene-17,B.C.,"MEXICALI, B.C.",0,1,1,0,0,0,
19-ene-17,B.C.,"TIJUANA, B.C.",1,0,1,0,0,0,
20-ene-17,PUE.,"PUE., PUE.",0,1,1,0,0,0,
21-ene-17,DGO.,"SANTIAGO PAPASQUIARO, DGO.",1,0,1,1,0,0,
21-ene-17,DGO.,"GOMEZ PALACIO, DGO.",1,0,1,0,0,0,
23-ene-17,DGO.,"GOMEZ PALACIO, DGO.",1,0,1,0,0,0,
23-ene-17,B.C.,"ENSENADA, B.C.",1,0,1,0,0,0,
24-ene-17,D.F.,"COYOACAN, D.F.",1,0,1,0,0,14,
25-ene-17,TAMPS.,"TAMPICO, TAMPS.",1,0,1,1,0,26,
25-ene-17,CAMP.,"ESCÁRCEGA, CAMP.",1,0,1,0,0,0,
25-ene-17,ZAC.,"TLALTENANGO DE SANCHEZ ROMAN, ZAC.",1,0,1,0,0,0,
25-ene-17,ZAC.,"JEREZ, ZAC.",1,0,1,0,0,6,
25-ene-17,ZAC.,"TLALTENANGO DE SANCHEZ ROMAN, ZAC.",1,0,1,0,0,0,
26-ene-17,ZAC.,"TLALTENANGO DE SANCHEZ ROMAN, ZAC.",1,0,1,0,0,0,
26-ene-17,B.C.,"ENSENADA, B.C.",1,0,1,0,0,0,
26-ene-17,CHIS.,"JUÁREZ, CHIS.",0,1,1,0,0,0,
26-ene-17,COAH.,"SALTILLO, COAH.",1,0,1,0,7,60,
26-ene-17,COAH.,"MONCLOVA, COAH.",1,0,1,0,0,31,
26-ene-17,COAH.,"TORREÓN, COAH.",1,0,1,0,0,0,
26-ene-17,COAH.,"MÚZQUIZ, COAH.",1,0,1,1,0,12,
26-ene-17,COAH.,"TORREÓN, COAH.",1,0,1,0,0,0,
26-ene-17,B.C.,"ENSENADA, B.C.",1,0,1,0,0,0,
27-ene-17,DGO.,"DGO., DGO.",1,0,1,30,0,0,
27-ene-17,ZAC.,"TLALTENANGO DE SANCHEZ ROMAN, ZAC.",0,1,1,0,0,0,
27-ene-17,YUC.,"SINANCHE, YUC.",1,0,1,0,0,0,
27-ene-17,ZAC.,"TLALTENANGO DE SANCHEZ ROMAN, ZAC.",0,1,1,0,0,0,
28-ene-17,COAH.,"TORREÓN, COAH.",0,1,1,0,0,0,
29-ene-17,DGO.,"PUEBLO NUEVO, DGO.",1,0,1,0,0,0,
29-ene-17,MICH.,"MORELIA, MICH.",0,1,1,0,3,329,
29-ene-17,TAMPS.,"TAMPICO, TAMPS.",1,0,1,0,0,39,
29-ene-17,CAMP.,"ESCÁRCEGA, CAMP.",1,0,1,0,0,0,
30-ene-17,COAH.,"MÚZQUIZ, COAH.",0,1,1,0,0,0,
30-ene-17,SIN.,"MAZATLAN, SIN.",1,0,1,0,0,0,
31-ene-17,COAH.,"SALTILLO, COAH.",1,0,1,6,0,225,
31-ene-17,B.C.,"ENSENADA, B.C.",1,0,1,0,0,0,
31-ene-17,TAMPS.,"NUEVO LAREDO, TAMPS.",1,0,1,0,0,0,
31-ene-17,CHIH.,"GUADALUPE, CHIH.",0,1,1,0,0,0,
01-feb-17,DGO.,"SANTIAGO PAPASQUIARO, DGO.",1,0,1,1,0,0,
01-feb-17,CHIH.,"GUADALUPE, CHIH.",0,1,1,0,0,0,
01-feb-17,COAH.,"FRANCISCO I. MADERO, COAH.",1,0,1,0,0,0,
01-feb-17,COAH.,"PIEDRAS NEGRAS, COAH.",0,1,1,0,0,0,
02-feb-17,DGO.,"GOMEZ PALACIO, DGO.",1,0,1,0,0,0,
02-feb-17,COAH.,"SALTILLO, COAH.",1,0,1,0,0,408,
03-feb-17,D.F.,"COYOACAN, D.F.",1,0,1,0,0,0,
03-feb-17,GRO.,"COAHUAYUTLA DE JOSE MARIA IZAZAGA, GRO.",0,1,1,0,0,0,
04-feb-17,COAH.,"MATAMOROS, COAH.",1,0,1,0,0,0,
04-feb-17,COAH.,"MATAMOROS, COAH.",1,0,1,0,0,0,
06-feb-17,SIN.,"MAZATLAN, SIN.",1,0,1,0,0,0,
07-feb-17,COAH.,"TORREÓN, COAH.",1,0,1,0,0,0,
08-feb-17,COAH.,"TORREÓN, COAH.",1,0,1,0,0,0,
08-feb-17,COAH.,"MATAMOROS, COAH.",1,0,1,0,0,0,
08-feb-17,COAH.,"SALTILLO, COAH.",1,0,1,0,0,12,
08-feb-17,COAH.,"PIEDRAS NEGRAS, COAH.",1,0,1,0,0,0,
08-feb-17,VER.,"TUXPAM, VER.",1,0,1,0,0,0,
08-feb-17,CHIS.,"PALENQUE, CHIS.",1,0,1,0,0,0,
08-feb-17,COAH.,"TORREÓN, COAH.",1,0,1,0,0,0,
08-feb-17,COAH.,"MATAMOROS, COAH.",1,0,1,0,0,0,
09-feb-17,GRO.,"ATOYAC DE ALVAREZ, GRO.",1,0,1,0,3,0,
09-feb-17,CHIS.,"JUÁREZ, CHIS.",0,1,1,0,0,0,
10-feb-17,PUE.,"ATLIXCO, PUE.",1,0,1,0,0,0,
10-feb-17,COAH.,"FRANCISCO I. MADERO, COAH.",1,0,1,0,0,0,
10-feb-17,MICH.,"LAZARO CARDENAS, MICH.",1,0,1,0,0,0,
10-feb-17,B.C.S.,"LOS CABOS, B.C.S.",1,0,1,0,0,0,
10-feb-17,COAH.,"FRANCISCO I. MADERO, COAH.",1,0,1,0,0,0,
10-feb-17,COAH.,"MONCLOVA, COAH.",0,1,1,0,0,0,
11-feb-17,B.C.,"MEXICALI, B.C.",1,0,1,0,0,0,
11-feb-17,B.C.S.,"LOS CABOS, B.C.S.",1,0,1,0,0,0,
12-feb-17,B.C.,"MEXICALI, B.C.",0,1,1,0,0,0,
13-feb-17,MICH.,"LAZARO CARDENAS, MICH.",1,0,1,0,0,0,
13-feb-17,GRO.,"COAHUAYUTLA DE JOSE MARIA IZAZAGA, GRO.",0,1,1,0,0,0,
13-feb-17,GRO.,"ACAPULCO DE JUAREZ, GRO.",1,0,1,0,8,37,
13-feb-17,DGO.,"DGO., DGO.",1,0,1,8,0,109,
13-feb-17,MICH.,"TACAMBARO, MICH.",0,1,1,0,0,883,
14-feb-17,COAH.,"TORREÓN, COAH.",0,1,1,0,0,0,
14-feb-17,GRO.,"COAHUAYUTLA DE JOSE MARIA IZAZAGA, GRO.",1,0,1,0,0,0,
14-feb-17,GRO.,"ACAPULCO DE JUAREZ, GRO.",0,1,1,0,1,325,
14-feb-17,VER.,"COATZACOALCOS, VER.",1,0,1,0,0,4,
14-feb-17,TAMPS.,"NUEVO LAREDO, TAMPS.",1,0,1,2,0,53,
14-feb-17,SIN.,"CULIACAN, SIN.",0,1,1,0,4,0,
14-feb-17,COAH.,"TORREÓN, COAH.",0,1,1,0,0,0,
14-feb-17,COAH.,"SALTILLO, COAH.",1,0,1,2,0,140,
14-feb-17,D.F.,"TLAHUAC, D.F.",1,0,1,0,0,162,
14-feb-17,CHIH.,"GUADALUPE, CHIH.",0,1,1,0,0,0,
14-feb-17,MICH.,"LAZARO CARDENAS, MICH.",1,0,1,0,0,62,
15-feb-17,D.F.,"TLAHUAC, D.F.",0,1,1,0,0,0,
15-feb-17,COAH.,"PIEDRAS NEGRAS, COAH.",1,0,1,0,0,0,
16-feb-17,B.C.,"MEXICALI, B.C.",1,0,1,0,0,0,
16-feb-17,COAH.,"MONCLOVA, COAH.",1,0,1,1,0,0,
16-feb-17,DGO.,"DGO., DGO.",1,0,1,0,0,0,
16-feb-17,VER.,"COATZACOALCOS, VER.",1,0,1,0,0,0,
16-feb-17,GRO.,"COAHUAYUTLA DE JOSE MARIA IZAZAGA, GRO.",0,1,1,0,0,0,
17-feb-17,MICH.,"LAZARO CARDENAS, MICH.",1,0,1,2,0,0,
17-feb-17,B.C.,"MEXICALI, B.C.",0,1,1,0,0,0,
18-feb-17,COAH.,"SAN PEDRO, COAH.",0,1,1,0,0,0,
18-feb-17,COAH.,"SALTILLO, COAH.",1,0,1,0,0,0,
18-feb-17,TAB.,"CENTRO, TAB.",1,0,1,0,0,0,
19-feb-17,B.C.,"TIJUANA, B.C.",1,0,1,0,0,0,
20-feb-17,ZAC.,"MOMAX, ZAC.",1,0,1,0,0,0,
20-feb-17,GRO.,"COYUCA DE BENITEZ, GRO.",1,0,1,0,0,0,
20-feb-17,D.F.,"IZTACALCO, D.F.",1,0,1,0,0,0,
20-feb-17,GRO.,"LA UNION DE ISIDORO MONTES DE OCA, GRO.",0,1,1,0,0,0,
20-feb-17,ZAC.,"TEPECHITLAN, ZAC.",1,0,1,0,0,0,
20-feb-17,ZAC.,"MOMAX, ZAC.",1,0,1,0,0,0,
20-feb-17,DGO.,"GOMEZ PALACIO, DGO.",1,0,1,0,0,0,
21-feb-17,CHIH.,"NUEVO CASAS GRANDES, CHIH.",1,0,1,1,1,18,
21-feb-17,MICH.,"LAZARO CARDENAS, MICH.",1,0,1,0,0,0,
22-feb-17,COAH.,"TORREÓN, COAH.",0,1,1,0,0,0,
22-feb-17,SIN.,"CULIACAN, SIN.",1,0,1,1,0,0,
22-feb-17,SIN.,"MAZATLAN, SIN.",1,0,1,0,0,0,
22-feb-17,YUC.,"MOTUL, YUC.",1,0,1,0,0,0,
22-feb-17,VER.,"SAN RAFAEL, VER.",1,0,1,0,0,0,
22-feb-17,VER.,"POZA RICA DE HGO., VER.",0,1,1,0,0,164,
22-feb-17,YUC.,"MOTUL, YUC.",1,0,1,0,0,0,
22-feb-17,D.F.,"ALVARO OBREGON, D.F.",0,1,1,0,0,0,
23-feb-17,D.F.,"ALVARO OBREGON, D.F.",1,0,1,0,0,0,
23-feb-17,B.C.,"ENSENADA, B.C.",1,0,1,0,0,0,
23-feb-17,CHIH.,"GUADALUPE, CHIH.",0,1,1,0,0,11,
23-feb-17,MICH.,"LAZARO CARDENAS, MICH.",1,0,1,0,0,0,
24-feb-17,CHIH.,"GUACHOCHI, CHIH.",0,1,1,0,0,0,
24-feb-17,D.F.,"IZTAPALAPA, D.F.",1,0,1,0,0,0,
24-feb-17,DGO.,"GOMEZ PALACIO, DGO.",0,1,1,0,0,0,
24-feb-17,COAH.,"SALTILLO, COAH.",1,0,1,0,0,0,
24-feb-17,JAL.,"PUERTO VALLARTA, JAL.",0,1,1,0,0,0,
27-feb-17,ZAC.,"JALPA, ZAC.",1,0,1,0,0,71,
27-feb-17,VER.,"COATZACOALCOS, VER.",1,0,1,0,0,0,
28-feb-17,COAH.,"MATAMOROS, COAH.",1,0,1,0,0,0,
01-mar-17,PUE.,"PUE., PUE.",0,1,1,0,0,0,
02-mar-17,D.F.,"IZTAPALAPA, D.F.",1,0,1,0,0,0,
03-mar-17,TAB.,"NACAJUCA, TAB.",1,0,1,0,0,5,
03-mar-17,OAX.,"SAN JUAN BAUTISTA TUXTEPEC, OAX.",1,0,1,0,0,0,
03-mar-17,VER.,"FORTIN, VER.",1,0,1,0,0,34,
03-mar-17,TAMPS.,"NUEVO LAREDO, TAMPS.",1,0,1,1,0,56,
03-mar-17,CHIH.,"HGO. DEL PARRAL, CHIH.",1,0,1,0,0,0,
04-mar-17,COAH.,"PIEDRAS NEGRAS, COAH.",1,0,1,0,0,105,
06-mar-17,HGO.,"TULANCINGO DE BRAVO, HGO.",1,0,1,0,0,0,
07-mar-17,COAH.,"TORREÓN, COAH.",1,0,1,0,0,0,
07-mar-17,COAH.,"MATAMOROS, COAH.",1,0,1,1,0,16,
07-mar-17,COAH.,"MÚZQUIZ, COAH.",1,0,1,1,0,4,
08-mar-17,HGO.,"TULANCINGO DE BRAVO, HGO.",0,1,1,0,0,0,
08-mar-17,GRO.,"PUNGARABATO, GRO.",1,0,1,0,0,0,
08-mar-17,MICH.,"LAZARO CARDENAS, MICH.",1,0,1,0,0,0,
09-mar-17,D.F.,"IZTAPALAPA, D.F.",1,0,1,0,0,0,
09-mar-17,COAH.,"PIEDRAS NEGRAS, COAH.",1,0,1,1,0,0,
09-mar-17,VER.,"COSOLEACAQUE, VER.",1,0,1,0,0,302,
09-mar-17,OAX.,"OAX. DE JUAREZ, OAX.",1,0,1,0,0,0,
09-mar-17,OAX.,"MIAHUATLAN DE PORFIRIO DIAZ, OAX.",0,1,1,0,0,5,
09-mar-17,D.F.,"IZTACALCO, D.F.",1,0,1,0,0,0,
09-mar-17,TAMPS.,"EL MANTE, TAMPS.",1,0,1,0,0,0,
10-mar-17,COAH.,"FRANCISCO I. MADERO, COAH.",1,0,1,0,0,0,
10-mar-17,MEX.,"SAN FELIPE DEL PROGRESO, MEX.",1,0,1,0,0,0,
10-mar-17,VER.,"COSOLEACAQUE, VER.",1,0,1,0,0,604,
11-mar-17,PUE.,"PUE., PUE.",1,0,1,0,0,0,
11-mar-17,COAH.,"FRANCISCO I. MADERO, COAH.",1,0,1,0,0,0,
11-mar-17,JAL.,"CIHUATLAN, JAL.",1,0,1,0,0,0,
11-mar-17,QRO.,"QUERETARO, QRO.",0,1,1,0,0,0,
12-mar-17,MEX.,"SAN FELIPE DEL PROGRESO, MEX.",1,0,1,0,0,0,
13-mar-17,VER.,"COSOLEACAQUE, VER.",1,0,1,0,0,77,
13-mar-17,MICH.,"TACAMBARO, MICH.",1,0,1,1,0,7,
13-mar-17,OAX.,"CIUDAD IXTEPEC, OAX.",1,0,1,0,0,0,
14-mar-17,HGO.,"TULANCINGO DE BRAVO, HGO.",1,0,1,0,1,0,
14-mar-17,MEX.,"VALLE DE CHALCO SOLIDARIDAD, MEX.",1,0,1,0,0,0,
14-mar-17,VER.,"COSOLEACAQUE, VER.",1,0,1,2,0,68,
14-mar-17,MICH.,"TACAMBARO, MICH.",1,0,1,0,0,390,
14-mar-17,COAH.,"ACUÑA, COAH.",0,1,1,0,0,0,
14-mar-17,OAX.,"CIUDAD IXTEPEC, OAX.",1,0,1,0,0,0,
14-mar-17,CHIH.,"HGO. DEL PARRAL, CHIH.",1,0,1,0,0,24,
15-mar-17,OAX.,"PINOTEPA DE DON LUIS, OAX.",1,0,1,4,0,0,
15-mar-17,CHIH.,"HGO. DEL PARRAL, CHIH.",1,0,1,1,0,145,
15-mar-17,TAMPS.,"TAMPICO, TAMPS.",1,0,1,1,0,68,
15-mar-17,D.F.,"IZTAPALAPA, D.F.",1,0,1,0,0,6500,
15-mar-17,HGO.,"ZIMAPAN, HGO.",1,0,1,0,0,0,
15-mar-17,COAH.,"TORREÓN, COAH.",1,0,1,0,0,0,
16-mar-17,OAX.,"SAN JUAN BAUTISTA TUXTEPEC, OAX.",0,1,1,0,0,0,
16-mar-17,OAX.,"CIUDAD IXTEPEC, OAX.",1,0,1,0,0,0,
16-mar-17,COAH.,"TORREÓN, COAH.",1,0,1,0,0,0,
16-mar-17,COAH.,"TORREÓN, COAH.",1,0,1,0,0,0,
16-mar-17,N.L.,"MONTERREY, N.L.",0,1,1,3,0,60,
16-mar-17,N.L.,"SALINAS VICTORIA, N.L.",0,1,1,3,0,300,
16-mar-17,GRO.,"PUNGARABATO, GRO.",0,1,1,0,0,0,
16-mar-17,COAH.,"TORREÓN, COAH.",1,0,1,0,0,0,
16-mar-17,COAH.,"MONCLOVA, COAH.",1,0,1,0,0,0,
16-mar-17,QRO.,"SAN JUAN DEL RIO, QRO.",1,0,1,0,0,0,
17-mar-17,OAX.,"SAN JUAN BAUTISTA TUXTEPEC, OAX.",0,1,1,0,0,0,
17-mar-17,COAH.,"SAN PEDRO, COAH.",1,0,1,1,0,0,
17-mar-17,COAH.,"PIEDRAS NEGRAS, COAH.",0,1,1,1,0,0,
17-mar-17,COAH.,"ACUÑA, COAH.",0,1,1,0,0,6,
17-mar-17,VER.,"POZA RICA DE HGO., VER.",0,1,1,0,0,0,
17-mar-17,QRO.,"SAN JUAN DEL RIO, QRO.",1,0,1,0,0,0,
17-mar-17,MEX.,"VALLE DE CHALCO SOLIDARIDAD, MEX.",1,0,1,0,0,123,
17-mar-17,TAMPS.,"NUEVO LAREDO, TAMPS.",0,1,1,0,0,429,
17-mar-17,TAMPS.,"MATAMOROS, TAMPS.",1,0,1,0,0,171,
17-mar-17,MEX.,"VALLE DE CHALCO SOLIDARIDAD, MEX.",1,0,1,1,0,692,
17-mar-17,MEX.,"IXTLAHUACA, MEX.",1,0,1,0,0,53,
18-mar-17,QRO.,"SAN JUAN DEL RIO, QRO.",0,1,1,0,0,0,
18-mar-17,HGO.,"ZIMAPAN, HGO.",1,0,1,0,0,0,
18-mar-17,COAH.,"NAVA, COAH.",0,1,1,1,0,53,
21-mar-17,MEX.,"SAN JOSE DEL RINCON, MEX.",0,1,1,0,0,0,
21-mar-17,N.L.,"SALINAS VICTORIA, N.L.",0,1,1,0,0,0,
21-mar-17,OAX.,"PINOTEPA DE DON LUIS, OAX.",0,1,1,0,3,0,
22-mar-17,D.F.,"TLALPAN, D.F.",0,1,1,0,3,0,
22-mar-17,MEX.,"SAN JOSE DEL RINCON, MEX.",0,1,1,0,0,0,
22-mar-17,B.C.S.,"LA PAZ, B.C.S.",0,1,1,0,0,0,
23-mar-17,MEX.,"SAN JOSE DEL RINCON, MEX.",1,0,1,0,0,0,
23-mar-17,MEX.,"SULTEPEC, MEX.",1,0,1,0,0,0,
23-mar-17,TAMPS.,"NUEVO LAREDO, TAMPS.",1,0,1,0,0,274,
23-mar-17,COAH.,"MATAMOROS, COAH.",1,0,1,0,0,0,
23-mar-17,COAH.,"FRANCISCO I. MADERO, COAH.",1,0,1,0,0,0,
23-mar-17,GRO.,"SAN MIGUEL TOTOLAPAN, GRO.",0,1,1,0,0,0,
23-mar-17,COAH.,"TORREÓN, COAH.",0,1,1,0,0,0,
23-mar-17,OAX.,"SAN JUAN BAUTISTA TUXTEPEC, OAX.",0,1,1,0,0,0,
23-mar-17,N.L.,"MONTERREY, N.L.",0,1,1,0,0,350,
23-mar-17,MICH.,"APATZINGAN, MICH.",1,0,1,0,0,0,
24-mar-17,D.F.,"TLALPAN, D.F.",1,0,1,0,3,0,
24-mar-17,VER.,"MARTINEZ DE LA TORRE, VER.",1,0,1,0,0,6,
24-mar-17,VER.,"COSOLEACAQUE, VER.",1,0,1,0,0,90,
24-mar-17,TAMPS.,"NUEVO LAREDO, TAMPS.",1,0,1,0,0,0,
25-mar-17,ZAC.,"ZAC., ZAC.",1,0,1,0,0,470,
26-mar-17,MEX.,"NAUCALPAN DE JUAREZ, MEX.",1,0,1,0,0,1448,
26-mar-17,JAL.,"TOMATLAN, JAL.",1,0,1,0,0,0,
27-mar-17,COAH.,"MATAMOROS, COAH.",1,0,1,0,0,0,
27-mar-17,GRO.,"COYUCA DE BENITEZ, GRO.",1,0,1,0,0,0,
27-mar-17,OAX.,"PINOTEPA DE DON LUIS, OAX.",1,0,1,0,0,0,
27-mar-17,N.L.,"MONTERREY, N.L.",0,1,1,7,0,228,
28-mar-17,N.L.,"MONTERREY, N.L.",1,0,1,20,0,500,
28-mar-17,N.L.,"CIENEGA DE FLORES, N.L.",1,0,1,0,0,170,
28-mar-17,TAMPS.,"NUEVO LAREDO, TAMPS.",0,1,1,5,0,140,
28-mar-17,MICH.,"APATZINGAN, MICH.",1,0,1,0,0,0,
28-mar-17,COAH.,"TORREÓN, COAH.",1,0,1,0,0,0,
28-mar-17,OAX.,"ASUNCION IXTALTEPEC, OAX.",1,0,1,0,0,0,
29-mar-17,COAH.,"TORREÓN, COAH.",1,0,1,0,0,0,
29-mar-17,COAH.,"SAN PEDRO, COAH.",1,0,1,0,0,0,
31-mar-17,VER.,"COSOLEACAQUE, VER.",0,1,1,0,0,128,
31-mar-17,COAH.,"PIEDRAS NEGRAS, COAH.",0,1,1,0,0,0,
31-mar-17,COAH.,"ACUÑA, COAH.",0,1,1,0,0,0,
31-mar-17,COAH.,"MÚZQUIZ, COAH.",1,0,1,0,0,0,
31-mar-17,ZAC.,"TAB., ZAC.",1,0,1,0,0,0,
31-mar-17,GRO.,"COYUCA DE BENITEZ, GRO.",1,0,1,0,0,0,
03-abr-17,CHIH.,"HGO. DEL PARRAL, CHIH.",1,0,1,0,0,0,
03-abr-17,VER.,"GUTIERREZ ZAMORA, VER.",0,1,1,0,0,0,
03-abr-17,COAH.,"MÚZQUIZ, COAH.",1,0,1,0,0,0,
03-abr-17,TAMPS.,"NUEVO LAREDO, TAMPS.",1,0,1,0,0,42,
04-abr-17,DGO.,"DGO., DGO.",1,0,1,2,0,0,
04-abr-17,VER.,"TLAPACOYAN, VER.",1,0,1,0,0,0,
04-abr-17,OAX.,"PINOTEPA DE DON LUIS, OAX.",0,1,1,0,0,0,
05-abr-17,DGO.,"DGO., DGO.",0,1,1,3,0,0,
05-abr-17,CHIS.,"TAPACHULA, CHIS.",0,1,1,0,0,0,
05-abr-17,D.F.,"TLALPAN, D.F.",1,0,1,0,0,0,
05-abr-17,COAH.,"PIEDRAS NEGRAS, COAH.",1,0,1,0,4,146,
05-abr-17,D.F.,"TLALPAN, D.F.",1,0,1,0,0,0,
05-abr-17,MICH.,"APATZINGAN, MICH.",0,1,1,0,0,0,
05-abr-17,MICH.,"VISTA HERMOSA, MICH.",1,0,1,0,0,0,
06-abr-17,MICH.,"APATZINGAN, MICH.",0,1,1,0,0,0,
06-abr-17,MICH.,"LAZARO CARDENAS, MICH.",1,0,1,0,0,0,
06-abr-17,VER.,"TLAPACOYAN, VER.",1,0,1,0,0,0,
06-abr-17,TAMPS.,"MIGUEL ALEMAN, TAMPS.",1,0,1,2,0,50,
07-abr-17,VER.,"TLAPACOYAN, VER.",1,0,1,0,0,0,
07-abr-17,VER.,"LAS VIGAS DE RAMIREZ, VER.",0,1,1,0,0,0,
08-abr-17,TAMPS.,"MIGUEL ALEMAN, TAMPS.",0,1,1,0,0,0,
08-abr-17,TAMPS.,"MIGUEL ALEMAN, TAMPS.",1,0,1,0,0,0,
08-abr-17,TAB.,"PARAISO, TAB.",1,0,1,0,0,0,
10-abr-17,N.L.,"JUAREZ, N.L.",1,0,1,0,0,0,
10-abr-17,VER.,"TLAPACOYAN, VER.",1,0,1,0,0,0,
10-abr-17,TAMPS.,"NUEVO LAREDO, TAMPS.",1,0,1,0,0,0,
10-abr-17,MICH.,"LAZARO CARDENAS, MICH.",1,0,1,1,1,0,
10-abr-17,D.F.,"TLALPAN, D.F.",1,0,1,0,0,0,
10-abr-17,D.F.,"COYOACAN, D.F.",1,0,1,0,0,0,
11-abr-17,OAX.,"SAN JUAN BAUTISTA TUXTEPEC, OAX.",1,0,1,0,0,143,
11-abr-17,SIN.,"ELOTA, SIN.",1,0,1,0,0,0,
12-abr-17,SIN.,"NAVOLATO, SIN.",1,0,1,0,15,0,
12-abr-17,SIN.,"MAZATLAN, SIN.",1,0,1,0,6,0,
12-abr-17,TAMPS.,"NUEVO LAREDO, TAMPS.",0,1,1,0,0,30,
12-abr-17,VER.,"SANTIAGO TUXTLA, VER.",0,1,1,0,0,0,
13-abr-17,DGO.,"DGO., DGO.",0,1,1,0,0,0,
13-abr-17,DGO.,"DGO., DGO.",0,1,1,0,0,0,
14-abr-17,DGO.,"DGO., DGO.",1,0,1,0,0,0,
14-abr-17,TAB.,"CARDENAS, TAB.",1,0,1,0,0,0,
14-abr-17,DGO.,"DGO., DGO.",1,0,1,0,0,0,
15-abr-17,D.F.,"IZTAPALAPA, D.F.",1,0,1,0,0,6500,
17-abr-17,DGO.,"DGO., DGO.",1,0,1,0,0,0,
18-abr-17,TAB.,"CARDENAS, TAB.",0,1,1,0,0,0,
19-abr-17,CHIH.,"HGO. DEL PARRAL, CHIH.",1,0,1,0,0,0,
20-abr-17,N.L.,"MONTERREY, N.L.",0,1,1,0,0,0,
21-abr-17,OAX.,"MATIAS ROMERO AVENDAÑO, OAX.",1,0,1,0,0,0,
22-abr-17,CHIH.,"HGO. DEL PARRAL, CHIH.",1,0,1,0,0,0,
23-abr-17,S.L.P.,"SAN LUIS POTOSI, S.L.P.",1,0,1,0,0,1,
23-abr-17,DGO.,"DGO., DGO.",1,0,1,0,0,0,
24-abr-17,GRO.,"COYUCA DE BENITEZ, GRO.",1,0,1,0,0,0,
24-abr-17,JAL.,"GUADALAJARA, JAL.",1,0,1,0,0,0,
24-abr-17,JAL.,"TLAJOMULCO DE ZUÑIGA, JAL.",0,1,1,0,0,0,
24-abr-17,N.L.,"MONTERREY, N.L.",1,0,1,0,0,0,
25-abr-17,D.F.,"XOCHIMILCO, D.F.",1,0,1,0,0,0,
25-abr-17,SIN.,"NAVOLATO, SIN.",1,0,1,0,1,0,
25-abr-17,SIN.,"MAZATLAN, SIN.",1,0,1,0,0,0,
25-abr-17,JAL.,"TONALA, JAL.",1,0,1,0,0,0,
25-abr-17,TAMPS.,"TAMPICO, TAMPS.",1,0,1,9,0,112,
26-abr-17,N.L.,"GUADALUPE, N.L.",1,0,1,0,0,147,
26-abr-17,SIN.,"ELOTA, SIN.",1,0,1,0,4,0,
26-abr-17,JAL.,"TONALA, JAL.",1,0,1,0,0,0,
26-abr-17,JAL.,"TLAJOMULCO DE ZUÑIGA, JAL.",0,1,1,0,0,0,
27-abr-17,MICH.,"PANINDICUARO, MICH.",1,0,1,0,0,200,
27-abr-17,JAL.,"TLAJOMULCO DE ZUÑIGA, JAL.",0,1,1,0,0,0,
27-abr-17,N.L.,"MONTERREY, N.L.",1,0,1,1,0,23,
27-abr-17,D.F.,"CUAUHTEMOC, D.F.",1,0,1,0,0,0,
27-abr-17,DGO.,"DGO., DGO.",1,0,1,5,0,0,
28-abr-17,CHIS.,"OCOSINGO, CHIS.",0,1,1,0,0,0,
28-abr-17,MICH.,"LAZARO CARDENAS, MICH.",1,0,1,0,0,0,
28-abr-17,SIN.,"ELOTA, SIN.",1,0,1,0,7,0,
28-abr-17,JAL.,"ZAPOPAN, JAL.",1,0,1,0,0,0,
28-abr-17,JAL.,"TONALA, JAL.",1,0,1,0,0,0,
28-abr-17,JAL.,"TLAQUEPAQUE, JAL.",1,0,1,0,0,219,
29-abr-17,JAL.,"TONALA, JAL.",0,1,1,0,0,0,
29-abr-17,JAL.,"TLAJOMULCO DE ZUÑIGA, JAL.",0,1,1,0,0,0,
29-abr-17,JAL.,"TLAQUEPAQUE, JAL.",1,0,1,0,0,0,
30-abr-17,DGO.,"DGO., DGO.",1,0,1,0,4,0,
01-may-17,JAL.,"GUADALAJARA, JAL.",1,0,1,0,0,0,
01-may-17,JAL.,"TLAQUEPAQUE, JAL.",1,0,1,0,0,0,
02-may-17,JAL.,"ZAPOPAN, JAL.",0,1,1,0,0,0,
02-may-17,JAL.,"TLAQUEPAQUE, JAL.",0,1,1,0,0,0,
02-may-17,N.L.,"MONTERREY, N.L.",1,0,1,0,0,95,
02-may-17,SIN.,"BADIRAGUATO, SIN.",1,0,1,0,0,0,
03-may-17,TAMPS.,"NUEVO LAREDO, TAMPS.",0,1,1,1,0,0,
03-may-17,JAL.,"TONALA, JAL.",0,1,1,0,0,0,
03-may-17,SIN.,"SAN IGNACIO, SIN.",0,1,1,0,0,0,
03-may-17,GRO.,"PUNGARABATO, GRO.",1,0,1,0,0,0,
03-may-17,DGO.,"DGO., DGO.",1,0,1,8,2,0,
04-may-17,MICH.,"APATZINGAN, MICH.",1,0,1,0,0,0,
04-may-17,JAL.,"GUADALAJARA, JAL.",1,0,1,0,0,0,
04-may-17,JAL.,"ZAPOPAN, JAL.",0,1,1,2,0,161,
04-may-17,JAL.,"TONALA, JAL.",1,0,1,0,0,0,
04-may-17,SIN.,"SAN IGNACIO, SIN.",0,1,1,0,0,0,
04-may-17,DGO.,"DGO., DGO.",1,0,1,0,0,0,
04-may-17,MICH.,"IXTLAN, MICH.",1,0,1,0,0,0,
05-may-17,DGO.,"DGO., DGO.",1,0,1,0,0,0,
05-may-17,D.F.,"GUSTAVO A. MADERO, D.F.",1,0,1,0,0,0,
06-may-17,JAL.,"ZAPOPAN, JAL.",0,1,1,1,5,4,
06-may-17,JAL.,"TONALA, JAL.",0,1,1,0,0,0,
06-may-17,JAL.,"TLAJOMULCO DE ZUÑIGA, JAL.",1,0,1,0,0,0,
06-may-17,TAMPS.,"MATAMOROS, TAMPS.",0,1,1,6,0,132,
07-may-17,JAL.,"GUADALAJARA, JAL.",1,0,1,0,0,0,
07-may-17,JAL.,"TONALA, JAL.",0,1,1,0,0,0,
07-may-17,JAL.,"TLAJOMULCO DE ZUÑIGA, JAL.",1,0,1,0,0,0,
08-may-17,JAL.,"ZAPOPAN, JAL.",1,0,1,0,0,0,
08-may-17,JAL.,"TLAQUEPAQUE, JAL.",0,1,1,3,0,115,
08-may-17,Q. ROO,"OTHON P. BLANCO, Q. ROO",1,0,1,2,0,34,
08-may-17,MICH.,"LAZARO CARDENAS, MICH.",1,0,1,0,0,150,
08-may-17,PUE.,"TEHUACAN, PUE.",1,0,1,3,0,73,
08-may-17,D.F.,"AZCAPOTZALCO, D.F.",0,1,1,0,0,148,
08-may-17,DGO.,"DGO., DGO.",1,0,1,2,0,0,
09-may-17,SIN.,"BADIRAGUATO, SIN.",1,0,1,0,0,0,
09-may-17,JAL.,"TONALA, JAL.",1,0,1,0,0,0,
09-may-17,JAL.,"TLAJOMULCO DE ZUÑIGA, JAL.",1,0,1,0,0,0,
09-may-17,JAL.,"TLAQUEPAQUE, JAL.",0,1,1,0,0,151,
09-may-17,TAMPS.,"TAMPICO, TAMPS.",1,0,1,0,0,31,
09-may-17,TAMPS.,"NUEVO LAREDO, TAMPS.",1,0,1,2,0,121,
10-may-17,D.F.,"AZCAPOTZALCO, D.F.",1,0,1,0,2,134,
10-may-17,DGO.,"DGO., DGO.",0,1,1,0,0,0,
10-may-17,JAL.,"TLAJOMULCO DE ZUÑIGA, JAL.",1,0,1,0,0,0,
10-may-17,JAL.,"TLAQUEPAQUE, JAL.",0,1,1,0,0,0,
11-may-17,D.F.,"AZCAPOTZALCO, D.F.",0,1,1,0,0,0,
11-may-17,JAL.,"TLAJOMULCO DE ZUÑIGA, JAL.",1,0,1,0,0,0,
12-may-17,JAL.,"TLAJOMULCO DE ZUÑIGA, JAL.",1,0,1,0,0,0,
12-may-17,N.L.,"MONTERREY, N.L.",0,1,1,28,0,40,
12-may-17,DGO.,"DGO., DGO.",1,0,1,0,0,0,
13-may-17,B.C.S.,"MULEGÉ, B.C.S.",0,1,1,0,0,0,
13-may-17,N.L.,"GARCIA, N.L.",1,0,1,1,0,0,
13-may-17,N.L.,"HGO., N.L.",0,1,1,0,0,0,
13-may-17,GRO.,"ATOYAC DE ALVAREZ, GRO.",1,0,1,1,0,0,
13-may-17,JAL.,"TLAJOMULCO DE ZUÑIGA, JAL.",0,1,1,0,0,0,
14-may-17,B.C.S.,"MULEGÉ, B.C.S.",0,1,1,0,0,0,
14-may-17,JAL.,"GUADALAJARA, JAL.",1,0,1,0,0,0,
14-may-17,JAL.,"TLAJOMULCO DE ZUÑIGA, JAL.",1,0,1,0,0,0,
14-may-17,JAL.,"TLAQUEPAQUE, JAL.",1,0,1,0,0,187,
15-may-17,JAL.,"GUADALAJARA, JAL.",0,1,1,0,0,0,
15-may-17,JAL.,"ZAPOPAN, JAL.",1,0,1,0,0,0,
15-may-17,JAL.,"TLAJOMULCO DE ZUÑIGA, JAL.",0,1,1,0,0,0,
15-may-17,N.L.,"HGO., N.L.",0,1,1,0,0,0,
15-may-17,B.C.S.,"MULEGÉ, B.C.S.",0,1,1,0,0,0,
15-may-17,TAMPS.,"NUEVO LAREDO, TAMPS.",1,0,1,1,0,3234,
15-may-17,GRO.,"ATOYAC DE ALVAREZ, GRO.",0,1,1,0,0,0,
16-may-17,DGO.,"DGO., DGO.",0,1,1,0,0,0,
16-may-17,B.C.S.,"MULEGÉ, B.C.S.",0,1,1,0,0,0,
16-may-17,JAL.,"TONALA, JAL.",1,0,1,0,0,0,
16-may-17,JAL.,"TLAJOMULCO DE ZUÑIGA, JAL.",1,0,1,0,0,0,
16-may-17,JAL.,"TLAQUEPAQUE, JAL.",0,1,1,0,0,150,
17-may-17,D.F.,"AZCAPOTZALCO, D.F.",0,1,1,0,0,0,
17-may-17,N.L.,"HGO., N.L.",0,1,1,1,0,100,
17-may-17,DGO.,"DGO., DGO.",1,0,1,2,1,0,
18-may-17,JAL.,"ZAPOPAN, JAL.",1,0,1,2,0,41,
18-may-17,JAL.,"TONALA, JAL.",0,1,1,0,0,0,
18-may-17,JAL.,"TLAJOMULCO DE ZUÑIGA, JAL.",1,0,1,0,0,0,
18-may-17,JAL.,"TLAQUEPAQUE, JAL.",1,0,1,0,0,0,
18-may-17,DGO.,"DGO., DGO.",1,0,1,0,0,0,
18-may-17,SIN.,"SAN IGNACIO, SIN.",1,0,1,0,0,0,
18-may-17,D.F.,"AZCAPOTZALCO, D.F.",1,0,1,0,0,0,
19-may-17,TAMPS.,"NUEVO LAREDO, TAMPS.",1,0,1,0,0,50,
19-may-17,JAL.,"GUADALAJARA, JAL.",1,0,1,0,0,0,
19-may-17,JAL.,"TONALA, JAL.",1,0,1,0,0,0,
19-may-17,JAL.,"TLAJOMULCO DE ZUÑIGA, JAL.",1,0,1,0,0,0,
19-may-17,DGO.,"DGO., DGO.",1,0,1,0,0,0,
21-may-17,JAL.,"TLAJOMULCO DE ZUÑIGA, JAL.",1,0,1,0,0,0,
22-may-17,DGO.,"DGO., DGO.",1,0,1,0,0,0,
22-may-17,JAL.,"TONALA, JAL.",0,1,1,0,0,0,
22-may-17,B.C.S.,"LA PAZ, B.C.S.",0,1,1,0,0,0,
22-may-17,SIN.,"CONCORDIA, SIN.",0,1,1,0,0,0,
23-may-17,D.F.,"BENITO JUAREZ, D.F.",1,0,1,0,0,10217,
23-may-17,JAL.,"TLAJOMULCO DE ZUÑIGA, JAL.",1,0,1,0,0,0,
23-may-17,DGO.,"DGO., DGO.",0,1,1,0,0,0,
24-may-17,D.F.,"BENITO JUAREZ, D.F.",0,1,1,0,0,0,
24-may-17,JAL.,"GUADALAJARA, JAL.",0,1,1,0,0,0,
24-may-17,JAL.,"TLAQUEPAQUE, JAL.",0,1,1,0,0,95,
24-may-17,N.L.,"MONTERREY, N.L.",1,0,1,1,0,0,
25-may-17,TAB.,"CENTRO, TAB.",1,0,1,0,0,0,
25-may-17,SON.,"HUATABAMPO, SON.",1,0,1,0,0,0,
25-may-17,SON.,"NAVOJOA, SON.",1,0,1,1,0,0,
25-may-17,N.L.,"MINA, N.L.",1,0,1,2,0,0,
25-may-17,JAL.,"GUADALAJARA, JAL.",1,0,1,0,0,0,
25-may-17,JAL.,"TLAJOMULCO DE ZUÑIGA, JAL.",1,0,1,0,0,0,
26-may-17,SON.,"NAVOJOA, SON.",0,1,1,3,0,3,
26-may-17,N.L.,"SAN NICOLAS DE LOS GARZA, N.L.",1,0,1,4,0,10,
26-may-17,N.L.,"MONTERREY, N.L.",0,1,1,1,0,0,
27-may-17,MICH.,"APATZINGAN, MICH.",1,0,1,0,0,0,
27-may-17,DGO.,"DGO., DGO.",1,0,1,3,0,0,
27-may-17,JAL.,"ZAPOPAN, JAL.",1,0,1,0,0,0,
27-may-17,JAL.,"TLAJOMULCO DE ZUÑIGA, JAL.",0,1,1,1,0,48,
28-may-17,MICH.,"APATZINGAN, MICH.",1,0,1,0,0,0,
28-may-17,JAL.,"GUADALAJARA, JAL.",1,0,1,0,0,50,
28-may-17,JAL.,"TLAJOMULCO DE ZUÑIGA, JAL.",1,0,1,0,2,34,
29-may-17,JAL.,"GUADALAJARA, JAL.",1,0,1,0,0,0,
29-may-17,JAL.,"TLAQUEPAQUE, JAL.",0,1,1,0,0,0,
29-may-17,TAMPS.,"NUEVO LAREDO, TAMPS.",0,1,1,0,0,14,
29-may-17,AGS.,"AGS., AGS.",1,0,1,0,0,0,
29-may-17,SIN.,"CONCORDIA, SIN.",0,1,1,0,0,0,
29-may-17,DGO.,"DGO., DGO.",1,0,1,1,0,0,
30-may-17,TAB.,"TENOSIQUE, TAB.",1,0,1,0,0,0,
30-may-17,DGO.,"DGO., DGO.",1,0,1,0,0,0,
31-may-17,N.L.,"MONTERREY, N.L.",1,0,1,0,0,0,
31-may-17,TAB.,"CENTRO, TAB.",1,0,1,0,0,0,
31-may-17,CHIH.,"HGO. DEL PARRAL, CHIH.",1,0,1,0,0,232,
01-jun-17,JAL.,"TLAQUEPAQUE, JAL.",0,1,1,0,0,120,
01-jun-17,JAL.,"TONALA, JAL.",1,0,1,0,0,0,
01-jun-17,TAB.,"CENTRO, TAB.",0,1,1,0,0,0,
01-jun-17,MICH.,"APATZINGAN, MICH.",0,1,1,0,0,0,
01-jun-17,SON.,"GUAYMAS, SON.",1,0,1,0,0,0,
02-jun-17,TAMPS.,"NUEVO LAREDO, TAMPS.",1,0,1,0,0,0,
02-jun-17,AGS.,"AGS., AGS.",1,0,1,15,0,57,
02-jun-17,SIN.,"CONCORDIA, SIN.",0,1,1,0,0,0,
02-jun-17,JAL.,"TLAQUEPAQUE, JAL.",1,0,1,0,0,0,
02-jun-17,JAL.,"TONALA, JAL.",0,1,1,0,0,0,
02-jun-17,TLAX.,"TLAX., TLAX.",1,0,1,0,0,0,
02-jun-17,TLAX.,"HUAMANTLA, TLAX.",0,1,1,0,0,0,
03-jun-17,N.L.,"SAN PEDRO GARZA GARCIA, N.L.",1,0,1,0,0,100,
03-jun-17,JAL.,"TONALA, JAL.",0,1,1,0,0,0,
04-jun-17,DGO.,"DGO., DGO.",0,1,1,1,2,0,
04-jun-17,JAL.,"TLAJOMULCO DE ZUÑIGA, JAL.",1,0,1,7,0,68,
04-jun-17,JAL.,"TONALA, JAL.",0,1,1,0,0,0,
04-jun-17,JAL.,"ZAPOPAN, JAL.",1,0,1,5,0,162,
04-jun-17,QRO.,"COLON, QRO.",0,1,1,0,2,0,
05-jun-17,CHIS.,"VILLAFLORES, CHIS.",1,0,1,0,0,0,
05-jun-17,TAB.,"CENTRO, TAB.",1,0,1,0,0,0,
05-jun-17,D.F.,"GUSTAVO A. MADERO, D.F.",1,0,1,0,0,15,
05-jun-17,JAL.,"TLAJOMULCO DE ZUÑIGA, JAL.",0,1,1,5,0,0,
05-jun-17,DGO.,"DGO., DGO.",0,1,1,2,0,0,
05-jun-17,CHIS.,"TONALÁ, CHIS.",1,0,1,0,0,3,
06-jun-17,D.F.,"GUSTAVO A. MADERO, D.F.",1,0,1,0,0,2851,
06-jun-17,CHIS.,"TONALÁ, CHIS.",0,1,1,10,0,611,
06-jun-17,N.L.,"SANTA CATARINA, N.L.",1,0,1,0,0,0,
06-jun-17,TLAX.,"CHIAUTEMPAN, TLAX.",1,0,1,0,0,0,
07-jun-17,MICH.,"TLALPUJAHUA, MICH.",0,1,1,0,6,50,
07-jun-17,JAL.,"TLAQUEPAQUE, JAL.",1,0,1,0,2,119,
07-jun-17,JAL.,"ZAPOPAN, JAL.",1,0,1,0,0,0,
07-jun-17,JAL.,"TLAJOMULCO DE ZUÑIGA, JAL.",0,1,1,0,0,0,
07-jun-17,COAH.,"SALTILLO, COAH.",1,0,1,1,0,0,
07-jun-17,TAB.,"CENTRO, TAB.",1,0,1,0,0,0,
07-jun-17,TLAX.,"CUAPIAXTLA, TLAX.",0,1,1,0,0,0,
07-jun-17,SON.,"GUAYMAS, SON.",0,1,1,0,0,0,
07-jun-17,SON.,"HUATABAMPO, SON.",1,0,1,0,0,0,
08-jun-17,D.F.,"XOCHIMILCO, D.F.",0,1,1,0,0,398,
08-jun-17,N.L.,"SANTA CATARINA, N.L.",1,0,1,0,0,0,
08-jun-17,N.L.,"CARMEN, N.L.",1,0,1,9,0,0,
08-jun-17,B.C.S.,"COMONDÚ, B.C.S.",1,0,1,0,0,22,
08-jun-17,MICH.,"TLALPUJAHUA, MICH.",1,0,1,0,0,4500,
08-jun-17,JAL.,"GUADALAJARA, JAL.",1,0,1,0,0,0,
08-jun-17,CHIS.,"VILLAFLORES, CHIS.",0,1,1,0,0,0,
08-jun-17,PUE.,"ACAJETE, PUE.",1,0,1,1,0,2,
08-jun-17,SON.,"GUAYMAS, SON.",0,1,1,1,0,0,
09-jun-17,N.L.,"MONTERREY, N.L.",0,1,1,1,0,35,
09-jun-17,CHIS.,"BENEMÉRITO DE LAS AMÉRICAS, CHIS.",1,0,1,1,0,0,
09-jun-17,JAL.,"TLAQUEPAQUE, JAL.",0,1,1,0,0,12,
09-jun-17,JAL.,"TLAJOMULCO DE ZUÑIGA, JAL.",1,0,1,0,0,0,
09-jun-17,PUE.,"ACAJETE, PUE.",1,0,1,0,0,0,
09-jun-17,GRO.,"OLINALA, GRO.",0,1,1,1,0,0,
09-jun-17,TAB.,"CENTRO, TAB.",0,1,1,0,0,0,
09-jun-17,SON.,"HUATABAMPO, SON.",1,0,1,0,0,0,
10-jun-17,CHIS.,"TONALÁ, CHIS.",1,0,1,15,0,976,
10-jun-17,JAL.,"TLAQUEPAQUE, JAL.",0,1,1,0,0,30,
10-jun-17,MOR.,"CUERNAVACA, MOR.",0,1,1,1,3,11,
10-jun-17,TAMPS.,"MATAMOROS, TAMPS.",1,0,1,1,0,57,
10-jun-17,DGO.,"DGO., DGO.",1,0,1,1,0,0,
10-jun-17,N.L.,"CARMEN, N.L.",1,0,1,8,0,50,
11-jun-17,MOR.,"CUERNAVACA, MOR.",0,1,1,1,0,176,
11-jun-17,GRO.,"ATOYAC DE ALVAREZ, GRO.",1,0,1,1,0,54,
12-jun-17,B.C.,"ENSENADA, B.C.",0,1,1,0,0,0,
12-jun-17,SIN.,"SALVADOR ALVARADO, SIN.",0,1,1,0,0,0,
12-jun-17,JAL.,"GUADALAJARA, JAL.",1,0,1,0,0,0,
12-jun-17,JAL.,"TLAQUEPAQUE, JAL.",0,1,1,3,0,0,
13-jun-17,DGO.,"DGO., DGO.",0,1,1,1,0,0,
13-jun-17,SIN.,"ROSARIO, SIN.",0,1,1,0,1,0,
13-jun-17,JAL.,"GUADALAJARA, JAL.",1,0,1,0,0,0,
13-jun-17,JAL.,"TONALA, JAL.",1,0,1,0,0,35,
13-jun-17,D.F.,"GUSTAVO A. MADERO, D.F.",0,1,1,0,0,1420,
13-jun-17,B.C.,"TIJUANA, B.C.",1,0,1,0,0,0,
13-jun-17,N.L.,"MONTERREY, N.L.",1,0,1,300,0,0,
14-jun-17,AGS.,"ASIENTOS, AGS.",0,1,1,0,0,0,
14-jun-17,COAH.,"TORREÓN, COAH.",1,0,1,0,0,0,
14-jun-17,SIN.,"ROSARIO, SIN.",1,0,1,0,1,0,
14-jun-17,MICH.,"LAZARO CARDENAS, MICH.",1,0,1,1,0,0,
14-jun-17,COAH.,"PIEDRAS NEGRAS, COAH.",0,1,1,0,0,0,
14-jun-17,COAH.,"MÚZQUIZ, COAH.",1,0,1,0,0,98,
14-jun-17,COAH.,"ACUÑA, COAH.",0,1,1,0,0,0,
14-jun-17,N.L.,"MONTERREY, N.L.",1,0,1,0,0,81,
14-jun-17,B.C.,"ENSENADA, B.C.",1,0,1,0,0,0,
14-jun-17,JAL.,"GUADALAJARA, JAL.",1,0,1,1,0,20,
15-jun-17,GTO.,"PURISIMA DEL RINCON, GTO.",0,1,1,0,0,0,
15-jun-17,GRO.,"LA UNION DE ISIDORO MONTES DE OCA, GRO.",1,0,1,0,0,0,
15-jun-17,COAH.,"SAN PEDRO, COAH.",1,0,1,0,0,0,
15-jun-17,COAH.,"SALTILLO, COAH.",1,0,1,0,0,194,
15-jun-17,SIN.,"SALVADOR ALVARADO, SIN.",1,0,1,0,0,0,
15-jun-17,N.L.,"SANTA CATARINA, N.L.",1,0,1,300,0,0,
15-jun-17,JAL.,"TONALA, JAL.",1,0,1,0,0,0,
15-jun-17,OAX.,"SAN DIONISIO DEL MAR, OAX.",1,0,1,0,0,0,
16-jun-17,JAL.,"GUADALAJARA, JAL.",0,1,1,0,0,0,
16-jun-17,JAL.,"ZAPOPAN, JAL.",1,0,1,0,0,0,
16-jun-17,COAH.,"TORREÓN, COAH.",1,0,1,0,0,0,
16-jun-17,COAH.,"FRANCISCO I. MADERO, COAH.",1,0,1,0,0,0,
16-jun-17,COAH.,"MONCLOVA, COAH.",1,0,1,0,0,0,
16-jun-17,SIN.,"ROSARIO, SIN.",0,1,1,0,0,0,
16-jun-17,TAB.,"JALPA DE MENDEZ, TAB.",0,1,1,0,0,0,
16-jun-17,YUC.,"TIXKOKOB, YUC.",0,1,1,0,0,0,
16-jun-17,OAX.,"SAN DIONISIO DEL MAR, OAX.",0,1,1,0,0,0,
16-jun-17,MEX.,"IXTAPAN DEL ORO, MEX.",1,0,1,0,0,0,
16-jun-17,TLAX.,"SAN PABLO DEL MONTE, TLAX.",1,0,1,0,0,0,
17-jun-17,JAL.,"GUADALAJARA, JAL.",0,1,1,0,1,0,
17-jun-17,JAL.,"TLAQUEPAQUE, JAL.",0,1,1,0,0,0,
17-jun-17,JAL.,"TLAJOMULCO DE ZUÑIGA, JAL.",1,0,1,0,0,0,
17-jun-17,JAL.,"TONALA, JAL.",0,1,1,0,0,0,
17-jun-17,JAL.,"ZAPOPAN, JAL.",0,1,1,0,0,0,
17-jun-17,B.C.,"ENSENADA, B.C.",1,0,1,0,0,0,
18-jun-17,JAL.,"GUADALAJARA, JAL.",1,0,1,0,0,0,
18-jun-17,JAL.,"TLAQUEPAQUE, JAL.",1,0,1,0,0,0,
18-jun-17,DGO.,"DGO., DGO.",1,0,1,0,0,0,
18-jun-17,TLAX.,"SAN PABLO DEL MONTE, TLAX.",1,0,1,0,0,0,
19-jun-17,JAL.,"GUADALAJARA, JAL.",1,0,1,0,0,22,
19-jun-17,JAL.,"TLAQUEPAQUE, JAL.",1,0,1,0,0,122,
19-jun-17,COAH.,"TORREÓN, COAH.",1,0,1,0,0,0,
19-jun-17,COAH.,"FRANCISCO I. MADERO, COAH.",1,0,1,0,0,0,
19-jun-17,COAH.,"MÚZQUIZ, COAH.",1,0,1,0,0,0,
19-jun-17,AGS.,"ASIENTOS, AGS.",1,0,1,0,0,16,
19-jun-17,D.F.,"GUSTAVO A. MADERO, D.F.",0,1,1,0,0,0,
20-jun-17,TLAX.,"TLAXCO, TLAX.",1,0,1,0,0,0,
20-jun-17,MEX.,"ISIDRO FABELA, MEX.",0,1,1,0,0,0,
20-jun-17,SON.,"HERMOSILLO, SON.",1,0,1,1,0,0,
20-jun-17,SON.,"GUAYMAS, SON.",1,0,1,0,0,0,
20-jun-17,QRO.,"PEDRO ESCOBEDO, QRO.",1,0,1,0,0,0,
20-jun-17,JAL.,"GUADALAJARA, JAL.",1,0,1,0,0,0,
20-jun-17,COAH.,"SALTILLO, COAH.",0,1,1,0,0,66,
20-jun-17,COAH.,"FRANCISCO I. MADERO, COAH.",1,0,1,0,0,0,
20-jun-17,COAH.,"PIEDRAS NEGRAS, COAH.",1,0,1,0,0,650,
20-jun-17,N.L.,"SANTA CATARINA, N.L.",1,0,1,0,0,200,
20-jun-17,N.L.,"CARMEN, N.L.",0,1,1,3,0,0,
21-jun-17,COAH.,"MATAMOROS, COAH.",1,0,1,0,0,0,
21-jun-17,MEX.,"ISIDRO FABELA, MEX.",0,1,1,0,0,0,
21-jun-17,COAH.,"MONCLOVA, COAH.",1,0,1,1,0,31,
21-jun-17,TAB.,"BALANCAN, TAB.",0,1,1,0,0,0,
21-jun-17,N.L.,"MONTERREY, N.L.",1,0,1,0,0,0,
21-jun-17,SIN.,"ROSARIO, SIN.",0,1,1,0,0,0,
21-jun-17,TAB.,"CUNDUACAN, TAB.",1,0,1,0,0,0,
22-jun-17,MEX.,"ALMOLOYA DE JUAREZ, MEX.",1,0,1,1,0,0,
22-jun-17,MEX.,"JIQUIPILCO, MEX.",0,1,1,0,0,0,
22-jun-17,MEX.,"ISIDRO FABELA, MEX.",0,1,1,0,0,0,
22-jun-17,JAL.,"TLAQUEPAQUE, JAL.",0,1,1,0,0,120,
22-jun-17,JAL.,"ZAPOPAN, JAL.",1,0,1,0,1,0,
22-jun-17,GRO.,"PUNGARABATO, GRO.",1,0,1,0,0,0,
22-jun-17,TLAX.,"IXTACUIXTLA DE MARIANO MATAMOROS, TLAX.",0,1,1,0,0,67,
22-jun-17,COAH.,"NUEVA ROSITA, COAH.",1,0,1,0,0,0,
22-jun-17,SIN.,"ROSARIO, SIN.",0,1,1,0,0,0,
23-jun-17,GRO.,"OLINALA, GRO.",0,1,1,0,0,0,
23-jun-17,B.C.,"ENSENADA, B.C.",0,1,1,0,0,0,
23-jun-17,COAH.,"MATAMOROS, COAH.",0,1,1,0,0,0,
23-jun-17,COAH.,"SAN PEDRO, COAH.",1,0,1,0,0,0,
23-jun-17,COAH.,"PIEDRAS NEGRAS, COAH.",0,1,1,0,0,104,
23-jun-17,QRO.,"PEDRO ESCOBEDO, QRO.",1,0,1,0,0,0,
23-jun-17,DGO.,"DGO., DGO.",1,0,1,0,0,0,
23-jun-17,SIN.,"ROSARIO, SIN.",1,0,1,0,0,0,
23-jun-17,ZAC.,"GENERAL FRANCISCO R. MURGUIA, ZAC.",1,0,1,0,0,0,
24-jun-17,TLAX.,"IXTACUIXTLA DE MARIANO MATAMOROS, TLAX.",1,0,1,0,0,0,
24-jun-17,TLAX.,"TLAXCO, TLAX.",0,1,1,0,0,0,
24-jun-17,B.C.,"ENSENADA, B.C.",0,1,1,0,0,0,
24-jun-17,JAL.,"GUADALAJARA, JAL.",1,0,1,0,0,200,
24-jun-17,JAL.,"TLAQUEPAQUE, JAL.",1,0,1,0,0,125,
24-jun-17,TAMPS.,"MATAMOROS, TAMPS.",0,1,1,0,0,26,
25-jun-17,MEX.,"HUEYPOXTLA, MEX.",1,0,1,1,0,1,
26-jun-17,GRO.,"COYUCA DE BENITEZ, GRO.",0,1,1,0,0,0,
26-jun-17,SON.,"HUATABAMPO, SON.",0,1,1,0,0,0,
26-jun-17,N.L.,"MONTERREY, N.L.",1,0,1,1,0,22,
26-jun-17,MOR.,"TEPOZTLAN, MOR.",1,0,1,0,0,0,
26-jun-17,JAL.,"EL SALTO, JAL.",1,0,1,0,1,0,
27-jun-17,B.C.,"TIJUANA, B.C.",1,0,1,0,0,0,
27-jun-17,B.C.,"ENSENADA, B.C.",0,1,1,0,0,0,
27-jun-17,GRO.,"OLINALA, GRO.",1,0,1,0,0,0,
27-jun-17,COAH.,"FRANCISCO I. MADERO, COAH.",1,0,1,0,0,0,
27-jun-17,COAH.,"MÚZQUIZ, COAH.",1,0,1,0,0,0,
27-jun-17,COAH.,"ACUÑA, COAH.",0,1,1,0,0,0,
27-jun-17,JAL.,"EL SALTO, JAL.",0,1,1,2,0,250,
27-jun-17,N.L.,"CADEREYTA JIMENEZ, N.L.",1,0,1,0,0,19,
27-jun-17,SIN.,"CHOIX, SIN.",1,0,1,0,0,0,
27-jun-17,MICH.,"BUENAVISTA, MICH.",1,0,1,0,0,0,
27-jun-17,Q. ROO,"COZUMEL, Q. ROO",1,0,1,0,0,404,
28-jun-17,TLAX.,"ZACATELCO, TLAX.",1,0,1,0,0,0,
28-jun-17,GRO.,"PUNGARABATO, GRO.",1,0,1,0,0,0,
28-jun-17,COAH.,"TORREÓN, COAH.",1,0,1,0,0,0,
28-jun-17,COAH.,"ACUÑA, COAH.",0,1,1,0,0,0,
28-jun-17,JAL.,"EL SALTO, JAL.",1,0,1,3,0,26,
28-jun-17,SIN.,"SALVADOR ALVARADO, SIN.",1,0,1,0,0,0,
28-jun-17,Q. ROO,"COZUMEL, Q. ROO",1,0,1,0,0,316,
29-jun-17,MOR.,"TEPOZTLAN, MOR.",1,0,1,1,0,0,
29-jun-17,COAH.,"TORREÓN, COAH.",1,0,1,0,0,98,
29-jun-17,COAH.,"SALTILLO, COAH.",1,0,1,41,0,0,
29-jun-17,COAH.,"ACUÑA, COAH.",0,1,1,0,0,0,
29-jun-17,SIN.,"ROSARIO, SIN.",1,0,1,0,0,0,
29-jun-17,JAL.,"ZAPOTLANEJO, JAL.",1,0,1,0,0,0,
30-jun-17,COAH.,"MONCLOVA, COAH.",1,0,1,0,0,27,
30-jun-17,COAH.,"PIEDRAS NEGRAS, COAH.",1,0,1,1,0,0,
30-jun-17,Q. ROO,"COZUMEL, Q. ROO",1,0,1,0,0,1584,
30-jun-17,YUC.,"UMAN, YUC.",0,1,1,0,0,0,
30-jun-17,AGS.,"COSÍO, AGS.",0,1,1,0,0,0,
30-jun-17,JAL.,"EL SALTO, JAL.",1,0,1,0,0,0,
01-jul-17,MOR.,"TEPOZTLAN, MOR.",1,0,1,1,0,53,
01-jul-17,B.C.,"TIJUANA, B.C.",1,0,1,0,0,0,
01-jul-17,MEX.,"ATLAUTLA, MEX.",0,1,1,0,0,58,
02-jul-17,MEX.,"ATLAUTLA, MEX.",1,0,1,0,0,0,
03-jul-17,COAH.,"TORREÓN, COAH.",1,0,1,0,0,0,
03-jul-17,N.L.,"CADEREYTA JIMENEZ, N.L.",1,0,1,0,0,0,
03-jul-17,N.L.,"MONTERREY, N.L.",1,0,1,0,0,0,
03-jul-17,COAH.,"SALTILLO, COAH.",1,0,1,0,0,0,
03-jul-17,COAH.,"MONCLOVA, COAH.",1,0,1,0,1,0,
03-jul-17,COAH.,"MÚZQUIZ, COAH.",1,0,1,2,0,0,
03-jul-17,SON.,"NAVOJOA, SON.",1,0,1,0,0,0,
04-jul-17,OAX.,"PINOTEPA DE DON LUIS, OAX.",0,1,1,0,0,0,
04-jul-17,SON.,"HERMOSILLO, SON.",1,0,1,1,0,0,
04-jul-17,SON.,"HUATABAMPO, SON.",1,0,1,0,0,0,
04-jul-17,MEX.,"NOPALTEPEC, MEX.",1,0,1,0,1,0,
04-jul-17,GRO.,"OLINALA, GRO.",0,1,1,0,0,0,
04-jul-17,JAL.,"EL SALTO, JAL.",0,1,1,0,0,0,
04-jul-17,DGO.,"DGO., DGO.",1,0,1,1,1,0,
04-jul-17,N.L.,"MONTERREY, N.L.",0,1,1,0,0,0,
04-jul-17,COAH.,"FRANCISCO I. MADERO, COAH.",1,0,1,0,0,0,
04-jul-17,COAH.,"PIEDRAS NEGRAS, COAH.",0,1,1,0,0,0,
04-jul-17,COAH.,"MÚZQUIZ, COAH.",1,0,1,0,0,0,
05-jul-17,GRO.,"XOCHIHUEHUETLAN, GRO.",0,1,1,0,0,0,
05-jul-17,MEX.,"ACULCO, MEX.",1,0,1,0,0,0,
05-jul-17,TLAX.,"EL CARMEN TEQUEXQUITLA, TLAX.",1,0,1,0,0,0,
05-jul-17,TAMPS.,"REYNOSA, TAMPS.",1,0,1,0,0,117,
06-jul-17,MEX.,"MEXICALTZINGO, MEX.",0,1,1,0,0,20,
06-jul-17,TAMPS.,"NUEVO LAREDO, TAMPS.",1,0,1,0,0,32,
06-jul-17,COAH.,"TORREÓN, COAH.",1,0,1,0,0,0,
06-jul-17,COAH.,"FRANCISCO I. MADERO, COAH.",1,0,1,0,0,0,
06-jul-17,COAH.,"PIEDRAS NEGRAS, COAH.",1,0,1,0,0,30,
06-jul-17,COAH.,"SABINAS, COAH.",1,0,1,3,0,0,
06-jul-17,SON.,"GUAYMAS, SON.",1,0,1,0,0,0,
06-jul-17,N.L.,"MARIN, N.L.",1,0,1,0,0,0,
06-jul-17,JAL.,"ZAPOTLANEJO, JAL.",1,0,1,0,0,0,
07-jul-17,OAX.,"ASUNCION IXTALTEPEC, OAX.",0,1,1,0,0,130,
07-jul-17,MEX.,"MEXICALTZINGO, MEX.",0,1,1,0,0,0,
07-jul-17,JAL.,"ZAPOTLANEJO, JAL.",1,0,1,0,0,0,
07-jul-17,JAL.,"IXTLAHUACAN DE LOS MEMBRILLOS, JAL.",0,1,1,0,0,0,
07-jul-17,HGO.,"TULA DE ALLENDE, HGO.",1,0,1,0,0,0,
07-jul-17,MOR.,"TEPOZTLAN, MOR.",0,1,1,6,4,191,
07-jul-17,MEX.,"COCOTITLAN, MEX.",0,1,1,0,0,1,
07-jul-17,TAMPS.,"CAMARGO, TAMPS.",1,0,1,2,0,99,
08-jul-17,N.L.,"MONTERREY, N.L.",0,1,1,0,0,0,
08-jul-17,COAH.,"SALTILLO, COAH.",1,0,1,0,0,0,
08-jul-17,JAL.,"IXTLAHUACAN DE LOS MEMBRILLOS, JAL.",0,1,1,0,0,0,
09-jul-17,JAL.,"IXTLAHUACAN DE LOS MEMBRILLOS, JAL.",0,1,1,0,0,0,
10-jul-17,COAH.,"MONCLOVA, COAH.",1,0,1,0,0,0,
10-jul-17,COAH.,"MÚZQUIZ, COAH.",0,1,1,0,0,0,
10-jul-17,SIN.,"EL FUERTE, SIN.",0,1,1,0,0,0,
11-jul-17,COAH.,"TORREÓN, COAH.",1,0,1,0,0,0,
11-jul-17,COAH.,"MONCLOVA, COAH.",1,0,1,0,0,0,
11-jul-17,B.C.,"TIJUANA, B.C.",0,1,1,0,0,0,
11-jul-17,JAL.,"IXTLAHUACAN DE LOS MEMBRILLOS, JAL.",1,0,1,0,0,0,
11-jul-17,MEX.,"MOR., MEX.",0,1,1,0,0,81,
11-jul-17,MEX.,"OCUILAN, MEX.",0,1,1,0,0,0,
11-jul-17,TLAX.,"TLAX., TLAX.",0,1,1,0,0,0,
11-jul-17,CHIS.,"CHIAPA DE CORZO, CHIS.",1,0,1,0,0,0,
11-jul-17,OAX.,"JUCHITAN DE ZARAGOZA, OAX.",1,0,1,0,0,0,
12-jul-17,COAH.,"MONCLOVA, COAH.",1,0,1,0,0,0,
12-jul-17,MEX.,"MOR., MEX.",1,0,1,0,0,0,
12-jul-17,MEX.,"OCUILAN, MEX.",1,0,1,0,0,7,
12-jul-17,D.F.,"MILPA ALTA, D.F.",1,0,1,0,0,0,
12-jul-17,JAL.,"IXTLAHUACAN DE LOS MEMBRILLOS, JAL.",0,1,1,0,0,0,
12-jul-17,TLAX.,"SANTA ANA NOPALUCAN, TLAX.",0,1,1,0,0,0,
12-jul-17,HGO.,"HUASCA DE OCAMPO, HGO.",1,0,1,0,0,0,
12-jul-17,MEX.,"OTUMBA, MEX.",1,0,1,1,0,0,
12-jul-17,PUE.,"HUEJOTZINGO, PUE.",0,1,1,0,0,0,
12-jul-17,TAMPS.,"NUEVO LAREDO, TAMPS.",1,0,1,0,0,0,
12-jul-17,HGO.,"HUASCA DE OCAMPO, HGO.",1,0,1,0,0,0,
13-jul-17,SIN.,"ESCUINAPA, SIN.",1,0,1,0,5,0,
13-jul-17,D.F.,"MILPA ALTA, D.F.",1,0,1,0,0,0,
13-jul-17,COAH.,"ACUÑA, COAH.",0,1,1,0,0,0,
13-jul-17,N.L.,"CADEREYTA JIMENEZ, N.L.",1,0,1,1,0,78,
13-jul-17,N.L.,"MONTERREY, N.L.",1,0,1,0,0,76,
13-jul-17,N.L.,"CADEREYTA JIMENEZ, N.L.",1,0,1,0,0,0,
14-jul-17,B.C.,"ENSENADA, B.C.",1,0,1,0,0,0,
14-jul-17,B.C.,"MEXICALI, B.C.",0,1,1,0,0,0,
14-jul-17,MEX.,"OTUMBA, MEX.",0,1,1,0,10,133,
14-jul-17,TAMPS.,"MATAMOROS, TAMPS.",1,0,1,0,0,8,
14-jul-17,CHIS.,"CHIAPA DE CORZO, CHIS.",1,0,1,0,0,0,
14-jul-17,PUE.,"HUEJOTZINGO, PUE.",1,0,1,0,2,0,
14-jul-17,COAH.,"TORREÓN, COAH.",1,0,1,0,0,0,
14-jul-17,COAH.,"SABINAS, COAH.",1,0,1,0,0,0,
14-jul-17,DGO.,"DGO., DGO.",1,0,1,1,0,0,
14-jul-17,SIN.,"ESCUINAPA, SIN.",0,1,1,0,0,0,
14-jul-17,JAL.,"IXTLAHUACAN DE LOS MEMBRILLOS, JAL.",1,0,1,0,0,0,
14-jul-17,JAL.,"EL SALTO, JAL.",1,0,1,0,0,0,
14-jul-17,OAX.,"JUCHITAN DE ZARAGOZA, OAX.",1,0,1,1,0,30,
14-jul-17,TLAX.,"SANTA ANA NOPALUCAN, TLAX.",0,1,1,0,0,0,
15-jul-17,JAL.,"IXTLAHUACAN DE LOS MEMBRILLOS, JAL.",0,1,1,0,0,0,
15-jul-17,JAL.,"EL SALTO, JAL.",1,0,1,0,0,0,
15-jul-17,GRO.,"ATOYAC DE ALVAREZ, GRO.",1,0,1,0,0,0,
15-jul-17,SON.,"HERMOSILLO, SON.",1,0,1,1,0,0,
15-jul-17,MEX.,"ATLACOMULCO, MEX.",0,1,1,0,0,353,
15-jul-17,TLAX.,"SANTA ANA NOPALUCAN, TLAX.",0,1,1,0,0,0,
16-jul-17,MEX.,"OTUMBA, MEX.",1,0,1,0,0,47,
16-jul-17,GRO.,"ATOYAC DE ALVAREZ, GRO.",1,0,1,0,0,0,
17-jul-17,COAH.,"SAN PEDRO, COAH.",1,0,1,1,0,0,
17-jul-17,COAH.,"TORREÓN, COAH.",1,0,1,0,0,0,
17-jul-17,COAH.,"RAMOS ARIZPE, COAH.",0,1,1,0,0,19,
17-jul-17,B.C.,"TIJUANA, B.C.",0,1,1,0,0,0,
18-jul-17,COAH.,"RAMOS ARIZPE, COAH.",0,1,1,0,0,0,
18-jul-17,TAB.,"COMALCALCO, TAB.",1,0,1,0,0,0,
18-jul-17,JAL.,"ZAPOTLANEJO, JAL.",0,1,1,0,0,0,
18-jul-17,JAL.,"IXTLAHUACAN DE LOS MEMBRILLOS, JAL.",1,0,1,0,0,0,
18-jul-17,B.C.,"ENSENADA, B.C.",0,1,1,0,0,0,
18-jul-17,SON.,"HERMOSILLO, SON.",1,0,1,0,0,0,
18-jul-17,TLAX.,"SANTA ANA NOPALUCAN, TLAX.",1,0,1,0,0,0,
19-jul-17,JAL.,"IXTLAHUACAN DE LOS MEMBRILLOS, JAL.",0,1,1,0,0,0,
19-jul-17,COAH.,"SALTILLO, COAH.",1,0,1,1,0,0,
19-jul-17,MEX.,"CUAUTITLAN IZCALLI, MEX.",1,0,1,0,0,0,
19-jul-17,TLAX.,"TLAX., TLAX.",0,1,1,0,0,0,
19-jul-17,SON.,"NAVOJOA, SON.",1,0,1,0,0,0,
20-jul-17,COAH.,"SALTILLO, COAH.",0,1,1,0,0,96,
20-jul-17,JAL.,"IXTLAHUACAN DE LOS MEMBRILLOS, JAL.",0,1,1,0,0,0,
20-jul-17,JAL.,"EL SALTO, JAL.",0,1,1,0,0,0,
20-jul-17,TLAX.,"SANTA ANA NOPALUCAN, TLAX.",1,0,1,0,0,0,
21-jul-17,D.F.,"MIGUEL HGO., D.F.",1,0,1,0,0,0,
21-jul-17,JAL.,"IXTLAHUACAN DE LOS MEMBRILLOS, JAL.",1,0,1,0,0,0,
21-jul-17,JAL.,"EL SALTO, JAL.",1,0,1,0,0,0,
21-jul-17,TAMPS.,"TAMPICO, TAMPS.",1,0,1,1,0,23,
21-jul-17,COAH.,"PIEDRAS NEGRAS, COAH.",1,0,1,22,0,0,
21-jul-17,MEX.,"TENANGO DEL AIRE, MEX.",1,0,1,0,0,0,
21-jul-17,MEX.,"ATENCO, MEX.",0,1,1,0,0,0,
21-jul-17,MEX.,"RAYON, MEX.",1,0,1,1,0,33,
22-jul-17,N.L.,"CERRALVO, N.L.",0,1,1,0,0,0,
22-jul-17,JAL.,"IXTLAHUACAN DE LOS MEMBRILLOS, JAL.",0,1,1,0,0,0,
22-jul-17,JAL.,"EL SALTO, JAL.",0,1,1,0,0,0,
22-jul-17,B.C.,"TIJUANA, B.C.",0,1,1,0,0,0,
22-jul-17,MEX.,"TENANGO DEL AIRE, MEX.",1,0,1,0,0,0,
22-jul-17,JAL.,"TOMATLAN, JAL.",0,1,1,0,0,0,
22-jul-17,MEX.,"RAYON, MEX.",0,1,1,0,0,12,
23-jul-17,MEX.,"TENANGO DEL AIRE, MEX.",1,0,1,0,0,0,
23-jul-17,MEX.,"CUAUTITLAN IZCALLI, MEX.",1,0,1,0,0,0,
23-jul-17,JAL.,"EL SALTO, JAL.",0,1,1,0,0,0,
23-jul-17,B.C.,"TIJUANA, B.C.",1,0,1,0,0,0,
23-jul-17,B.C.,"ENSENADA, B.C.",0,1,1,0,0,0,
24-jul-17,TAB.,"CENTRO, TAB.",1,0,1,0,0,0,
24-jul-17,COAH.,"RAMOS ARIZPE, COAH.",1,0,1,0,0,0,
24-jul-17,COAH.,"MONCLOVA, COAH.",1,0,1,1,3,44,
24-jul-17,COAH.,"FRANCISCO I. MADERO, COAH.",1,0,1,0,0,0,
24-jul-17,JAL.,"EL SALTO, JAL.",1,0,1,0,0,0,
24-jul-17,TAMPS.,"TAMPICO, TAMPS.",0,1,1,0,0,0,
24-jul-17,SON.,"HUATABAMPO, SON.",0,1,1,0,0,0,
25-jul-17,MEX.,"TEPETLAOXTOC, MEX.",0,1,1,0,0,0,
25-jul-17,HGO.,"ZACUALTIPAN DE ANGELES, HGO.",0,1,1,0,0,0,
25-jul-17,TAB.,"CENTRO, TAB.",1,0,1,0,0,5,
25-jul-17,N.L.,"MONTERREY, N.L.",0,1,1,0,0,17,
25-jul-17,COAH.,"RAMOS ARIZPE, COAH.",1,0,1,8,0,500,
25-jul-17,COAH.,"MONCLOVA, COAH.",1,0,1,0,0,0,
25-jul-17,COAH.,"PIEDRAS NEGRAS, COAH.",0,1,1,0,0,0,
25-jul-17,COAH.,"MÚZQUIZ, COAH.",0,1,1,0,0,57,
25-jul-17,MEX.,"ALMOLOYA DEL RIO, MEX.",1,0,1,0,0,0,
25-jul-17,MEX.,"VILLA DEL CARBON, MEX.",1,0,1,0,0,0,
25-jul-17,TAB.,"PARAISO, TAB.",1,0,1,0,0,0,
26-jul-17,AGS.,"AGS., AGS.",1,0,1,1,0,0,
26-jul-17,COAH.,"FRANCISCO I. MADERO, COAH.",0,1,1,0,0,0,
26-jul-17,COAH.,"MÚZQUIZ, COAH.",1,0,1,0,0,0,
26-jul-17,MEX.,"TEPETLIXPA, MEX.",1,0,1,1,0,0,
26-jul-17,D.F.,"AZCAPOTZALCO, D.F.",1,0,1,0,0,0,
26-jul-17,MEX.,"ALMOLOYA DEL RIO, MEX.",1,0,1,0,0,0,
27-jul-17,COAH.,"SAN PEDRO, COAH.",1,0,1,0,0,0,
27-jul-17,COAH.,"FRONTERA, COAH.",1,0,1,0,0,0,
27-jul-17,MICH.,"BUENAVISTA, MICH.",0,1,1,0,0,0,
27-jul-17,HGO.,"TIZAYUCA, HGO.",0,1,1,0,0,0,
27-jul-17,MEX.,"TEPETLIXPA, MEX.",0,1,1,0,0,1690,
27-jul-17,MEX.,"TEPETLAOXTOC, MEX.",1,0,1,0,0,0,
27-jul-17,MEX.,"ALMOLOYA DEL RIO, MEX.",1,0,1,0,0,0,
27-jul-17,SON.,"GUAYMAS, SON.",1,0,1,0,0,0,
28-jul-17,MICH.,"BUENAVISTA, MICH.",0,1,1,0,0,0,
29-jul-17,B.C.,"TIJUANA, B.C.",0,1,1,0,0,0,
29-jul-17,MEX.,"CHAPA DE MOTA, MEX.",1,0,1,0,0,0,
29-jul-17,COAH.,"PIEDRAS NEGRAS, COAH.",1,0,1,0,0,0,
30-jul-17,MEX.,"ALMOLOYA DEL RIO, MEX.",1,0,1,0,0,79,
30-jul-17,MEX.,"TEPETLAOXTOC, MEX.",1,0,1,0,0,0,
31-jul-17,COAH.,"TORREÓN, COAH.",1,0,1,0,0,0,
31-jul-17,COAH.,"RAMOS ARIZPE, COAH.",1,0,1,1,0,400,
31-jul-17,COAH.,"SAN PEDRO, COAH.",1,0,1,0,0,0,
01-ago-17,MOR.,"EMILIANO ZAPATA, MOR.",0,1,1,0,0,0,
01-ago-17,COAH.,"SAN PEDRO, COAH.",1,0,1,0,0,0,
01-ago-17,COAH.,"PIEDRAS NEGRAS, COAH.",0,1,1,0,0,0,
01-ago-17,TAB.,"CENTRO, TAB.",1,0,1,1,0,0,
02-ago-17,B.C.,"MEXICALI, B.C.",1,0,1,0,0,0,
02-ago-17,MEX.,"SAN SIMON DE GRO., MEX.",1,0,1,0,0,0,
02-ago-17,MEX.,"SOYANIQUILPAN DE JUAREZ, MEX.",1,0,1,0,0,50,
02-ago-17,MEX.,"TEZOYUCA, MEX.",1,0,1,0,0,0,
02-ago-17,SON.,"HERMOSILLO, SON.",0,1,1,0,0,0,
02-ago-17,MICH.,"BUENAVISTA, MICH.",1,0,1,0,0,164,
02-ago-17,COAH.,"SALTILLO, COAH.",1,0,1,0,0,945,
02-ago-17,COAH.,"MÚZQUIZ, COAH.",0,1,1,2,0,0,
03-ago-17,D.F.,"MIGUEL HGO., D.F.",1,0,1,0,7,0,
03-ago-17,OAX.,"PINOTEPA DE DON LUIS, OAX.",0,1,1,0,0,0,
03-ago-17,COAH.,"PIEDRAS NEGRAS, COAH.",1,0,1,0,0,140,
03-ago-17,MEX.,"TEZOYUCA, MEX.",0,1,1,0,1,0,
03-ago-17,TAB.,"PARAISO, TAB.",1,0,1,0,0,0,
04-ago-17,GRO.,"TLACOACHISTLAHUACA, GRO.",1,0,1,0,0,0,
04-ago-17,MEX.,"TEZOYUCA, MEX.",0,1,1,0,0,0,
04-ago-17,COAH.,"PIEDRAS NEGRAS, COAH.",1,0,1,0,0,0,
04-ago-17,COAH.,"SAN PEDRO, COAH.",1,0,1,0,0,0,
04-ago-17,MEX.,"SAN SIMON DE GRO., MEX.",1,0,1,0,0,0,
04-ago-17,AGS.,"AGS., AGS.",1,0,1,2,0,0,
05-ago-17,B.C.,"ENSENADA, B.C.",1,0,1,0,0,0,
05-ago-17,MEX.,"SAN SIMON DE GRO., MEX.",1,0,1,0,0,0,
05-ago-17,MEX.,"TLALMANALCO, MEX.",1,0,1,1,0,0,
05-ago-17,COAH.,"SABINAS, COAH.",1,0,1,0,0,0,
05-ago-17,TAMPS.,"MATAMOROS, TAMPS.",1,0,1,0,0,0,
07-ago-17,B.C.,"MEXICALI, B.C.",1,0,1,0,0,0,
07-ago-17,Q. ROO,"OTHON P. BLANCO, Q. ROO",0,1,1,0,0,492,
07-ago-17,S.L.P.,"CIUDAD VALLES, S.L.P.",1,0,1,0,0,0,
08-ago-17,HGO.,"ZACUALTIPAN DE ANGELES, HGO.",1,0,1,0,0,0,
08-ago-17,MOR.,"EMILIANO ZAPATA, MOR.",1,0,1,0,0,0,
08-ago-17,CHIS.,"TAPACHULA, CHIS.",0,1,1,0,0,0,
08-ago-17,COAH.,"RAMOS ARIZPE, COAH.",1,0,1,0,0,381,
08-ago-17,COAH.,"SALTILLO, COAH.",0,1,1,0,0,0,
08-ago-17,COAH.,"SAN PEDRO, COAH.",0,1,1,0,0,0,
08-ago-17,COAH.,"SAN PEDRO, COAH.",0,1,1,0,0,0,
08-ago-17,S.L.P.,"SAN LUIS POTOSI, S.L.P.",1,0,1,0,0,0,
08-ago-17,N.L.,"MELCHOR OCAMPO, N.L.",0,1,1,3,0,170,
09-ago-17,B.C.,"ENSENADA, B.C.",0,1,1,0,0,0,
09-ago-17,B.C.,"MEXICALI, B.C.",0,1,1,0,0,0,
09-ago-17,COAH.,"PIEDRAS NEGRAS, COAH.",1,0,1,0,0,0,
10-ago-17,CHIH.,"HGO. DEL PARRAL, CHIH.",1,0,1,1,0,3,
10-ago-17,SIN.,"ESCUINAPA, SIN.",0,1,1,0,0,0,
10-ago-17,N.L.,"MONTERREY, N.L.",1,0,1,0,0,40,
10-ago-17,S.L.P.,"CIUDAD VALLES, S.L.P.",1,0,1,0,0,0,
10-ago-17,TAB.,"CENTRO, TAB.",1,0,1,0,0,0,
11-ago-17,AGS.,"AGS., AGS.",1,0,1,2,0,0,
11-ago-17,QRO.,"EL MARQUES, QRO.",0,1,1,0,0,0,
11-ago-17,MEX.,"TEXCALYACAC, MEX.",0,1,1,0,0,0,
11-ago-17,MEX.,"AMECAMECA, MEX.",1,0,1,0,0,0,
11-ago-17,COAH.,"FRANCISCO I. MADERO, COAH.",1,0,1,1,0,0,
11-ago-17,COAH.,"SALTILLO, COAH.",1,0,1,0,0,0,
11-ago-17,N.L.,"MONTERREY, N.L.",1,0,1,0,0,232,
11-ago-17,TAMPS.,"NUEVO LAREDO, TAMPS.",1,0,1,3,0,92,
11-ago-17,SIN.,"ESCUINAPA, SIN.",0,1,1,0,0,0,
11-ago-17,MEX.,"AMECAMECA, MEX.",1,0,1,0,0,0,
12-ago-17,COAH.,"NAVA, COAH.",0,1,1,0,0,0,
13-ago-17,MEX.,"TEXCALYACAC, MEX.",1,0,1,0,0,0,
13-ago-17,S.L.P.,"SAN LUIS POTOSI, S.L.P.",1,0,1,10,0,0,
14-ago-17,QRO.,"EL MARQUES, QRO.",0,1,1,0,5,0,
14-ago-17,CHIH.,"HGO. DEL PARRAL, CHIH.",1,0,1,1,0,3,
14-ago-17,MOR.,"EMILIANO ZAPATA, MOR.",1,0,1,1,0,19,
14-ago-17,COAH.,"MONCLOVA, COAH.",1,0,1,0,2,0,
14-ago-17,SIN.,"COSALA, SIN.",0,1,1,0,0,0,
14-ago-17,SIN.,"ANGOSTURA, SIN.",0,1,1,0,0,0,
14-ago-17,Q. ROO,"OTHON P. BLANCO, Q. ROO",1,0,1,0,7,60,
15-ago-17,MEX.,"TIMILPAN, MEX.",1,0,1,1,0,0,
15-ago-17,MEX.,"CHICONCUAC, MEX.",0,1,1,0,0,166,
15-ago-17,COAH.,"MÚZQUIZ, COAH.",0,1,1,0,0,0,
15-ago-17,N.L.,"MONTERREY, N.L.",1,0,1,0,0,45,
15-ago-17,SIN.,"ANGOSTURA, SIN.",1,0,1,0,0,0,
16-ago-17,SIN.,"ANGOSTURA, SIN.",0,1,1,0,2,0,
16-ago-17,SIN.,"COSALA, SIN.",0,1,1,0,5,0,
17-ago-17,N.L.,"ALLENDE, N.L.",1,0,1,1,0,0,
17-ago-17,S.L.P.,"CIUDAD VALLES, S.L.P.",1,0,1,0,2,123,
17-ago-17,VER.,"CAMERINO Z. MENDOZA, VER.",1,0,1,0,0,0,
17-ago-17,VER.,"MISANTLA, VER.",1,0,1,1,0,1,
17-ago-17,B.C.,"TIJUANA, B.C.",1,0,1,0,0,0,
17-ago-17,COAH.,"MÚZQUIZ, COAH.",0,1,1,0,0,0,
17-ago-17,TAMPS.,"NUEVO LAREDO, TAMPS.",1,0,1,0,0,0,
18-ago-17,N.L.,"ALLENDE, N.L.",1,0,1,0,0,0,
18-ago-17,TAMPS.,"NUEVO LAREDO, TAMPS.",1,0,1,0,0,0,
18-ago-17,OAX.,"SANTO DOMINGO TEHUANTEPEC, OAX.",1,0,1,0,0,0,
18-ago-17,MICH.,"GABRIEL ZAMORA, MICH.",1,0,1,0,0,500,
18-ago-17,VER.,"SAYULA DE ALEMAN, VER.",1,0,1,0,0,0,
18-ago-17,COAH.,"MÚZQUIZ, COAH.",1,0,1,0,0,0,
18-ago-17,COAH.,"ACUÑA, COAH.",0,1,1,0,0,0,
18-ago-17,S.L.P.,"SAN LUIS POTOSI, S.L.P.",1,0,1,1,0,0,
18-ago-17,GRO.,"ATOYAC DE ALVAREZ, GRO.",1,0,1,1,0,9,
18-ago-17,TAB.,"CENTRO, TAB.",1,0,1,0,0,0,
19-ago-17,DGO.,"SANTIAGO PAPASQUIARO, DGO.",1,0,1,1,0,0,
19-ago-17,MEX.,"TIMILPAN, MEX.",1,0,1,1,0,0,
19-ago-17,GRO.,"ATOYAC DE ALVAREZ, GRO.",0,1,1,0,0,0,
19-ago-17,GRO.,"PUNGARABATO, GRO.",1,0,1,0,0,0,
19-ago-17,COAH.,"SABINAS, COAH.",1,0,1,0,0,0,
19-ago-17,TAMPS.,"MATAMOROS, TAMPS.",1,0,1,0,0,0,
19-ago-17,MEX.,"CHICONCUAC, MEX.",1,0,1,0,0,0,
19-ago-17,S.L.P.,"SAN LUIS POTOSI, S.L.P.",1,0,1,2,2,0,
19-ago-17,S.L.P.,"CIUDAD VALLES, S.L.P.",0,1,1,0,0,0,
19-ago-17,B.C.,"ENSENADA, B.C.",0,1,1,0,0,0,
20-ago-17,S.L.P.,"SAN LUIS POTOSI, S.L.P.",1,0,1,5,0,0,
22-ago-17,HGO.,"ZACUALTIPAN DE ANGELES, HGO.",1,0,1,0,1,0,
22-ago-17,MOR.,"EMILIANO ZAPATA, MOR.",1,0,1,0,0,52,
22-ago-17,MEX.,"SAN MARTIN DE LAS PIRAMIDES, MEX.",1,0,1,1,0,288,
22-ago-17,COAH.,"PIEDRAS NEGRAS, COAH.",1,0,1,0,0,0,
22-ago-17,COAH.,"RAMOS ARIZPE, COAH.",0,1,1,1,0,494,
22-ago-17,COAH.,"SALTILLO, COAH.",1,0,1,0,0,28,
22-ago-17,COAH.,"SAN PEDRO, COAH.",1,0,1,0,0,0,
22-ago-17,COAH.,"SAN PEDRO, COAH.",1,0,1,0,0,0,
22-ago-17,MEX.,"VILLA DE ALLENDE, MEX.",1,0,1,0,0,0,
22-ago-17,YUC.,"TINUM, YUC.",1,0,1,0,0,0,
22-ago-17,VER.,"COATEPEC, VER.",1,0,1,1,0,24,
22-ago-17,TAB.,"CENTRO, TAB.",1,0,1,0,0,0,
22-ago-17,B.C.,"MEXICALI, B.C.",0,1,1,0,0,0,
23-ago-17,GRO.,"ARCELIA, GRO.",1,0,1,0,0,0,
24-ago-17,MEX.,"VILLA DE ALLENDE, MEX.",1,0,1,0,0,90,
24-ago-17,MOR.,"EMILIANO ZAPATA, MOR.",1,0,1,0,3,0,
24-ago-17,CHIH.,"JANOS, CHIH.",1,0,1,0,0,0,
24-ago-17,COAH.,"MATAMOROS, COAH.",1,0,1,0,0,0,
24-ago-17,COAH.,"MÚZQUIZ, COAH.",1,0,1,0,0,0,
24-ago-17,COAH.,"RAMOS ARIZPE, COAH.",1,0,1,0,0,34,
24-ago-17,COAH.,"SALTILLO, COAH.",1,0,1,0,0,930,
24-ago-17,GRO.,"COAHUAYUTLA DE JOSE MARIA IZAZAGA, GRO.",0,1,1,0,0,0,
24-ago-17,DGO.,"DGO., DGO.",1,0,1,1,0,0,
24-ago-17,MEX.,"SAN MARTIN DE LAS PIRAMIDES, MEX.",0,1,1,0,12,0,
25-ago-17,D.F.,"VENUSTIANO CARRANZA, D.F.",1,0,1,0,0,338,
25-ago-17,COAH.,"SABINAS, COAH.",0,1,1,5,0,0,
25-ago-17,B.C.,"TIJUANA, B.C.",1,0,1,0,0,0,
25-ago-17,B.C.,"ENSENADA, B.C.",0,1,1,0,0,0,
25-ago-17,MEX.,"SAN MARTIN DE LAS PIRAMIDES, MEX.",1,0,1,0,0,0,
25-ago-17,N.L.,"LOS HERRERAS, N.L.",0,1,1,0,0,0,
25-ago-17,S.L.P.,"SAN LUIS POTOSI, S.L.P.",1,0,1,0,0,0,
25-ago-17,VER.,"ALTOTONGA, VER.",1,0,1,1,0,36,
26-ago-17,TAMPS.,"MATAMOROS, TAMPS.",0,1,1,0,0,0,
26-ago-17,DGO.,"DGO., DGO.",1,0,1,0,0,0,
26-ago-17,B.C.,"TIJUANA, B.C.",0,1,1,0,0,0,
26-ago-17,HGO.,"ZACUALTIPAN DE ANGELES, HGO.",1,0,1,0,0,0,
27-ago-17,COAH.,"PIEDRAS NEGRAS, COAH.",1,0,1,0,0,0,
27-ago-17,S.L.P.,"SAN LUIS POTOSI, S.L.P.",1,0,1,0,0,0,
28-ago-17,B.C.,"TIJUANA, B.C.",0,1,1,0,0,0,
28-ago-17,N.L.,"MONTERREY, N.L.",1,0,1,1,0,254,
28-ago-17,TAMPS.,"NUEVO LAREDO, TAMPS.",0,1,1,0,0,300,
29-ago-17,TAMPS.,"NUEVO LAREDO, TAMPS.",1,0,1,0,0,300,
29-ago-17,MEX.,"TULTITLAN, MEX.",1,0,1,0,0,0,
29-ago-17,MEX.,"LA PAZ, MEX.",1,0,1,0,0,24,
29-ago-17,COAH.,"TORREÓN, COAH.",1,0,1,0,0,0,
29-ago-17,COAH.,"MATAMOROS, COAH.",0,1,1,0,0,0,
29-ago-17,COAH.,"FRANCISCO I. MADERO, COAH.",1,0,1,0,0,0,
29-ago-17,COAH.,"SALTILLO, COAH.",0,1,1,0,2,0,
29-ago-17,B.C.,"TIJUANA, B.C.",0,1,1,0,0,0,
30-ago-17,DGO.,"DGO., DGO.",1,0,1,0,0,0,
30-ago-17,S.L.P.,"SAN LUIS POTOSI, S.L.P.",1,0,1,0,0,0,
30-ago-17,MEX.,"XALATLACO, MEX.",0,1,1,0,0,0,
30-ago-17,COAH.,"MATAMOROS, COAH.",1,0,1,0,0,0,
31-ago-17,TAMPS.,"NUEVO LAREDO, TAMPS.",1,0,1,0,0,0,
31-ago-17,COAH.,"ACUÑA, COAH.",1,0,1,0,0,0,
31-ago-17,B.C.,"ENSENADA, B.C.",0,1,1,0,0,0,
31-ago-17,D.F.,"TLALPAN, D.F.",0,1,1,0,0,0,
31-ago-17,MEX.,"TULTITLAN, MEX.",0,1,1,0,0,23,
01-sep-17,MEX.,"ZACAZONAPAN, MEX.",1,0,1,0,0,0,
01-sep-17,D.F.,"TLALPAN, D.F.",1,0,1,0,0,0,
01-sep-17,TAMPS.,"NUEVO LAREDO, TAMPS.",1,0,1,0,0,200,
02-sep-17,COAH.,"TORREÓN, COAH.",1,0,1,0,0,0,
02-sep-17,S.L.P.,"SAN LUIS POTOSI, S.L.P.",1,0,1,0,0,0,
02-sep-17,DGO.,"DGO., DGO.",0,1,1,0,1,0,
02-sep-17,MEX.,"XALATLACO, MEX.",1,0,1,0,0,0,
02-sep-17,TAB.,"BENEMÉRITO DE LAS AMÉRICAS, CHIS.",1,0,1,0,0,0,
02-sep-17,COAH.,"SAN PEDRO, COAH.",1,0,1,0,0,0,
03-sep-17,MEX.,"XALATLACO, MEX.",1,0,1,0,0,27,
03-sep-17,B.C.,"ENSENADA, B.C.",1,0,1,0,1,0,
04-sep-17,Q. ROO,"TULUM, Q. ROO",0,1,1,0,0,0,
04-sep-17,D.F.,"TLALPAN, D.F.",1,0,1,0,7,1662,
04-sep-17,QRO.,"JALPAN DE SERRA, QRO.",0,1,1,0,0,0,
04-sep-17,DGO.,"DGO., DGO.",0,1,1,0,1,0,
04-sep-17,COAH.,"TORREÓN, COAH.",0,1,1,0,1,0,
04-sep-17,S.L.P.,"CIUDAD VALLES, S.L.P.",1,0,1,0,0,0,
04-sep-17,COAH.,"SALTILLO, COAH.",1,0,1,1,0,77,
04-sep-17,COAH.,"RAMOS ARIZPE, COAH.",1,0,1,0,0,0,
05-sep-17,N.L.,"MONTERREY, N.L.",0,1,1,1,0,65,
05-sep-17,COAH.,"FRANCISCO I. MADERO, COAH.",0,1,1,0,0,0,
05-sep-17,S.L.P.,"CIUDAD VALLES, S.L.P.",1,0,1,0,0,0,
05-sep-17,MEX.,"APAXCO, MEX.",1,0,1,0,0,0,
06-sep-17,GRO.,"CHILPANCINGO DE LOS BRAVO, GRO.",0,1,1,0,0,0,
06-sep-17,MEX.,"CHIAUTLA, MEX.",0,1,1,0,0,0,
06-sep-17,MEX.,"APAXCO, MEX.",1,0,1,1,0,0,
06-sep-17,ZAC.,"GUADALUPE, ZAC.",0,1,1,0,0,18,
06-sep-17,COAH.,"MATAMOROS, COAH.",1,0,1,0,0,0,
06-sep-17,COAH.,"SALTILLO, COAH.",1,0,1,0,0,47,
07-sep-17,COAH.,"RAMOS ARIZPE, COAH.",1,0,1,0,0,0,
07-sep-17,COAH.,"PIEDRAS NEGRAS, COAH.",1,0,1,0,0,0,
07-sep-17,MEX.,"CHIAUTLA, MEX.",1,0,1,0,0,445,
07-sep-17,B.C.,"MEXICALI, B.C.",1,0,1,0,0,0,
08-sep-17,S.L.P.,"CIUDAD VALLES, S.L.P.",1,0,1,0,0,0,
08-sep-17,COAH.,"SAN PEDRO, COAH.",1,0,1,0,0,0,
08-sep-17,COAH.,"SALTILLO, COAH.",1,0,1,0,0,44,
08-sep-17,COAH.,"SABINAS, COAH.",1,0,1,0,0,0,
08-sep-17,COAH.,"TORREÓN, COAH.",1,0,1,0,0,0,
08-sep-17,MEX.,"CHIAUTLA, MEX.",1,0,1,0,0,71,
09-sep-17,DGO.,"DGO., DGO.",1,0,1,0,0,0,
09-sep-17,S.L.P.,"CIUDAD VALLES, S.L.P.",1,0,1,0,0,0,
09-sep-17,S.L.P.,"SAN LUIS POTOSI, S.L.P.",1,0,1,3,1,0,
09-sep-17,MEX.,"ZACUALPAN, MEX.",0,1,1,0,0,0,
09-sep-17,MEX.,"ZUMPAHUACAN, MEX.",1,0,1,0,0,0,
09-sep-17,COAH.,"SAN PEDRO, COAH.",1,0,1,0,0,0,
09-sep-17,MEX.,"APAXCO, MEX.",0,1,1,0,0,0,
09-sep-17,B.C.,"MEXICALI, B.C.",0,1,1,0,0,0,
10-sep-17,COAH.,"SAN PEDRO, COAH.",1,0,1,0,0,0,
11-sep-17,DGO.,"DGO., DGO.",0,1,1,0,0,0,
12-sep-17,B.C.,"ENSENADA, B.C.",0,1,1,0,0,0,
12-sep-17,ZAC.,"TLALTENANGO DE SANCHEZ ROMAN, ZAC.",1,0,1,0,0,0,
13-sep-17,COAH.,"SAN PEDRO, COAH.",1,0,1,0,0,0,
13-sep-17,ZAC.,"TLALTENANGO DE SANCHEZ ROMAN, ZAC.",0,1,1,0,0,35,
13-sep-17,D.F.,"TLALPAN, D.F.",1,0,1,0,0,200,
13-sep-17,D.F.,"ALVARO OBREGON, D.F.",0,1,1,0,1,0,
14-sep-17,B.C.,"ENSENADA, B.C.",1,0,1,0,0,0,
14-sep-17,COAH.,"SAN PEDRO, COAH.",0,1,1,0,0,0,
14-sep-17,AGS.,"AGS., AGS.",1,0,1,0,0,0,
14-sep-17,D.F.,"ALVARO OBREGON, D.F.",1,0,1,0,0,0,
14-sep-17,ZAC.,"TLALTENANGO DE SANCHEZ ROMAN, ZAC.",1,0,1,0,0,210,
15-sep-17,TAMPS.,"MATAMOROS, TAMPS.",0,1,1,6,0,297,
15-sep-17,VER.,"ISLA, VER.",1,0,1,0,0,0,
16-sep-17,DGO.,"DGO., DGO.",1,0,1,1,0,0,
17-sep-17,DGO.,"DGO., DGO.",1,0,1,0,0,0,
18-sep-17,B.C.,"TIJUANA, B.C.",1,0,1,0,0,0,
18-sep-17,COAH.,"SALTILLO, COAH.",1,0,1,2,2,210,
18-sep-17,COAH.,"ACUÑA, COAH.",1,0,1,0,0,0,
18-sep-17,GRO.,"TECPAN DE GALEANA, GRO.",1,0,1,1,0,7,
19-sep-17,ZAC.,"GUADALUPE, ZAC.",1,0,1,0,0,0,
19-sep-17,DGO.,"DGO., DGO.",1,0,1,7,0,0,
19-sep-17,SIN.,"MOCORITO, SIN.",1,0,1,0,2,0,
19-sep-17,MEX.,"AMATEPEC, MEX.",1,0,1,0,0,0,
19-sep-17,MEX.,"COYOTEPEC, MEX.",0,1,1,0,0,0,
19-sep-17,TAMPS.,"TAMPICO, TAMPS.",1,0,1,0,0,0,
19-sep-17,B.C.,"TIJUANA, B.C.",0,1,1,0,0,0,
19-sep-17,B.C.,"MEXICALI, B.C.",1,0,1,0,0,0,
19-sep-17,GRO.,"TECPAN DE GALEANA, GRO.",1,0,1,1,0,8,
20-sep-17,ZAC.,"GUADALUPE, ZAC.",1,0,1,1,0,264,
20-sep-17,COAH.,"FRANCISCO I. MADERO, COAH.",0,1,1,1,0,0,
20-sep-17,GRO.,"TECPAN DE GALEANA, GRO.",0,1,1,0,0,0,
20-sep-17,MEX.,"AMATEPEC, MEX.",1,0,1,0,0,0,
20-sep-17,N.L.,"LINARES, N.L.",0,1,1,0,0,0,
20-sep-17,MEX.,"COYOTEPEC, MEX.",0,1,1,0,0,53,
21-sep-17,MEX.,"AMANALCO, MEX.",0,1,1,0,0,0,
21-sep-17,N.L.,"LINARES, N.L.",1,0,1,0,0,0,
21-sep-17,COAH.,"RAMOS ARIZPE, COAH.",1,0,1,0,0,650,
21-sep-17,COAH.,"ACUÑA, COAH.",1,0,1,0,0,0,
22-sep-17,ZAC.,"PINOS, ZAC.",1,0,1,0,0,0,
22-sep-17,COAH.,"SALTILLO, COAH.",0,1,1,0,0,0,
22-sep-17,N.L.,"LINARES, N.L.",0,1,1,0,0,0,
22-sep-17,TAB.,"CENTRO, TAB.",0,1,1,0,0,0,
22-sep-17,MEX.,"TEPOTZOTLAN, MEX.",1,0,1,0,0,0,
23-sep-17,MEX.,"AMANALCO, MEX.",1,0,1,0,0,0,
23-sep-17,TAB.,"TENOSIQUE, TAB.",1,0,1,0,0,0,
23-sep-17,COAH.,"SALTILLO, COAH.",1,0,1,0,1,0,
24-sep-17,ZAC.,"GUADALUPE, ZAC.",1,0,1,0,0,1054,
24-sep-17,N.L.,"CHINA, N.L.",1,0,1,0,0,0,
25-sep-17,B.C.,"TIJUANA, B.C.",1,0,1,0,0,0,
25-sep-17,B.C.,"ENSENADA, B.C.",1,0,1,0,0,0,
25-sep-17,GRO.,"COYUCA DE BENITEZ, GRO.",0,1,1,0,0,0,
26-sep-17,ZAC.,"GUADALUPE, ZAC.",1,0,1,1,0,27,
26-sep-17,COAH.,"SAN PEDRO, COAH.",1,0,1,0,0,30,
26-sep-17,MEX.,"PAPALOTLA, MEX.",0,1,1,0,0,0,
27-sep-17,MEX.,"CAPULHUAC, MEX.",0,1,1,0,0,0,
27-sep-17,N.L.,"LINARES, N.L.",1,0,1,0,0,0,
27-sep-17,N.L.,"MONTERREY, N.L.",1,0,1,5,0,80,
27-sep-17,B.C.,"ENSENADA, B.C.",0,1,1,0,0,0,
27-sep-17,DGO.,"DGO., DGO.",1,0,1,0,0,0,
28-sep-17,CHIH.,"CASAS GRANDES, CHIH.",0,1,1,0,0,0,
28-sep-17,MEX.,"PAPALOTLA, MEX.",1,0,1,0,0,0,
28-sep-17,SON.,"SAHUARIPA, SON.",1,0,1,0,0,0,
29-sep-17,ZAC.,"JUCHIPILA, ZAC.",1,0,1,0,0,0,
30-sep-17,CAMP.,"CALKINÍ, CAMP.",0,1,1,0,0,0,
30-sep-17,B.C.,"MEXICALI, B.C.",1,0,1,0,0,0,
02-oct-17,SON.,"GUAYMAS, SON.",1,0,1,1,0,22,
02-oct-17,SON.,"ALAMOS, SON.",1,0,1,1,0,0,
03-oct-17,B.C.,"MEXICALI, B.C.",0,1,1,0,0,0,
03-oct-17,ZAC.,"OJOCALIENTE, ZAC.",1,0,1,0,0,0,
03-oct-17,ZAC.,"FRESNILLO, ZAC.",1,0,1,0,0,0,
04-oct-17,ZAC.,"JEREZ, ZAC.",0,1,1,0,0,0,
04-oct-17,CHIS.,"OCOSINGO, CHIS.",1,0,1,0,0,0,
04-oct-17,B.C.,"ENSENADA, B.C.",1,0,1,0,1,0,
05-oct-17,N.L.,"GRAL. BRAVO, N.L.",0,1,1,0,0,0,
05-oct-17,SON.,"ALAMOS, SON.",1,0,1,0,0,0,
05-oct-17,COL.,"COL., COL.",0,1,1,0,0,0,
05-oct-17,SIN.,"MOCORITO, SIN.",0,1,1,0,0,0,
06-oct-17,ZAC.,"JEREZ, ZAC.",1,0,1,0,0,429,
06-oct-17,DGO.,"DGO., DGO.",1,0,1,0,0,0,
06-oct-17,GRO.,"TECPAN DE GALEANA, GRO.",0,1,1,0,0,0,
06-oct-17,SON.,"EMPALME, SON.",1,0,1,1,0,0,
09-oct-17,D.F.,"IZTACALCO, D.F.",1,0,1,0,0,55,
09-oct-17,N.L.,"GALEANA, N.L.",1,0,1,0,0,0,
09-oct-17,ZAC.,"RIO GRANDE, ZAC.",1,0,1,0,0,0,
10-oct-17,COAH.,"SALTILLO, COAH.",1,0,1,0,0,0,
10-oct-17,D.F.,"IZTACALCO, D.F.",1,0,1,0,0,13,
11-oct-17,D.F.,"IZTACALCO, D.F.",0,1,1,0,0,199,
11-oct-17,B.C.,"TIJUANA, B.C.",1,0,1,0,0,0,
11-oct-17,SON.,"HERMOSILLO, SON.",1,0,1,0,0,0,
11-oct-17,N.L.,"MONTERREY, N.L.",0,1,1,0,0,0,
11-oct-17,DGO.,"DGO., DGO.",1,0,1,0,0,0,
11-oct-17,COL.,"COL., COL.",1,0,1,0,0,0,
11-oct-17,GRO.,"TECPAN DE GALEANA, GRO.",1,0,1,1,0,0,
12-oct-17,SON.,"HERMOSILLO, SON.",1,0,1,0,0,192,
12-oct-17,DGO.,"DGO., DGO.",0,1,1,0,0,0,
12-oct-17,MICH.,"APATZINGAN, MICH.",1,0,1,0,0,0,
12-oct-17,B.C.,"MEXICALI, B.C.",0,1,1,0,0,0,
12-oct-17,SON.,"HERMOSILLO, SON.",1,0,1,0,0,70,
13-oct-17,COAH.,"ACUÑA, COAH.",0,1,1,0,0,20,
13-oct-17,N.L.,"GALEANA, N.L.",0,1,1,0,0,0,
14-oct-17,ZAC.,"OJOCALIENTE, ZAC.",1,0,1,0,0,0,
15-oct-17,B.C.,"MEXICALI, B.C.",1,0,1,0,0,0,
16-oct-17,D.F.,"LA MAGDALENA CONTRERAS, D.F.",0,1,1,0,0,0,
16-oct-17,SON.,"HERMOSILLO, SON.",1,0,1,0,0,0,
16-oct-17,SIN.,"GUASAVE, SIN.",1,0,1,0,0,0,
16-oct-17,ZAC.,"CUAUHTEMOC, ZAC.",0,1,1,0,0,0,
17-oct-17,SON.,"SAHUARIPA, SON.",1,0,1,0,0,0,
17-oct-17,SON.,"ALAMOS, SON.",1,0,1,0,0,0,
17-oct-17,SIN.,"GUASAVE, SIN.",1,0,1,0,0,0,
17-oct-17,ZAC.,"MOMAX, ZAC.",0,1,1,0,0,0,
17-oct-17,COL.,"COL., COL.",1,0,1,0,0,103,
17-oct-17,DGO.,"GOMEZ PALACIO, DGO.",0,1,1,0,0,0,
18-oct-17,B.C.,"TIJUANA, B.C.",1,0,1,0,0,0,
18-oct-17,DGO.,"DGO., DGO.",1,0,1,0,0,0,
18-oct-17,N.L.,"MONTERREY, N.L.",1,0,1,0,0,0,
18-oct-17,SIN.,"CULIACAN, SIN.",1,0,1,0,0,0,
18-oct-17,SON.,"SAHUARIPA, SON.",0,1,1,0,0,0,
19-oct-17,SON.,"HERMOSILLO, SON.",1,0,1,1,0,0,
19-oct-17,SIN.,"CULIACAN, SIN.",1,0,1,0,0,0,
19-oct-17,DGO.,"SANTIAGO PAPASQUIARO, DGO.",1,0,1,0,0,0,
20-oct-17,SIN.,"GUASAVE, SIN.",1,0,1,0,0,0,
20-oct-17,SON.,"ALAMOS, SON.",1,0,1,0,0,0,
21-oct-17,COAH.,"ACUÑA, COAH.",1,0,1,1,0,0,
21-oct-17,B.C.S.,"MULEGÉ, B.C.S.",0,1,1,0,0,300,
23-oct-17,AGS.,"AGS., AGS.",1,0,1,0,0,0,
23-oct-17,SIN.,"GUASAVE, SIN.",1,0,1,0,0,0,
23-oct-17,DGO.,"GOMEZ PALACIO, DGO.",1,0,1,0,0,0,
23-oct-17,GRO.,"COYUCA DE BENITEZ, GRO.",1,0,1,0,0,0,
24-oct-17,SON.,"MOCTEZUMA, SON.",0,1,1,0,0,0,
24-oct-17,DGO.,"GOMEZ PALACIO, DGO.",1,0,1,0,0,0,
25-oct-17,DGO.,"DGO., DGO.",0,1,1,0,0,0,
25-oct-17,SON.,"HERMOSILLO, SON.",1,0,1,0,0,20,
25-oct-17,SIN.,"GUASAVE, SIN.",1,0,1,0,2,0,
25-oct-17,SIN.,"CULIACAN, SIN.",1,0,1,0,9,0,
26-oct-17,ZAC.,"MONTE ESCOBEDO, ZAC.",1,0,1,3,0,36,
26-oct-17,ZAC.,"MOYAHUA DE ESTRADA, ZAC.",1,0,1,0,0,0,
27-oct-17,TAMPS.,"MATAMOROS, TAMPS.",1,0,1,0,0,0,
27-oct-17,AGS.,"AGS., AGS.",1,0,1,0,0,5,
27-oct-17,COAH.,"SABINAS, COAH.",1,0,1,0,0,0,
27-oct-17,DGO.,"GOMEZ PALACIO, DGO.",0,1,1,0,0,0,
27-oct-17,SIN.,"GUASAVE, SIN.",1,0,1,0,0,0,
28-oct-17,B.C.,"TIJUANA, B.C.",0,1,1,0,0,0,
28-oct-17,B.C.,"ENSENADA, B.C.",0,1,1,0,0,0,
28-oct-17,B.C.,"TIJUANA, B.C.",0,1,1,0,0,0,
28-oct-17,B.C.,"TIJUANA, B.C.",0,1,1,0,0,0,
30-oct-17,D.F.,"ALVARO OBREGON, D.F.",1,0,1,0,0,0,
30-oct-17,B.C.,"MEXICALI, B.C.",0,1,1,0,0,0,
31-oct-17,B.C.,"TIJUANA, B.C.",0,1,1,0,0,0,
31-oct-17,B.C.,"ENSENADA, B.C.",1,0,1,0,0,0,
31-oct-17,DGO.,"GOMEZ PALACIO, DGO.",1,0,1,0,0,0,
31-oct-17,DGO.,"DGO., DGO.",0,1,1,0,0,0,
01-nov-17,SON.,"ALAMOS, SON.",1,0,1,0,0,0,
02-nov-17,SON.,"HERMOSILLO, SON.",0,1,1,0,0,0,
03-nov-17,DGO.,"GOMEZ PALACIO, DGO.",1,0,1,0,0,0,
06-nov-17,SON.,"HERMOSILLO, SON.",0,1,1,0,0,0,
07-nov-17,S.L.P.,"CIUDAD VALLES, S.L.P.",1,0,1,0,0,0,
08-nov-17,SON.,"HERMOSILLO, SON.",0,1,1,0,0,0,
08-nov-17,DGO.,"GOMEZ PALACIO, DGO.",1,0,1,0,0,0,
08-nov-17,ZAC.,"ZAC., ZAC.",1,0,1,1,0,6,
08-nov-17,ZAC.,"GUADALUPE, ZAC.",1,0,1,3,0,640,
09-nov-17,DGO.,"DGO., DGO.",0,1,1,0,0,0,
10-nov-17,SON.,"HERMOSILLO, SON.",1,0,1,0,0,0,
11-nov-17,COAH.,"ACUÑA, COAH.",1,0,1,1,0,0,
11-nov-17,N.L.,"GRAL. ESCOBEDO, N.L.",1,0,1,0,0,0,
13-nov-17,SIN.,"MAZATLAN, SIN.",1,0,1,0,0,0,
13-nov-17,S.L.P.,"SAN LUIS POTOSI, S.L.P.",1,0,1,0,0,58,
14-nov-17,CHIH.,"NUEVO CASAS GRANDES, CHIH.",0,1,1,0,4,355,
14-nov-17,B.C.,"MEXICALI, B.C.",0,1,1,0,1,0,
14-nov-17,ZAC.,"GUADALUPE, ZAC.",1,0,1,4,0,50,
14-nov-17,ZAC.,"FRESNILLO, ZAC.",1,0,1,0,0,0,
14-nov-17,D.F.,"COYOACAN, D.F.",1,0,1,0,1,0,
14-nov-17,B.C.,"MEXICALI, B.C.",1,0,1,0,1,0,
15-nov-17,S.L.P.,"SAN LUIS POTOSI, S.L.P.",0,1,1,0,0,0,
15-nov-17,B.C.,"TIJUANA, B.C.",1,0,1,0,1,0,
15-nov-17,ZAC.,"FRESNILLO, ZAC.",1,0,1,15,0,194,
16-nov-17,D.F.,"COYOACAN, D.F.",1,0,1,0,0,50,
16-nov-17,CHIH.,"NUEVO CASAS GRANDES, CHIH.",1,0,1,0,0,0,
16-nov-17,ZAC.,"ZAC., ZAC.",1,0,1,1,0,0,
16-nov-17,S.L.P.,"SAN LUIS POTOSI, S.L.P.",1,0,1,1,0,0,
17-nov-17,B.C.,"TIJUANA, B.C.",1,0,1,0,0,0,
17-nov-17,SON.,"YECORA, SON.",1,0,1,0,0,0,
17-nov-17,S.L.P.,"SAN LUIS POTOSI, S.L.P.",1,0,1,0,0,0,
17-nov-17,N.L.,"MONTERREY, N.L.",1,0,1,7,0,350,
17-nov-17,D.F.,"COYOACAN, D.F.",1,0,1,0,0,0,
19-nov-17,TAMPS.,"MATAMOROS, TAMPS.",1,0,1,0,0,0,
20-nov-17,B.C.S.,"MULEGÉ, B.C.S.",1,0,1,1,0,25,
20-nov-17,B.C.,"MEXICALI, B.C.",1,0,1,0,0,0,
21-nov-17,B.C.,"TIJUANA, B.C.",1,0,1,0,0,0,
21-nov-17,S.L.P.,"SAN LUIS POTOSI, S.L.P.",1,0,1,0,1,0,
21-nov-17,Q. ROO,"COZUMEL, Q. ROO",1,0,1,0,0,0,
22-nov-17,GRO.,"COYUCA DE BENITEZ, GRO.",0,1,1,0,0,0,
22-nov-17,N.L.,"MONTERREY, N.L.",0,1,1,0,0,430,
23-nov-17,SIN.,"MAZATLAN, SIN.",1,0,1,0,0,0,
24-nov-17,DGO.,"DGO., DGO.",0,1,1,0,0,0,
24-nov-17,Q. ROO,"COZUMEL, Q. ROO",1,0,1,0,0,1531,
24-nov-17,GRO.,"COYUCA DE BENITEZ, GRO.",1,0,1,0,0,0,
25-nov-17,B.C.,"TIJUANA, B.C.",1,0,1,0,0,0,
25-nov-17,S.L.P.,"SAN LUIS POTOSI, S.L.P.",1,0,1,4,9,0,
27-nov-17,S.L.P.,"SAN LUIS POTOSI, S.L.P.",1,0,1,2,0,0,
28-nov-17,B.C.,"TIJUANA, B.C.",1,0,1,0,0,0,
28-nov-17,B.C.,"ENSENADA, B.C.",0,1,1,0,0,0,
29-nov-17,S.L.P.,"SAN LUIS POTOSI, S.L.P.",1,0,1,0,0,0,
29-nov-17,ZAC.,"FRESNILLO, ZAC.",1,0,1,2,0,8,
30-nov-17,GRO.,"CHILPANCINGO DE LOS BRAVO, GRO.",1,0,1,1,0,0,
30-nov-17,B.C.,"TIJUANA, B.C.",0,1,1,0,0,0,
30-nov-17,SIN.,"MAZATLAN, SIN.",0,1,1,0,0,0,
30-nov-17,Q. ROO,"COZUMEL, Q. ROO",1,0,1,1,0,964,
01-dic-17,DGO.,"GOMEZ PALACIO, DGO.",1,0,1,0,0,0,
01-dic-17,COAH.,"ACUÑA, COAH.",1,0,1,0,0,60,
02-dic-17,COAH.,"ACUÑA, COAH.",1,0,1,2,0,60,
03-dic-17,GTO.,"CELAYA, GTO.",0,1,1,0,0,0,
04-dic-17,GRO.,"ATOYAC DE ALVAREZ, GRO.",1,0,1,1,0,0,
05-dic-17,ZAC.,"GUADALUPE, ZAC.",1,0,1,0,0,0,
05-dic-17,ZAC.,"FRESNILLO, ZAC.",1,0,1,0,0,301,
05-dic-17,COAH.,"MÚZQUIZ, COAH.",0,1,1,0,0,0,
06-dic-17,ZAC.,"ZAC., ZAC.",1,0,1,0,0,112,
06-dic-17,S.L.P.,"SAN LUIS POTOSI, S.L.P.",1,0,1,0,0,0,
06-dic-17,DGO.,"DGO., DGO.",0,1,1,0,0,0,
06-dic-17,COAH.,"ACUÑA, COAH.",1,0,1,0,0,0,
06-dic-17,GTO.,"CELAYA, GTO.",0,1,1,0,0,0,
07-dic-17,ZAC.,"GUADALUPE, ZAC.",1,0,1,17,1,578,
07-dic-17,DGO.,"DGO., DGO.",1,0,1,6,0,0,
08-dic-17,B.C.,"ENSENADA, B.C.",1,0,1,0,0,0,
08-dic-17,ZAC.,"ZAC., ZAC.",1,0,1,0,0,0,
11-dic-17,S.L.P.,"CIUDAD VALLES, S.L.P.",1,0,1,0,0,0,
11-dic-17,DGO.,"DGO., DGO.",1,0,1,0,0,0,
11-dic-17,B.C.,"TIJUANA, B.C.",1,0,1,0,0,0,
11-dic-17,N.L.,"APODACA, N.L.",1,0,1,0,0,0,
11-dic-17,PUE.,"SAN MARTIN TEXMELUCAN, PUE.",1,0,1,0,0,0,
12-dic-17,B.C.,"TIJUANA, B.C.",1,0,1,0,0,0,
13-dic-17,S.L.P.,"SAN LUIS POTOSI, S.L.P.",1,0,1,25,0,0,
13-dic-17,GRO.,"SAN MIGUEL TOTOLAPAN, GRO.",0,1,1,0,0,0,
14-dic-17,B.C.,"MEXICALI, B.C.",0,1,1,0,0,0,
14-dic-17,N.L.,"APODACA, N.L.",1,0,1,0,0,0,
14-dic-17,PUE.,"SAN MARTIN TEXMELUCAN, PUE.",1,0,1,0,0,90,
15-dic-17,B.C.,"MEXICALI, B.C.",1,0,1,0,0,0,
15-dic-17,N.L.,"APODACA, N.L.",1,0,1,1,0,0,
15-dic-17,S.L.P.,"SAN LUIS POTOSI, S.L.P.",1,0,1,0,0,0,
15-dic-17,DGO.,"DGO., DGO.",1,0,1,0,0,0,
16-dic-17,DGO.,"SANTIAGO PAPASQUIARO, DGO.",1,0,1,0,0,0,
17-dic-17,DGO.,"DGO., DGO.",0,1,1,0,0,0,
18-dic-17,B.C.,"MEXICALI, B.C.",0,1,1,0,0,0,
18-dic-17,GRO.,"COYUCA DE BENITEZ, GRO.",1,0,1,0,0,23,
19-dic-17,B.C.,"MEXICALI, B.C.",0,1,1,0,0,0,
19-dic-17,COAH.,"ACUÑA, COAH.",0,1,1,0,0,0,
20-dic-17,B.C.,"TIJUANA, B.C.",0,1,1,0,0,0,
20-dic-17,B.C.,"TIJUANA, B.C.",1,0,1,0,0,0,
21-dic-17,B.C.,"MEXICALI, B.C.",0,1,1,0,0,0,
22-dic-17,TAMPS.,"MATAMOROS, TAMPS.",1,0,1,6,0,24,
24-dic-17,DGO.,"DGO., DGO.",1,0,1,0,0,0,
26-dic-17,B.C.,"MEXICALI, B.C.",0,1,1,0,0,0,
27-dic-17,GRO.,"ATOYAC DE ALVAREZ, GRO.",1,0,1,1,0,1,
27-dic-17,B.C.,"MEXICALI, B.C.",1,0,1,0,0,0,
28-dic-17,DGO.,"DGO., DGO.",1,0,1,1,0,0,
29-dic-17,DGO.,"DGO., DGO.",0,1,1,0,0,0,
02-ene-18,DGO.,"DGO., DGO.",1,0,1,0,1,0,
06-ene-18,GRO.,"ATOYAC DE ALVAREZ, GRO.",0,1,1,1,0,8,
08-ene-18,B.C.,"MEXICALI, B.C.",0,1,1,0,0,0,
09-ene-18,COAH.,"MÚZQUIZ, COAH.",0,1,1,0,1,0,
09-ene-18,COAH.,"ACUÑA, COAH.",0,1,1,0,0,0,
10-ene-18,COAH.,"FRANCISCO I. MADERO, COAH.",1,0,1,1,0,0,
10-ene-18,COAH.,"RAMOS ARIZPE, COAH.",1,0,1,0,0,0,
10-ene-18,COAH.,"PIEDRAS NEGRAS, COAH.",0,1,1,0,0,0,
10-ene-18,COAH.,"ACUÑA, COAH.",1,0,1,0,0,0,
11-ene-18,COAH.,"FRANCISCO I. MADERO, COAH.",1,0,1,1,0,0,
11-ene-18,COAH.,"MONCLOVA, COAH.",0,1,1,0,0,0,
11-ene-18,DGO.,"DGO., DGO.",0,1,1,0,0,0,
12-ene-18,B.C.,"ENSENADA, B.C.",0,1,1,0,0,0,
13-ene-18,B.C.,"TIJUANA, B.C.",1,0,1,0,0,0,
13-ene-18,GRO.,"ATOYAC DE ALVAREZ, GRO.",1,0,1,7,0,0,
13-ene-18,COAH.,"SABINAS, COAH.",0,1,1,5,1,0,
13-ene-18,TAB.,"CENTRO, TAB.",1,0,1,0,0,0,
15-ene-18,COAH.,"RAMOS ARIZPE, COAH.",1,0,1,0,0,50,
15-ene-18,COAH.,"MÚZQUIZ, COAH.",0,1,1,0,0,0,
16-ene-18,COAH.,"SALTILLO, COAH.",0,1,1,0,0,0,
16-ene-18,COAH.,"PIEDRAS NEGRAS, COAH.",0,1,1,0,0,198,
17-ene-18,B.C.,"TIJUANA, B.C.",0,1,1,0,0,0,
17-ene-18,COAH.,"PIEDRAS NEGRAS, COAH.",1,0,1,0,0,106,
18-ene-18,B.C.,"TIJUANA, B.C.",0,1,1,0,0,0,
18-ene-18,COAH.,"FRANCISCO I. MADERO, COAH.",0,1,1,0,0,0,
18-ene-18,COAH.,"PIEDRAS NEGRAS, COAH.",1,0,1,0,1,30,
19-ene-18,COAH.,"PIEDRAS NEGRAS, COAH.",0,1,1,0,0,60,
20-ene-18,TAMPS.,"MATAMOROS, TAMPS.",0,1,1,1,0,26,
20-ene-18,COAH.,"SAN PEDRO, COAH.",1,0,1,0,0,0,
20-ene-18,COAH.,"SABINAS, COAH.",1,0,1,0,1,0,
22-ene-18,B.C.,"ENSENADA, B.C.",0,1,1,0,0,0,
22-ene-18,DGO.,"DGO., DGO.",1,0,1,0,0,0,
22-ene-18,COAH.,"SAN PEDRO, COAH.",1,0,1,0,0,0,
22-ene-18,COAH.,"RAMOS ARIZPE, COAH.",1,0,1,0,0,44,
22-ene-18,COAH.,"PIEDRAS NEGRAS, COAH.",1,0,1,0,0,0,
22-ene-18,GTO.,"IRAPUATO, GTO.",1,0,1,0,0,0,
23-ene-18,COAH.,"PIEDRAS NEGRAS, COAH.",1,0,1,0,0,750,
23-ene-18,B.C.,"ENSENADA, B.C.",1,0,1,0,0,0,
24-ene-18,B.C.,"ENSENADA, B.C.",1,0,1,0,0,0,
24-ene-18,COAH.,"TORREÓN, COAH.",1,0,1,0,0,0,
24-ene-18,VER.,"PUEBLO VIEJO, VER.",1,0,1,0,0,0,
24-ene-18,COAH.,"MÚZQUIZ, COAH.",0,1,1,0,0,0,
25-ene-18,COAH.,"FRANCISCO I. MADERO, COAH.",1,0,1,0,0,45,
25-ene-18,COAH.,"SALTILLO, COAH.",1,0,1,1,0,79,
26-ene-18,COAH.,"MATAMOROS, COAH.",1,0,1,0,0,0,
26-ene-18,COAH.,"SALTILLO, COAH.",1,0,1,0,0,36,
26-ene-18,COAH.,"ACUÑA, COAH.",0,1,1,0,0,0,
26-ene-18,VER.,"PUEBLO VIEJO, VER.",1,0,1,0,0,0,
29-ene-18,DGO.,"DGO., DGO.",0,1,1,1,0,0,
29-ene-18,COAH.,"FRANCISCO I. MADERO, COAH.",1,0,1,0,0,0,
29-ene-18,COAH.,"SALTILLO, COAH.",1,0,1,0,0,29,
29-ene-18,COAH.,"RAMOS ARIZPE, COAH.",1,0,1,1,0,25,
29-ene-18,COAH.,"ACUÑA, COAH.",0,1,1,2,2,130,
30-ene-18,ZAC.,"FRESNILLO, ZAC.",0,1,1,58,0,220,
31-ene-18,COAH.,"MÚZQUIZ, COAH.",0,1,1,0,0,0,
31-ene-18,ZAC.,"FRESNILLO, ZAC.",1,0,1,57,0,140,
01-feb-18,COAH.,"FRANCISCO I. MADERO, COAH.",1,0,1,0,0,0,
01-feb-18,COAH.,"SALTILLO, COAH.",1,0,1,0,0,223,
01-feb-18,COAH.,"MONCLOVA, COAH.",1,0,1,0,0,0,
01-feb-18,COAH.,"ACUÑA, COAH.",1,0,1,0,0,0,
02-feb-18,COAH.,"MONCLOVA, COAH.",1,0,1,0,0,0,
02-feb-18,ZAC.,"ZAC., ZAC.",1,0,1,4,0,18,
03-feb-18,DGO.,"GOMEZ PALACIO, DGO.",1,0,1,0,0,0,
04-feb-18,CHIS.,"BENEMÉRITO DE LAS AMÉRICAS, CHIS.",1,0,1,0,0,0,
05-feb-18,TAMPS.,"REYNOSA, TAMPS.",1,0,1,1,0,61,
06-feb-18,COAH.,"FRANCISCO I. MADERO, COAH.",0,1,1,0,0,0,
06-feb-18,COAH.,"PIEDRAS NEGRAS, COAH.",0,1,1,1,0,0,
06-feb-18,DGO.,"GOMEZ PALACIO, DGO.",1,0,1,0,0,0,
07-feb-18,COL.,"COL., COL.",1,0,1,0,0,0,
08-feb-18,COAH.,"SAN PEDRO, COAH.",0,1,1,0,0,0,
08-feb-18,COAH.,"ACUÑA, COAH.",1,0,1,0,0,0,
09-feb-18,COAH.,"FRANCISCO I. MADERO, COAH.",1,0,1,0,0,0,
09-feb-18,COAH.,"PIEDRAS NEGRAS, COAH.",1,0,1,0,0,0,
09-feb-18,COAH.,"SABINAS, COAH.",1,0,1,0,0,81,
12-feb-18,DGO.,"DGO., DGO.",0,1,1,0,0,0,
12-feb-18,SIN.,"CULIACAN, SIN.",0,1,1,0,0,0,
12-feb-18,COAH.,"ACUÑA, COAH.",1,0,1,0,0,0,
13-feb-18,COAH.,"TORREÓN, COAH.",1,0,1,1,0,0,
13-feb-18,COAH.,"SAN PEDRO, COAH.",1,0,1,2,0,0,
14-feb-18,COAH.,"FRANCISCO I. MADERO, COAH.",1,0,1,1,0,0,
14-feb-18,COAH.,"SABINAS, COAH.",0,1,1,0,1,0,
14-feb-18,DGO.,"GOMEZ PALACIO, DGO.",1,0,1,0,0,0,
14-feb-18,GRO.,"COYUCA DE CATALAN, GRO.",1,0,1,0,0,0,
14-feb-18,COAH.,"SAN PEDRO, COAH.",0,1,1,0,0,0,
16-feb-18,SIN.,"CULIACAN, SIN.",1,0,1,0,0,0,
16-feb-18,COAH.,"FRANCISCO I. MADERO, COAH.",1,0,1,0,0,40,
16-feb-18,COAH.,"ACUÑA, COAH.",1,0,1,0,0,9,
16-feb-18,TAMPS.,"NUEVO LAREDO, TAMPS.",1,0,1,2,0,563,
17-feb-18,TAB.,"CENTRO, TAB.",1,0,1,1,0,5,
17-feb-18,TAMPS.,"MATAMOROS, TAMPS.",1,0,1,0,0,102,
17-feb-18,TAMPS.,"NUEVO LAREDO, TAMPS.",1,0,1,2,0,563,
19-feb-18,COAH.,"SAN PEDRO, COAH.",1,0,1,0,0,0,
19-feb-18,Q. ROO,"COZUMEL, Q. ROO",1,0,1,0,0,675,
20-feb-18,COAH.,"ACUÑA, COAH.",1,0,1,0,0,0,
21-feb-18,COAH.,"MÚZQUIZ, COAH.",0,1,1,0,0,0,
21-feb-18,DGO.,"GOMEZ PALACIO, DGO.",1,0,1,0,0,0,
22-feb-18,SIN.,"CULIACAN, SIN.",1,0,1,0,0,0,
22-feb-18,COAH.,"SAN PEDRO, COAH.",0,1,1,0,0,0,
22-feb-18,COAH.,"ACUÑA, COAH.",0,1,1,0,0,0,
23-feb-18,COAH.,"SAN PEDRO, COAH.",1,0,1,0,0,0,
23-feb-18,DGO.,"GOMEZ PALACIO, DGO.",1,0,1,0,0,0,
26-feb-18,SIN.,"CULIACAN, SIN.",1,0,1,0,0,0,
26-feb-18,COAH.,"PIEDRAS NEGRAS, COAH.",0,1,1,0,0,50,
26-feb-18,COAH.,"ACUÑA, COAH.",0,1,1,0,0,0,
27-feb-18,COAH.,"SAN PEDRO, COAH.",0,1,1,0,0,0,
27-feb-18,SIN.,"CULIACAN, SIN.",0,1,1,0,0,0,
27-feb-18,COAH.,"PIEDRAS NEGRAS, COAH.",1,0,1,0,3,154,
28-feb-18,S.L.P.,"CIUDAD VALLES, S.L.P.",1,0,1,1,0,0,
01-mar-18,S.L.P.,"SAN LUIS POTOSI, S.L.P.",1,0,1,0,0,0,
01-mar-18,COAH.,"SALTILLO, COAH.",1,0,1,1,0,510,
02-mar-18,S.L.P.,"SAN LUIS POTOSI, S.L.P.",1,0,1,1,0,0,
05-mar-18,VER.,"TIERRA BLANCA, VER.",1,0,1,0,0,0,
06-mar-18,COAH.,"SALTILLO, COAH.",0,1,1,0,0,172,
07-mar-18,COAH.,"RAMOS ARIZPE, COAH.",1,0,1,1,0,108,
07-mar-18,COAH.,"ACUÑA, COAH.",1,0,1,0,0,0,
07-mar-18,VER.,"TIERRA BLANCA, VER.",1,0,1,0,0,0,
07-mar-18,DGO.,"LERDO, DGO.",0,1,1,0,0,120,
08-mar-18,COAH.,"MATAMOROS, COAH.",1,0,1,0,0,0,
08-mar-18,VER.,"VEGA DE ALATORRE, VER.",1,0,1,0,0,0,
08-mar-18,COAH.,"MATAMOROS, COAH.",1,0,1,0,0,0,
09-mar-18,COAH.,"SAN PEDRO, COAH.",1,0,1,0,0,0,
09-mar-18,DGO.,"GOMEZ PALACIO, DGO.",0,1,1,0,0,0,
10-mar-18,DGO.,"LERDO, DGO.",1,0,1,0,0,0,
12-mar-18,COAH.,"RAMOS ARIZPE, COAH.",1,0,1,6,0,20,
12-mar-18,VER.,"VEGA DE ALATORRE, VER.",1,0,1,0,0,0,
13-mar-18,COAH.,"RAMOS ARIZPE, COAH.",1,0,1,0,0,0,
14-mar-18,S.L.P.,"SAN LUIS POTOSI, S.L.P.",1,0,1,3,0,0,
14-mar-18,COAH.,"SALTILLO, COAH.",0,1,1,0,0,180,
14-mar-18,ZAC.,"FRESNILLO, ZAC.",1,0,1,0,0,8,
15-mar-18,SIN.,"MAZATLAN, SIN.",1,0,1,0,0,0,
15-mar-18,DGO.,"GOMEZ PALACIO, DGO.",0,1,1,0,0,0,
15-mar-18,DGO.,"LERDO, DGO.",0,1,1,0,0,0,
15-mar-18,S.L.P.,"SAN LUIS POTOSI, S.L.P.",1,0,1,3,0,0,
15-mar-18,ZAC.,"ZAC., ZAC.",1,0,1,0,0,0,
15-mar-18,GRO.,"BENITO JUAREZ, GRO.",0,1,1,1,0,3,
15-mar-18,S.L.P.,"CIUDAD VALLES, S.L.P.",1,0,1,0,0,0,
16-mar-18,TAB.,"HUIMANGUILLO, TAB.",0,1,1,0,0,0,
17-mar-18,COAH.,"SABINAS, COAH.",0,1,1,0,0,57,
17-mar-18,S.L.P.,"SAN LUIS POTOSI, S.L.P.",1,0,1,0,0,0,
18-mar-18,S.L.P.,"SAN LUIS POTOSI, S.L.P.",0,1,1,0,0,0,
19-mar-18,S.L.P.,"SAN LUIS POTOSI, S.L.P.",0,1,1,0,0,0,
20-mar-18,S.L.P.,"SAN LUIS POTOSI, S.L.P.",1,0,1,6,4,0,
20-mar-18,DGO.,"GOMEZ PALACIO, DGO.",1,0,1,0,0,0,
20-mar-18,COAH.,"ACUÑA, COAH.",1,0,1,0,0,0,
20-mar-18,ZAC.,"GUADALUPE, ZAC.",1,0,1,0,0,0,
21-mar-18,VER.,"RIO BLANCO, VER.",1,0,1,1,0,117,
21-mar-18,COAH.,"RAMOS ARIZPE, COAH.",1,0,1,0,0,0,
21-mar-18,COAH.,"PIEDRAS NEGRAS, COAH.",0,1,1,0,0,0,
23-mar-18,COAH.,"RAMOS ARIZPE, COAH.",1,0,1,0,0,0,
23-mar-18,S.L.P.,"SAN LUIS POTOSI, S.L.P.",1,0,1,0,0,0,
23-mar-18,VER.,"VER., VER.",1,0,1,0,0,0,
23-mar-18,DGO.,"LERDO, DGO.",1,0,1,0,0,0,
24-mar-18,COAH.,"SABINAS, COAH.",0,1,1,0,1,0,
24-mar-18,TAMPS.,"MATAMOROS, TAMPS.",0,1,1,0,0,53,
25-mar-18,TAMPS.,"MATAMOROS, TAMPS.",1,0,1,1,0,0,
26-mar-18,GRO.,"PETATLAN, GRO.",1,0,1,1,0,4,
27-mar-18,VER.,"MARTINEZ DE LA TORRE, VER.",1,0,1,1,0,7,
27-mar-18,DGO.,"GOMEZ PALACIO, DGO.",1,0,1,0,0,0,
27-mar-18,S.L.P.,"SAN LUIS POTOSI, S.L.P.",1,0,1,4,0,0,
27-mar-18,QRO.,"QUERETARO, QRO.",0,1,1,0,0,0,
28-mar-18,S.L.P.,"SAN LUIS POTOSI, S.L.P.",1,0,1,0,2,0,
31-mar-18,S.L.P.,"CIUDAD VALLES, S.L.P.",1,0,1,0,0,0,
31-mar-18,GRO.,"PETATLAN, GRO.",0,1,1,0,0,0,
06-jul-18,N.L.,"APODACA, N.L.",0,1,1,7,0,56,
06-jul-18,COL.,"COL., COL.",1,0,1,0,0,28,
09-jul-18,N.L.,"MONTERREY, N.L.",1,0,1,25,0,1697,
09-jul-18,GRO.,"PUNGARABATO, GRO.",1,0,1,1,0,0,
10-jul-18,B.C.,"ENSENADA, B.C.",1,0,1,0,0,5,
11-jul-18,B.C.,"ENSENADA, B.C.",1,0,1,0,0,5,
11-jul-18,N.L.,"MONTERREY, N.L.",1,0,1,25,0,100,
13-jul-18,N.L.,"SALINAS VICTORIA, N.L.",0,1,1,0,0,0,
14-jul-18,CHIS.,"PALENQUE, CHIS.",0,1,1,0,0,0,
17-jul-18,N.L.,"SALINAS VICTORIA, N.L.",0,1,1,0,0,0,
17-jul-18,ZAC.,"GUADALUPE, ZAC.",1,0,1,5,0,185,
18-jul-18,B.C.,"TIJUANA, B.C.",1,0,1,0,0,0,
18-jul-18,N.L.,"APODACA, N.L.",1,0,1,0,0,0,
18-jul-18,GTO.,"IRAPUATO, GTO.",1,0,1,0,7,0,
19-jul-18,B.C.,"TIJUANA, B.C.",1,0,1,0,0,0,
21-jul-18,GRO.,"COYUCA DE CATALAN, GRO.",1,0,1,0,0,0,
22-jul-18,TAB.,"BALANCAN, TAB.",0,1,1,0,0,0,
23-jul-18,N.L.,"SALINAS VICTORIA, N.L.",1,0,1,1,0,0,
23-jul-18,TAB.,"PARAISO, TAB.",1,0,1,1,0,0,
24-jul-18,B.C.,"ENSENADA, B.C.",1,0,1,0,0,0,
24-jul-18,TLAX.,"PANOTLA, TLAX.",1,0,1,0,0,0,
25-jul-18,B.C.,"ENSENADA, B.C.",0,1,1,0,0,0,
25-jul-18,N.L.,"APODACA, N.L.",1,0,1,0,0,0,
26-jul-18,N.L.,"APODACA, N.L.",1,0,1,0,0,0,
26-jul-18,SIN.,"NAVOLATO, SIN.",0,1,1,0,0,0,
26-jul-18,DGO.,"GOMEZ PALACIO, DGO.",1,0,1,0,0,0,
27-jul-18,PUE.,"PUE., PUE.",1,0,1,0,0,0,
28-jul-18,TLAX.,"TLAX., TLAX.",1,0,1,0,0,0,
28-jul-18,TAB.,"BALANCAN, TAB.",0,1,1,0,0,0,
30-jul-18,SIN.,"NAVOLATO, SIN.",1,0,1,0,0,0,
30-jul-18,N.L.,"APODACA, N.L.",1,0,1,0,0,100,
31-jul-18,D.F.,"GUSTAVO A. MADERO, D.F.",1,0,1,0,0,21,
31-jul-18,TAB.,"CENTRO, TAB.",1,0,1,0,0,0,
01-ago-18,GTO.,"IRAPUATO, GTO.",1,0,1,0,12,0,
02-ago-18,GTO.,"VILLAGRAN, GTO.",0,1,1,0,0,0,
02-ago-18,GTO.,"CELAYA, GTO.",1,0,1,0,0,0,
02-ago-18,B.C.,"TIJUANA, B.C.",1,0,1,0,1,0,
04-ago-18,N.L.,"APODACA, N.L.",0,1,1,1,0,0,
04-ago-18,TAMPS.,"NUEVO LAREDO, TAMPS.",0,1,1,0,0,119,
04-ago-18,DGO.,"GOMEZ PALACIO, DGO.",1,0,1,2,0,0,
04-ago-18,TLAX.,"APIZACO, TLAX.",1,0,1,0,0,0,
04-ago-18,TLAX.,"PANOTLA, TLAX.",1,0,1,0,0,0,
05-ago-18,TAB.,"JONUTA, TAB.",1,0,1,0,0,0,
06-ago-18,N.L.,"APODACA, N.L.",0,1,1,0,0,0,
06-ago-18,DGO.,"GOMEZ PALACIO, DGO.",0,1,1,0,0,0,
06-ago-18,B.C.,"MEXICALI, B.C.",0,1,1,0,0,0,
07-ago-18,DGO.,"DGO., DGO.",1,0,1,0,0,0,
07-ago-18,QRO.,"QUERETARO, QRO.",1,0,1,1,0,0,
07-ago-18,TAB.,"COMALCALCO, TAB.",1,0,1,1,0,0,
07-ago-18,TLAX.,"HUAMANTLA, TLAX.",1,0,1,0,0,0,
07-ago-18,TLAX.,"EL CARMEN TEQUEXQUITLA, TLAX.",0,1,1,0,0,0,
07-ago-18,TAMPS.,"NUEVO LAREDO, TAMPS.",1,0,1,0,0,4,
07-ago-18,TAMPS.,"MIER, TAMPS.",0,1,1,0,0,0,
07-ago-18,TAMPS.,"ALTAMIRA, TAMPS.",1,0,1,0,0,29,
08-ago-18,GTO.,"IRAPUATO, GTO.",0,1,1,0,5,34,
08-ago-18,MEX.,"ATLACOMULCO, MEX.",1,0,1,1,0,399,
08-ago-18,TAB.,"COMALCALCO, TAB.",1,0,1,1,0,0,
08-ago-18,MEX.,"ZUMPANGO, MEX.",1,0,1,0,7,17,
08-ago-18,TAMPS.,"NUEVO LAREDO, TAMPS.",0,1,1,0,0,4,
08-ago-18,TAMPS.,"TAMPICO, TAMPS.",1,0,1,0,0,0,
09-ago-18,N.L.,"APODACA, N.L.",1,0,1,0,0,0,
09-ago-18,DGO.,"DGO., DGO.",1,0,1,0,0,0,
09-ago-18,TAMPS.,"TAMPICO, TAMPS.",1,0,1,0,0,0,
09-ago-18,MEX.,"ATLACOMULCO, MEX.",1,0,1,0,0,28,
10-ago-18,COAH.,"SALTILLO, COAH.",1,0,1,0,0,0,
10-ago-18,COAH.,"ACUÑA, COAH.",1,0,1,0,0,0,
10-ago-18,TAMPS.,"NUEVO LAREDO, TAMPS.",0,1,1,0,0,44,
10-ago-18,QRO.,"ARROYO SECO, QRO.",1,0,1,0,0,0,
10-ago-18,TAB.,"COMALCALCO, TAB.",1,0,1,0,0,0,
10-ago-18,TLAX.,"HUAMANTLA, TLAX.",1,0,1,0,0,0,
10-ago-18,B.C.,"TIJUANA, B.C.",0,1,1,0,0,0,
10-ago-18,B.C.,"ENSENADA, B.C.",1,0,1,0,1,0,
10-ago-18,COAH.,"PIEDRAS NEGRAS, COAH.",1,0,1,2,0,0,
11-ago-18,CHIS.,"BENEMÉRITO DE LAS AMÉRICAS, CHIS.",1,0,1,0,0,0,
11-ago-18,TAMPS.,"TAMPICO, TAMPS.",1,0,1,0,1,0,
12-ago-18,QRO.,"PINAL DE AMOLES, QRO.",1,0,1,1,0,0,
12-ago-18,CHIS.,"BENEMÉRITO DE LAS AMÉRICAS, CHIS.",1,0,1,0,0,0,
12-ago-18,CHIS.,"PALENQUE, CHIS.",1,0,1,0,0,0,
12-ago-18,TAB.,"TENOSIQUE, TAB.",1,0,1,0,0,0,
13-ago-18,B.C.,"TIJUANA, B.C.",0,1,1,0,0,0,
13-ago-18,COAH.,"SALTILLO, COAH.",1,0,1,0,0,27,
13-ago-18,COAH.,"NUEVA ROSITA, COAH.",0,1,1,5,0,0,
13-ago-18,COAH.,"ACUÑA, COAH.",1,0,1,1,0,0,
13-ago-18,TLAX.,"CALPULALPAN, TLAX.",0,1,1,1,0,0,
13-ago-18,GRO.,"ZIHUATANEJO DE AZUETA, GRO.",0,1,1,0,0,0,
13-ago-18,TLAX.,"IXTACUIXTLA DE MARIANO MATAMOROS, TLAX.",0,1,1,0,0,0,
13-ago-18,MEX.,"CUAUTITLAN IZCALLI, MEX.",1,0,1,0,0,0,
14-ago-18,SIN.,"CHOIX, SIN.",1,0,1,0,0,0,
14-ago-18,TAMPS.,"EL MANTE, TAMPS.",1,0,1,0,0,0,
14-ago-18,COAH.,"PIEDRAS NEGRAS, COAH.",0,1,1,3,0,0,
14-ago-18,COAH.,"NUEVA ROSITA, COAH.",1,0,1,0,0,95,
14-ago-18,COAH.,"SALTILLO, COAH.",0,1,1,0,1,0,
14-ago-18,GTO.,"IRAPUATO, GTO.",1,0,1,0,0,0,
14-ago-18,GTO.,"CELAYA, GTO.",1,0,1,0,0,0,
14-ago-18,MEX.,"CUAUTITLAN IZCALLI, MEX.",1,0,1,0,0,0,
15-ago-18,COAH.,"NUEVA ROSITA, COAH.",1,0,1,0,0,33,
15-ago-18,N.L.,"APODACA, N.L.",0,1,1,0,0,0,
15-ago-18,SIN.,"NAVOLATO, SIN.",1,0,1,0,0,0,
15-ago-18,MEX.,"SAN MATEO ATENCO, MEX.",1,0,1,0,0,0,
15-ago-18,TLAX.,"IXTACUIXTLA DE MARIANO MATAMOROS, TLAX.",1,0,1,0,0,0,
15-ago-18,CHIS.,"TAPACHULA, CHIS.",0,1,1,0,0,0,
16-ago-18,B.C.,"ENSENADA, B.C.",0,1,1,0,1,0,
16-ago-18,COAH.,"TORREÓN, COAH.",1,0,1,0,0,0,
16-ago-18,TAMPS.,"TAMPICO, TAMPS.",1,0,1,0,0,29,
16-ago-18,SIN.,"NAVOLATO, SIN.",1,0,1,0,0,0,
16-ago-18,TLAX.,"IXTACUIXTLA DE MARIANO MATAMOROS, TLAX.",0,1,1,0,0,0,
16-ago-18,GRO.,"ZIHUATANEJO DE AZUETA, GRO.",1,0,1,0,0,20,
16-ago-18,TAMPS.,"VICTORIA, TAMPS.",1,0,1,3,5,0,
17-ago-18,B.C.,"ENSENADA, B.C.",1,0,1,0,0,0,
17-ago-18,COAH.,"SAN PEDRO, COAH.",0,1,1,1,0,6,
17-ago-18,COAH.,"SALTILLO, COAH.",0,1,1,36,0,0,
17-ago-18,COAH.,"RAMOS ARIZPE, COAH.",0,1,1,3,1,149,
17-ago-18,COAH.,"MONCLOVA, COAH.",0,1,1,1,0,100,
17-ago-18,N.L.,"LINARES, N.L.",1,0,1,0,0,0,
17-ago-18,MEX.,"SAN MATEO ATENCO, MEX.",1,0,1,0,0,50,
17-ago-18,TLAX.,"CALPULALPAN, TLAX.",1,0,1,0,0,0,
17-ago-18,SIN.,"CHOIX, SIN.",1,0,1,0,0,0,
17-ago-18,TAMPS.,"CAMARGO, TAMPS.",0,1,1,0,0,0,
17-ago-18,GRO.,"ZIHUATANEJO DE AZUETA, GRO.",1,0,1,0,0,0,
17-ago-18,MEX.,"CUAUTITLAN IZCALLI, MEX.",1,0,1,1,1,0,
18-ago-18,MEX.,"CUAUTITLAN IZCALLI, MEX.",1,0,1,0,0,0,
18-ago-18,MEX.,"SAN MATEO ATENCO, MEX.",1,0,1,0,0,2659,
18-ago-18,S.L.P.,"CIUDAD VALLES, S.L.P.",1,0,1,0,0,0,
19-ago-18,TAB.,"BALANCAN, TAB.",0,1,1,0,0,0,
20-ago-18,B.C.,"ENSENADA, B.C.",0,1,1,0,0,0,
20-ago-18,COAH.,"MONCLOVA, COAH.",1,0,1,1,0,0,
20-ago-18,TAMPS.,"GONZALEZ, TAMPS.",1,0,1,0,0,0,
20-ago-18,TAMPS.,"TAMPICO, TAMPS.",1,0,1,0,1,0,
20-ago-18,TAMPS.,"MATAMOROS, TAMPS.",0,1,1,1,0,37,
21-ago-18,TAMPS.,"ALTAMIRA, TAMPS.",1,0,1,0,0,0,
21-ago-18,TAMPS.,"EL MANTE, TAMPS.",1,0,1,0,0,10,
21-ago-18,TAMPS.,"VICTORIA, TAMPS.",1,0,1,1,0,38,
21-ago-18,TAMPS.,"MIER, TAMPS.",0,1,1,0,0,0,
21-ago-18,COAH.,"MATAMOROS, COAH.",1,0,1,0,0,0,
21-ago-18,COAH.,"ACUÑA, COAH.",0,1,1,0,0,0,
21-ago-18,MEX.,"APAXCO, MEX.",1,0,1,0,2,0,
22-ago-18,COAH.,"PIEDRAS NEGRAS, COAH.",1,0,1,0,0,0,
23-ago-18,N.L.,"MELCHOR OCAMPO, N.L.",0,1,1,250,0,0,
23-ago-18,SIN.,"CHOIX, SIN.",1,0,1,0,0,0,
23-ago-18,TAMPS.,"VICTORIA, TAMPS.",1,0,1,0,0,236,
23-ago-18,TAMPS.,"MIER, TAMPS.",0,1,1,0,0,63,
23-ago-18,TAMPS.,"ALTAMIRA, TAMPS.",1,0,1,1,0,17,
23-ago-18,TAMPS.,"CIUDAD MADERO, TAMPS.",1,0,1,1,0,0,
23-ago-18,TAMPS.,"TAMPICO, TAMPS.",1,0,1,0,0,105,
23-ago-18,ZAC.,"GUADALUPE, ZAC.",0,1,1,0,0,48,
23-ago-18,PUE.,"PUE., PUE.",1,0,1,0,1,147,
24-ago-18,COAH.,"SALTILLO, COAH.",0,1,1,58,0,17,
24-ago-18,COAH.,"MÚZQUIZ, COAH.",0,1,1,0,0,0,
24-ago-18,N.L.,"SANTA CATARINA, N.L.",1,0,1,0,0,0,
24-ago-18,TAMPS.,"NUEVO LAREDO, TAMPS.",1,0,1,0,0,0,
24-ago-18,TAMPS.,"MATAMOROS, TAMPS.",1,0,1,5,0,44,
24-ago-18,TAMPS.,"CIUDAD MADERO, TAMPS.",1,0,1,0,0,0,
24-ago-18,TLAX.,"PANOTLA, TLAX.",1,0,1,0,0,0,
24-ago-18,COAH.,"SABINAS, COAH.",1,0,1,4,0,0,
24-ago-18,SIN.,"CHOIX, SIN.",0,1,1,0,0,0,
25-ago-18,N.L.,"MELCHOR OCAMPO, N.L.",1,0,1,5,0,0,
25-ago-18,B.C.S.,"MULEGÉ, B.C.S.",1,0,1,1,0,0,
25-ago-18,MEX.,"APAXCO, MEX.",1,0,1,0,0,0,
27-ago-18,VER.,"TANTOYUCA, VER.",0,1,1,0,0,0,
27-ago-18,TLAX.,"TETLATLAHUCA, TLAX.",1,0,1,0,0,0,
27-ago-18,TLAX.,"SAN PABLO DEL MONTE, TLAX.",1,0,1,0,0,0,
27-ago-18,N.L.,"MELCHOR OCAMPO, N.L.",1,0,1,7,0,0,
28-ago-18,B.C.,"MEXICALI, B.C.",0,1,1,0,0,0,
28-ago-18,COAH.,"TORREÓN, COAH.",0,1,1,0,0,0,
28-ago-18,COAH.,"FRANCISCO I. MADERO, COAH.",0,1,1,0,0,0,
28-ago-18,COAH.,"SALTILLO, COAH.",1,0,1,14,0,0,
28-ago-18,TAMPS.,"TAMPICO, TAMPS.",1,0,1,1,2,0,
28-ago-18,TAMPS.,"MIER, TAMPS.",1,0,1,0,0,81,
29-ago-18,MEX.,"IXTAPAN DE LA SAL, MEX.",1,0,1,1,0,0,
29-ago-18,COAH.,"MONCLOVA, COAH.",1,0,1,0,0,0,
30-ago-18,MEX.,"CHICOLOAPAN, MEX.",1,0,1,0,0,39,
31-ago-18,B.C.,"TIJUANA, B.C.",0,1,1,0,0,0,
31-ago-18,COAH.,"SALTILLO, COAH.",0,1,1,0,0,50,
31-ago-18,COAH.,"RAMOS ARIZPE, COAH.",1,0,1,0,1,0,
31-ago-18,COAH.,"MONCLOVA, COAH.",1,0,1,0,0,70,
31-ago-18,COAH.,"PIEDRAS NEGRAS, COAH.",0,1,1,3,0,300,
31-ago-18,TAMPS.,"MATAMOROS, TAMPS.",1,0,1,0,0,8,
31-ago-18,TAMPS.,"VICTORIA, TAMPS.",0,1,1,0,0,19,
31-ago-18,TAMPS.,"MIER, TAMPS.",0,1,1,0,0,458,
31-ago-18,DGO.,"SANTIAGO PAPASQUIARO, DGO.",0,1,1,0,0,0,
31-ago-18,MEX.,"TLALNEPANTLA DE BAZ, MEX.",1,0,1,0,0,309,
31-ago-18,MOR.,"TEPOZTLAN, MOR.",1,0,1,3,0,107,
01-sep-18,COAH.,"ACUÑA, COAH.",1,0,1,1,0,0,
01-sep-18,MEX.,"IXTAPAN DE LA SAL, MEX.",0,1,1,1,0,55,
01-sep-18,TLAX.,"TETLATLAHUCA, TLAX.",0,1,1,0,0,0,
03-sep-18,COAH.,"MONCLOVA, COAH.",1,0,1,1,0,0,
03-sep-18,MEX.,"TOLUCA, MEX.",0,1,1,0,0,0,
03-sep-18,Q. ROO,"COZUMEL, Q. ROO",1,0,1,0,1,21,
04-sep-18,B.C.,"TIJUANA, B.C.",1,0,1,0,0,0,
04-sep-18,B.C.,"TIJUANA, B.C.",0,1,1,0,0,0,
04-sep-18,AGS.,"AGS., AGS.",1,0,1,0,0,475,
04-sep-18,MEX.,"TOLUCA, MEX.",1,0,1,0,1,2863,
05-sep-18,COAH.,"SALTILLO, COAH.",0,1,1,0,0,0,
05-sep-18,VER.,"VER., VER.",1,0,1,0,0,100,
05-sep-18,N.L.,"LINARES, N.L.",0,1,1,0,0,0,
05-sep-18,TAMPS.,"VICTORIA, TAMPS.",1,0,1,1,0,0,
05-sep-18,TAMPS.,"REYNOSA, TAMPS.",1,0,1,7,0,124,
06-sep-18,COAH.,"TORREÓN, COAH.",0,1,1,0,0,0,
06-sep-18,COAH.,"RAMOS ARIZPE, COAH.",0,1,1,0,0,0,
06-sep-18,N.L.,"GUADALUPE, N.L.",0,1,1,0,0,0,
06-sep-18,ZAC.,"GUADALUPE, ZAC.",1,0,1,21,0,0,
06-sep-18,VER.,"VER., VER.",1,0,1,1,0,71,
06-sep-18,VER.,"MARTINEZ DE LA TORRE, VER.",1,0,1,0,0,0,
06-sep-18,MEX.,"NEZAHUALCOYOTL, MEX.",1,0,1,0,0,50,
07-sep-18,COAH.,"SAN PEDRO, COAH.",1,0,1,0,0,0,
07-sep-18,COAH.,"ACUÑA, COAH.",0,1,1,0,0,0,
07-sep-18,VER.,"BOCA DEL RIO, VER.",1,0,1,0,0,0,
08-sep-18,MOR.,"TEPOZTLAN, MOR.",1,0,1,0,0,0,
08-sep-18,VER.,"VER., VER.",1,0,1,0,0,273,
08-sep-18,VER.,"BOCA DEL RIO, VER.",1,0,1,0,0,0,
08-sep-18,MEX.,"AMECAMECA, MEX.",0,1,1,0,0,1044,
09-sep-18,MEX.,"TOLUCA, MEX.",1,0,1,1,0,0,
10-sep-18,B.C.,"TIJUANA, B.C.",0,1,1,0,0,0,
10-sep-18,COAH.,"TORREÓN, COAH.",0,1,1,0,0,57,
10-sep-18,VER.,"BOCA DEL RIO, VER.",1,0,1,5,0,85,
11-sep-18,B.C.,"TIJUANA, B.C.",1,0,1,0,0,0,
11-sep-18,N.L.,"LOS RAMONES, N.L.",1,0,1,0,0,6000,
11-sep-18,QRO.,"PEÑAMILLER, QRO.",1,0,1,0,0,0,
11-sep-18,VER.,"BOCA DEL RIO, VER.",1,0,1,2,0,106,
11-sep-18,MOR.,"TEPOZTLAN, MOR.",0,1,1,0,0,0,
11-sep-18,ZAC.,"GUADALUPE, ZAC.",1,0,1,0,0,0,
11-sep-18,TAMPS.,"ALTAMIRA, TAMPS.",1,0,1,0,0,0,
11-sep-18,TAMPS.,"MATAMOROS, TAMPS.",0,1,1,5,0,22,
12-sep-18,B.C.,"TIJUANA, B.C.",0,1,1,0,0,0,
12-sep-18,COAH.,"PIEDRAS NEGRAS, COAH.",1,0,1,0,0,600,
12-sep-18,COAH.,"MÚZQUIZ, COAH.",0,1,1,0,0,0,
12-sep-18,VER.,"VER., VER.",0,1,1,2,0,881,
13-sep-18,MOR.,"CUERNAVACA, MOR.",1,0,1,0,0,63,
13-sep-18,MOR.,"EMILIANO ZAPATA, MOR.",1,0,1,0,0,170,
13-sep-18,TAMPS.,"MATAMOROS, TAMPS.",1,0,1,0,0,0,
13-sep-18,TAMPS.,"NUEVO LAREDO, TAMPS.",1,0,1,1,0,7,
14-sep-18,COAH.,"PIEDRAS NEGRAS, COAH.",1,0,1,6,0,154,
14-sep-18,N.L.,"LOS RAMONES, N.L.",1,0,1,0,0,0,
14-sep-18,TAMPS.,"CIUDAD MADERO, TAMPS.",1,0,1,0,0,0,
14-sep-18,MOR.,"CUERNAVACA, MOR.",0,1,1,0,0,50,
17-sep-18,N.L.,"LOS RAMONES, N.L.",1,0,1,0,0,1000,
17-sep-18,AGS.,"AGS., AGS.",1,0,1,4,0,121,
17-sep-18,MOR.,"CUERNAVACA, MOR.",0,1,1,8,0,276,
18-sep-18,COAH.,"PIEDRAS NEGRAS, COAH.",0,1,1,5,0,0,
18-sep-18,ZAC.,"ZAC., ZAC.",0,1,1,0,0,0,
18-sep-18,MEX.,"SAN SIMON DE GRO., MEX.",0,1,1,0,0,0,
18-sep-18,VER.,"XALAPA, VER.",1,0,1,0,0,0,
19-sep-18,MEX.,"SAN SIMON DE GRO., MEX.",1,0,1,0,0,0,
19-sep-18,AGS.,"AGS., AGS.",1,0,1,2,0,59,
20-sep-18,MEX.,"TULTEPEC, MEX.",1,0,1,0,0,46,
20-sep-18,ZAC.,"ZAC., ZAC.",0,1,1,0,0,0,
20-sep-18,COAH.,"MONCLOVA, COAH.",0,1,1,0,0,0,
20-sep-18,COAH.,"PIEDRAS NEGRAS, COAH.",0,1,1,0,0,0,
20-sep-18,COAH.,"ACUÑA, COAH.",0,1,1,0,0,0,
20-sep-18,MEX.,"SAN SIMON DE GRO., MEX.",0,1,1,0,0,0,
20-sep-18,B.C.,"MEXICALI, B.C.",1,0,1,0,0,0,
21-sep-18,MEX.,"TOLUCA, MEX.",0,1,1,0,0,395,
21-sep-18,MEX.,"SAN SIMON DE GRO., MEX.",0,1,1,0,0,0,
21-sep-18,MOR.,"TEPOZTLAN, MOR.",1,0,1,0,0,0,
21-sep-18,VER.,"VER., VER.",1,0,1,0,0,0,
22-sep-18,COAH.,"PIEDRAS NEGRAS, COAH.",1,0,1,0,0,400,
22-sep-18,TAMPS.,"MATAMOROS, TAMPS.",0,1,1,1,0,778,
22-sep-18,MEX.,"SAN SIMON DE GRO., MEX.",0,1,1,0,0,0,
22-sep-18,MOR.,"EMILIANO ZAPATA, MOR.",0,1,1,41,0,210,
23-sep-18,TAB.,"JONUTA, TAB.",1,0,1,0,0,0,
23-sep-18,S.L.P.,"CIUDAD VALLES, S.L.P.",1,0,1,5,4,0,
24-sep-18,MEX.,"ECATEPEC DE MOR., MEX.",1,0,1,0,7,240,
24-sep-18,N.L.,"MELCHOR OCAMPO, N.L.",1,0,1,0,0,0,
24-sep-18,COAH.,"FRANCISCO I. MADERO, COAH.",1,0,1,0,0,0,
24-sep-18,COAH.,"PIEDRAS NEGRAS, COAH.",0,1,1,4,0,300,
24-sep-18,COAH.,"FRANCISCO I. MADERO, COAH.",1,0,1,0,0,65,
25-sep-18,MEX.,"CHAPA DE MOTA, MEX.",0,1,1,0,0,0,
26-sep-18,COAH.,"FRANCISCO I. MADERO, COAH.",1,0,1,0,0,0,
26-sep-18,COAH.,"SALTILLO, COAH.",1,0,1,0,0,0,
26-sep-18,COAH.,"MÚZQUIZ, COAH.",0,1,1,0,0,0,
26-sep-18,TAMPS.,"ALTAMIRA, TAMPS.",1,0,1,0,0,0,
26-sep-18,S.L.P.,"SAN LUIS POTOSI, S.L.P.",0,1,1,0,0,0,
26-sep-18,MEX.,"CHAPA DE MOTA, MEX.",1,0,1,0,0,0,
26-sep-18,MOR.,"CUERNAVACA, MOR.",1,0,1,2,0,885,
27-sep-18,MEX.,"CHAPA DE MOTA, MEX.",1,0,1,0,0,0,
27-sep-18,MEX.,"IXTAPALUCA, MEX.",1,0,1,0,2,51,
28-sep-18,MOR.,"CUERNAVACA, MOR.",1,0,1,1,0,800,
28-sep-18,B.C.,"TIJUANA, B.C.",0,1,1,0,0,0,
28-sep-18,MEX.,"IXTAPALUCA, MEX.",1,0,1,0,0,4,
29-sep-18,COAH.,"PIEDRAS NEGRAS, COAH.",0,1,1,0,0,0,
01-oct-18,MEX.,"JILOTEPEC, MEX.",0,1,1,0,0,0,
01-oct-18,MEX.,"RAYON, MEX.",1,0,1,0,0,0,
01-oct-18,MOR.,"EMILIANO ZAPATA, MOR.",1,0,1,1,1,0,
01-oct-18,MEX.,"IXTAPALUCA, MEX.",1,0,1,0,0,46,
03-oct-18,MEX.,"TOLUCA, MEX.",1,0,1,1,0,122,
03-oct-18,COAH.,"SALTILLO, COAH.",1,0,1,1,0,11,
03-oct-18,MEX.,"IXTAPALUCA, MEX.",0,1,1,0,0,0,
03-oct-18,MEX.,"ECATEPEC DE MOR., MEX.",1,0,1,0,0,0,
04-oct-18,ZAC.,"GUADALUPE, ZAC.",1,0,1,9,0,0,
04-oct-18,S.L.P.,"SAN LUIS POTOSI, S.L.P.",1,0,1,0,0,0,
04-oct-18,MEX.,"LERMA, MEX.",1,0,1,0,0,5197,
04-oct-18,MEX.,"IXTAPALUCA, MEX.",1,0,1,0,0,295,
05-oct-18,S.L.P.,"MATEHUALA, S.L.P.",1,0,1,0,0,0,
05-oct-18,MEX.,"IXTAPALUCA, MEX.",1,0,1,0,0,206,
05-oct-18,MEX.,"ECATEPEC DE MOR., MEX.",0,1,1,0,0,5724,
07-oct-18,S.L.P.,"SAN LUIS POTOSI, S.L.P.",1,0,1,0,0,0,
08-oct-18,D.F.,"MIGUEL HGO., D.F.",1,0,1,0,1,366,
08-oct-18,AGS.,"AGS., AGS.",1,0,1,0,0,518,
09-oct-18,B.C.,"TIJUANA, B.C.",1,0,1,0,0,0,
09-oct-18,COAH.,"RAMOS ARIZPE, COAH.",1,0,1,1,0,247,
09-oct-18,DGO.,"GOMEZ PALACIO, DGO.",1,0,1,0,0,0,
09-oct-18,SIN.,"ROSARIO, SIN.",0,1,1,0,0,0,
09-oct-18,MEX.,"COACALCO DE BERRIOZABAL, MEX.",1,0,1,0,0,50,
10-oct-18,COAH.,"SAN PEDRO, COAH.",0,1,1,0,0,0,
10-oct-18,COAH.,"ACUÑA, COAH.",0,1,1,0,0,0,
10-oct-18,S.L.P.,"SAN LUIS POTOSI, S.L.P.",0,1,1,0,0,0,
10-oct-18,MEX.,"TEPOTZOTLAN, MEX.",0,1,1,0,0,109,
10-oct-18,MEX.,"COACALCO DE BERRIOZABAL, MEX.",1,0,1,0,0,75,
11-oct-18,S.L.P.,"SAN LUIS POTOSI, S.L.P.",1,0,1,0,0,0,
11-oct-18,S.L.P.,"MATEHUALA, S.L.P.",1,0,1,0,0,0,
12-oct-18,COAH.,"PIEDRAS NEGRAS, COAH.",0,1,1,0,0,485,
12-oct-18,S.L.P.,"EBANO, S.L.P.",1,0,1,0,0,53,
12-oct-18,S.L.P.,"SAN LUIS POTOSI, S.L.P.",1,0,1,0,0,0,
12-oct-18,S.L.P.,"SAN LUIS POTOSI, S.L.P.",1,0,1,0,0,0,
13-oct-18,B.C.,"TIJUANA, B.C.",1,0,1,0,0,0,
13-oct-18,S.L.P.,"EBANO, S.L.P.",1,0,1,1,0,0,
13-oct-18,MEX.,"NAUCALPAN DE JUAREZ, MEX.",1,0,1,0,0,2110,
14-oct-18,S.L.P.,"SOLEDAD DE GRACIANO SANCHEZ, S.L.P.",1,0,1,0,0,0,
15-oct-18,S.L.P.,"EBANO, S.L.P.",1,0,1,0,0,0,
16-oct-18,MEX.,"ATIZAPAN, MEX.",1,0,1,0,0,0,
16-oct-18,COAH.,"SALTILLO, COAH.",1,0,1,0,0,554,
16-oct-18,B.C.,"TIJUANA, B.C.",0,1,1,0,0,0,
17-oct-18,AGS.,"AGS., AGS.",1,0,1,0,0,50,
17-oct-18,S.L.P.,"SAN LUIS POTOSI, S.L.P.",1,0,1,0,0,0,
18-oct-18,MEX.,"NAUCALPAN DE JUAREZ, MEX.",1,0,1,1,0,2389,
18-oct-18,AGS.,"AGS., AGS.",1,0,1,1,0,721,
18-oct-18,COAH.,"SALTILLO, COAH.",0,1,1,0,0,0,
18-oct-18,COAH.,"PIEDRAS NEGRAS, COAH.",0,1,1,1,0,25,
18-oct-18,COAH.,"ACUÑA, COAH.",1,0,1,0,0,455,
19-oct-18,MEX.,"COACALCO DE BERRIOZABAL, MEX.",0,1,1,0,0,44,
19-oct-18,COAH.,"MATAMOROS, COAH.",1,0,1,2,0,0,
19-oct-18,COAH.,"PIEDRAS NEGRAS, COAH.",0,1,1,0,0,0,
19-oct-18,S.L.P.,"SAN LUIS POTOSI, S.L.P.",1,0,1,6,0,0,
20-oct-18,S.L.P.,"SALINAS, S.L.P.",1,0,1,0,0,0,
20-oct-18,MEX.,"COACALCO DE BERRIOZABAL, MEX.",1,0,1,1,0,0,
20-oct-18,COAH.,"PIEDRAS NEGRAS, COAH.",0,1,1,0,0,0,
20-oct-18,COAH.,"ACUÑA, COAH.",0,1,1,5,0,0,
22-oct-18,MOR.,"TEPOZTLAN, MOR.",0,1,1,8,0,1385,
22-oct-18,MEX.,"LA PAZ, MEX.",1,0,1,0,0,0,
23-oct-18,COAH.,"MÚZQUIZ, COAH.",0,1,1,0,0,170,
24-oct-18,ZAC.,"GUADALUPE, ZAC.",1,0,1,15,0,0,
24-oct-18,ZAC.,"FRESNILLO, ZAC.",1,0,1,0,0,0,
24-oct-18,GTO.,"LEON, GTO.",1,0,1,0,0,0,
24-oct-18,MEX.,"TECAMAC, MEX.",1,0,1,0,0,1467,
24-oct-18,MEX.,"LA PAZ, MEX.",1,0,1,0,14,91,
25-oct-18,MOR.,"CUERNAVACA, MOR.",0,1,1,4,4,440,
25-oct-18,COAH.,"PIEDRAS NEGRAS, COAH.",0,1,1,1,1,215,
25-oct-18,DGO.,"GOMEZ PALACIO, DGO.",0,1,1,0,0,0,
26-oct-18,MEX.,"TEJUPILCO, MEX.",1,0,1,0,0,26,
26-oct-18,DGO.,"GOMEZ PALACIO, DGO.",1,0,1,0,0,0,
26-oct-18,COAH.,"PIEDRAS NEGRAS, COAH.",0,1,1,0,0,0,
27-oct-18,MEX.,"TECAMAC, MEX.",1,0,1,0,0,126,
27-oct-18,MEX.,"LA PAZ, MEX.",0,1,1,0,15,0,
27-oct-18,MOR.,"CUERNAVACA, MOR.",1,0,1,18,0,80,
27-oct-18,COAH.,"ACUÑA, COAH.",0,1,1,0,0,0,
27-oct-18,CHIH.,"JUÁREZ, CHIH.",1,0,1,0,1,23,
29-oct-18,COAH.,"SALTILLO, COAH.",1,0,1,2,0,288,
30-oct-18,MOR.,"TEPOZTLAN, MOR.",1,0,1,0,0,250,
30-oct-18,MEX.,"TENANCINGO, MEX.",0,1,1,0,3,0,
30-oct-18,ZAC.,"FRESNILLO, ZAC.",1,0,1,11,0,0,
30-oct-18,COAH.,"SALTILLO, COAH.",1,0,1,0,0,0,
30-oct-18,COAH.,"MÚZQUIZ, COAH.",0,1,1,3,0,480,
31-oct-18,MEX.,"TECAMAC, MEX.",1,0,1,0,0,0,
01-nov-18,B.C.,"TIJUANA, B.C.",0,1,1,0,0,0,
01-nov-18,MEX.,"CHICONCUAC, MEX.",1,0,1,0,0,0,
03-nov-18,DGO.,"GOMEZ PALACIO, DGO.",1,0,1,0,0,0,
03-nov-18,CHIH.,"JUÁREZ, CHIH.",1,0,1,0,0,322,
04-nov-18,B.C.,"MEXICALI, B.C.",1,0,1,0,0,0,
05-nov-18,CHIH.,"JUÁREZ, CHIH.",1,0,1,0,0,0,
05-nov-18,COAH.,"SALTILLO, COAH.",1,0,1,1,0,0,
05-nov-18,MEX.,"METEPEC, MEX.",1,0,1,0,0,0,
06-nov-18,B.C.,"TIJUANA, B.C.",1,0,1,0,0,0,
06-nov-18,ZAC.,"GUADALUPE, ZAC.",1,0,1,8,0,0,
06-nov-18,CHIH.,"JUÁREZ, CHIH.",1,0,1,0,0,49,
07-nov-18,MEX.,"AMATEPEC, MEX.",0,1,1,0,0,0,
07-nov-18,COAH.,"PIEDRAS NEGRAS, COAH.",1,0,1,2,0,350,
08-nov-18,MOR.,"TEPOZTLAN, MOR.",1,0,1,11,0,409,
08-nov-18,CHIH.,"JUÁREZ, CHIH.",0,1,1,1,0,28,
08-nov-18,MEX.,"METEPEC, MEX.",1,0,1,0,0,0,
08-nov-18,MEX.,"AMATEPEC, MEX.",1,0,1,0,0,0,
09-nov-18,COAH.,"ACUÑA, COAH.",1,0,1,0,0,0,
09-nov-18,MEX.,"CUAUTITLAN IZCALLI, MEX.",1,0,1,0,0,1786,
10-nov-18,MEX.,"CUAUTITLAN IZCALLI, MEX.",1,0,1,0,0,0,
10-nov-18,MEX.,"AMATEPEC, MEX.",0,1,1,0,0,11,
12-nov-18,B.C.,"TIJUANA, B.C.",0,1,1,0,0,0,
12-nov-18,B.C.,"MEXICALI, B.C.",0,1,1,0,0,0,
12-nov-18,MEX.,"TEPETLAOXTOC, MEX.",0,1,1,0,0,1397,
12-nov-18,MEX.,"CUAUTITLAN IZCALLI, MEX.",1,0,1,0,0,0,
12-nov-18,MEX.,"TEPETLAOXTOC, MEX.",0,1,1,0,0,3084,
13-nov-18,MEX.,"EL ORO, MEX.",1,0,1,0,0,0,
13-nov-18,MEX.,"ALMOLOYA DE ALQUISIRAS, MEX.",0,1,1,0,0,0,
13-nov-18,N.L.,"LOS ALDAMAS, N.L.",0,1,1,25,0,0,
13-nov-18,COAH.,"PIEDRAS NEGRAS, COAH.",0,1,1,0,0,0,
13-nov-18,CHIH.,"JUÁREZ, CHIH.",0,1,1,1,0,28,
13-nov-18,D.F.,"CUAJIMALPA DE MOR., D.F.",1,0,1,0,2,627,
14-nov-18,MEX.,"TEPETLAOXTOC, MEX.",1,0,1,0,0,0,
16-nov-18,MEX.,"CUAUTITLAN IZCALLI, MEX.",1,0,1,0,0,0,
16-nov-18,COAH.,"PIEDRAS NEGRAS, COAH.",1,0,1,2,0,221,
16-nov-18,CHIH.,"JUÁREZ, CHIH.",0,1,1,10,0,156,
20-nov-18,MEX.,"VALLE DE BRAVO, MEX.",1,0,1,0,0,0,
21-nov-18,MEX.,"SAN MARTIN DE LAS PIRAMIDES, MEX.",1,0,1,0,0,6001,
22-nov-18,COAH.,"PIEDRAS NEGRAS, COAH.",0,1,1,1,0,0,
24-nov-18,B.C.,"ENSENADA, B.C.",0,1,1,0,0,0,
27-nov-18,S.L.P.,"CIUDAD VALLES, S.L.P.",1,0,1,0,0,0,
27-nov-18,COAH.,"TORREÓN, COAH.",1,0,1,0,0,0,
27-nov-18,MEX.,"JUCHITEPEC, MEX.",1,0,1,0,2,30,
28-nov-18,S.L.P.,"CIUDAD VALLES, S.L.P.",1,0,1,0,0,0,
28-nov-18,S.L.P.,"SALINAS, S.L.P.",0,1,1,0,0,0,
29-nov-18,MEX.,"JUCHITEPEC, MEX.",0,1,1,0,5,0,
30-nov-18,MEX.,"JUCHITEPEC, MEX.",1,0,1,0,0,14,
30-nov-18,MEX.,"JUCHITEPEC, MEX.",0,1,1,0,0,161,
03-dic-18,TAB.,"PARAISO, TAB.",1,0,1,0,0,14,
07-dic-18,SIN.,"MAZATLAN, SIN.",1,0,1,0,0,0,
07-dic-18,SIN.,"AHOME, SIN.",1,0,1,0,0,0,
11-dic-18,SIN.,"GUASAVE, SIN.",1,0,1,0,0,0,
12-dic-18,TAMPS.,"TAMPICO, TAMPS.",1,0,1,3,0,200,
12-dic-18,TAMPS.,"CIUDAD MADERO, TAMPS.",1,0,1,0,0,99,
13-dic-18,B.C.,"MEXICALI, B.C.",0,1,1,0,0,0,
17-dic-18,SIN.,"NAVOLATO, SIN.",0,1,1,0,0,0,
19-dic-18,SIN.,"CULIACAN, SIN.",1,0,1,0,0,0,
23-dic-18,TAB.,"TENOSIQUE, TAB.",0,1,1,0,0,0,
30-dic-18,GRO.,"PUNGARABATO, GRO.",0,1,1,0,0,0,
13-ene-19,TAB.,"JONUTA, TAB.",0,1,1,0,0,0,
25-ene-19,COAH.,"PIEDRAS NEGRAS, COAH.",0,1,1,0,0,100,
30-ene-19,YUC.,"IZAMAL, YUC.",0,1,1,0,0,0,
31-ene-19,YUC.,"IZAMAL, YUC.",0,1,1,0,0,0,
31-ene-19,COAH.,"PIEDRAS NEGRAS, COAH.",0,1,1,8,0,124,
01-feb-19,GTO.,"DOCTOR MORA, GTO.",1,0,1,0,0,0,
14-feb-19,COAH.,"SALTILLO, COAH.",1,0,1,0,0,0,
15-feb-19,COAH.,"SALTILLO, COAH.",0,1,1,5,1,27,
21-feb-19,COAH.,"SALTILLO, COAH.",1,0,1,0,0,23,
21-feb-19,COAH.,"ACUÑA, COAH.",1,0,1,0,0,0,
22-feb-19,CHIH.,"CUAUHTÉMOC, CHIH.",1,0,1,1,0,0,
22-feb-19,ZAC.,"FRESNILLO, ZAC.",1,0,1,2,0,44,
23-feb-19,DGO.,"GOMEZ PALACIO, DGO.",0,1,1,0,0,0,
26-feb-19,DGO.,"GOMEZ PALACIO, DGO.",1,0,1,1,0,0,
26-feb-19,GTO.,"ACAMBARO, GTO.",1,0,1,0,0,0,
01-mar-19,COAH.,"RAMOS ARIZPE, COAH.",1,0,1,0,0,0,
04-mar-19,DGO.,"GOMEZ PALACIO, DGO.",1,0,1,0,0,0,
05-mar-19,COAH.,"TORREÓN, COAH.",0,1,1,0,0,0,
05-mar-19,COAH.,"PIEDRAS NEGRAS, COAH.",0,1,1,6,0,317,
06-mar-19,COAH.,"SALTILLO, COAH.",1,0,1,1,0,128,
07-mar-19,COAH.,"MATAMOROS, COAH.",0,1,1,0,0,0,
07-mar-19,CHIS.,"SAN CRISTOBAL DE LAS CASAS, CHIS.",1,0,1,0,0,287,
07-mar-19,CHIS.,"TAPACHULA, CHIS.",1,0,1,11,2,596,
07-mar-19,COAH.,"SALTILLO, COAH.",0,1,1,1,0,0,
08-mar-19,COAH.,"FRANCISCO I. MADERO, COAH.",0,1,1,0,0,0,
08-mar-19,COAH.,"SALTILLO, COAH.",1,0,1,5,0,293,
09-mar-19,CHIS.,"SAN CRISTOBAL DE LAS CASAS, CHIS.",0,1,1,0,0,1283,
10-mar-19,CHIS.,"TAPACHULA, CHIS.",1,0,1,1,1,2667,
10-mar-19,CHIS.,"TUXTLA GUTIÉRREZ, CHIS.",1,0,1,0,2,3683,
11-mar-19,ZAC.,"FRESNILLO, ZAC.",0,1,1,5,0,50,
11-mar-19,COAH.,"SALTILLO, COAH.",1,0,1,0,0,0,
12-mar-19,S.L.P.,"CIUDAD VALLES, S.L.P.",0,1,1,0,0,0,
13-mar-19,ZAC.,"FRESNILLO, ZAC.",1,0,1,0,0,3568,
14-mar-19,S.L.P.,"SOLEDAD DE GRACIANO SANCHEZ, S.L.P.",1,0,1,0,0,0,
15-mar-19,COAH.,"PIEDRAS NEGRAS, COAH.",0,1,1,0,0,370,
15-mar-19,ZAC.,"FRESNILLO, ZAC.",1,0,1,6,0,3599,
15-mar-19,S.L.P.,"SOLEDAD DE GRACIANO SANCHEZ, S.L.P.",1,0,1,0,0,17,
16-mar-19,S.L.P.,"CIUDAD VALLES, S.L.P.",1,0,1,0,0,13,
18-mar-19,S.L.P.,"SOLEDAD DE GRACIANO SANCHEZ, S.L.P.",0,1,1,0,0,0,
19-mar-19,S.L.P.,"SAN LUIS POTOSI, S.L.P.",1,0,1,0,0,14,
19-mar-19,COAH.,"SALTILLO, COAH.",1,0,1,0,0,0,
20-mar-19,COAH.,"TORREÓN, COAH.",1,0,1,0,0,0,
20-mar-19,COAH.,"SAN PEDRO, COAH.",1,0,1,0,0,0,
20-mar-19,COAH.,"PIEDRAS NEGRAS, COAH.",0,1,1,0,0,0,
21-mar-19,COAH.,"FRANCISCO I. MADERO, COAH.",0,1,1,0,0,0,
22-mar-19,COAH.,"SAN PEDRO, COAH.",1,0,1,0,0,0,
23-mar-19,Q. ROO.,"COZUMEL, Q. ROO",0,1,1,0,0,332,
23-mar-19,COAH.,"PIEDRAS NEGRAS, COAH.",1,0,1,5,0,0,
25-mar-19,S.L.P.,"CIUDAD VALLES, S.L.P.",0,1,1,0,0,0,
25-mar-19,S.L.P.,"SAN LUIS POTOSI, S.L.P.",0,1,1,0,0,0,
26-mar-19,VER.,"COATZINTLA, VER.",1,0,1,0,0,0,
26-mar-19,S.L.P.,"SOLEDAD DE GRACIANO SANCHEZ, S.L.P.",1,0,1,0,0,0,
26-mar-19,S.L.P.,"CIUDAD VALLES, S.L.P.",0,1,1,0,0,0,
26-mar-19,COAH.,"FRANCISCO I. MADERO, COAH.",1,0,1,0,0,0,
26-mar-19,COAH.,"MONCLOVA, COAH.",1,0,1,0,0,5,
27-mar-19,COAH.,"PIEDRAS NEGRAS, COAH.",0,1,1,0,0,219,
27-mar-19,Q. ROO.,"BENITO JUAREZ, Q. ROO",1,0,1,0,0,55,
27-mar-19,S.L.P.,"RIOVERDE, S.L.P.",1,0,1,0,0,0,
28-mar-19,COAH.,"FRANCISCO I. MADERO, COAH.",0,1,1,0,0,0,
29-mar-19,DGO.,"GOMEZ PALACIO, DGO.",1,0,1,0,0,0,
29-mar-19,S.L.P.,"SAN LUIS POTOSI, S.L.P.",0,1,1,0,0,0,
29-mar-19,ZAC.,"GUADALUPE, ZAC.",1,0,1,8,0,93,
29-mar-19,COAH.,"TORREÓN, COAH.",1,0,1,0,0,0,
29-mar-19,COAH.,"FRANCISCO I. MADERO, COAH.",0,1,1,0,0,0,
01-abr-19,S.L.P.,"MATEHUALA, S.L.P.",0,1,1,0,0,0,
01-abr-19,ZAC.,"ZAC., ZAC.",1,0,1,0,0,0,
01-abr-19,ZAC.,"FRESNILLO, ZAC.",0,1,1,0,0,3500,
01-abr-19,COAH.,"SAN PEDRO, COAH.",1,0,1,7,0,0,
01-abr-19,COAH.,"MONCLOVA, COAH.",1,0,1,0,1,12,
02-abr-19,COAH.,"FRANCISCO I. MADERO, COAH.",0,1,1,0,0,0,
02-abr-19,COAH.,"SALTILLO, COAH.",0,1,1,0,0,280,
02-abr-19,VER.,"MALTRATA, VER.",1,0,1,0,0,0,
02-abr-19,ZAC.,"ZAC., ZAC.",1,0,1,6,0,0,
02-abr-19,S.L.P.,"SAN LUIS POTOSI, S.L.P.",0,1,1,0,0,0,
03-abr-19,S.L.P.,"SAN LUIS POTOSI, S.L.P.",0,1,1,0,0,0,
03-abr-19,S.L.P.,"CIUDAD VALLES, S.L.P.",1,0,1,4,0,0,
03-abr-19,CHIH.,"OJINAGA, CHIH.",1,0,1,2,0,7,
04-abr-19,COAH.,"SALTILLO, COAH.",0,1,1,0,0,0,
04-abr-19,COAH.,"MONCLOVA, COAH.",1,0,1,0,2,0,
04-abr-19,COAH.,"PIEDRAS NEGRAS, COAH.",0,1,1,2,0,60,
04-abr-19,S.L.P.,"CIUDAD VALLES, S.L.P.",1,0,1,0,0,0,
05-abr-19,CD. MÉX.,"IZTAPALAPA, CD. MÉX.",1,0,1,0,0,2441,
05-abr-19,COAH.,"SALTILLO, COAH.",1,0,1,0,0,0,
05-abr-19,COAH.,"MONCLOVA, COAH.",0,1,1,0,0,1,
05-abr-19,S.L.P.,"RIOVERDE, S.L.P.",1,0,1,0,0,0,
05-abr-19,S.L.P.,"SOLEDAD DE GRACIANO SANCHEZ, S.L.P.",1,0,1,0,0,0,
05-abr-19,S.L.P.,"MATEHUALA, S.L.P.",1,0,1,0,0,0,
06-abr-19,S.L.P.,"SOLEDAD DE GRACIANO SANCHEZ, S.L.P.",1,0,1,2,0,0,
09-abr-19,ZAC.,"ZAC., ZAC.",0,1,1,0,0,0,
09-abr-19,S.L.P.,"CIUDAD VALLES, S.L.P.",1,0,1,4,0,110,
10-abr-19,S.L.P.,"SAN LUIS POTOSI, S.L.P.",1,0,1,0,1,0,
11-abr-19,ZAC.,"GUADALUPE, ZAC.",1,0,1,4,0,0,
11-abr-19,ZAC.,"FRESNILLO, ZAC.",1,0,1,1,0,0,
11-abr-19,S.L.P.,"SOLEDAD DE GRACIANO SANCHEZ, S.L.P.",0,1,1,0,0,0,
12-abr-19,ZAC.,"GUADALUPE, ZAC.",0,1,1,0,2,0,
12-abr-19,COAH.,"RAMOS ARIZPE, COAH.",1,0,1,0,0,0,
13-abr-19,COAH.,"SAN PEDRO, COAH.",1,0,1,1,0,110,
15-abr-19,COAH.,"FRANCISCO I. MADERO, COAH.",1,0,1,0,0,0,
15-abr-19,S.L.P.,"CIUDAD VALLES, S.L.P.",0,1,1,0,0,0,
16-abr-19,S.L.P.,"CIUDAD VALLES, S.L.P.",1,0,1,1,0,0,
17-abr-19,S.L.P.,"SAN LUIS POTOSI, S.L.P.",1,0,1,3,0,0,
19-abr-19,S.L.P.,"CIUDAD VALLES, S.L.P.",1,0,1,0,0,0,
20-abr-19,S.L.P.,"CIUDAD VALLES, S.L.P.",0,1,1,1,0,40,
23-abr-19,CD. MÉX.,"VENUSTIANO CARRANZA, CD. MÉX.",1,0,1,0,0,30,
23-abr-19,COAH.,"MATAMOROS, COAH.",0,1,1,0,0,0,
23-abr-19,VER.,"LAS VIGAS DE RAMIREZ, VER.",0,1,1,2,0,9,
24-abr-19,CD. MÉX.,"VENUSTIANO CARRANZA, CD. MÉX.",1,0,1,0,0,38,
24-abr-19,CD. MÉX.,"IZTAPALAPA, CD. MÉX.",1,0,1,0,0,0,
25-abr-19,CHIH.,"JUÁREZ, CHIH.",1,0,1,7,0,0,
26-abr-19,CD. MÉX.,"IZTAPALAPA, CD. MÉX.",1,0,1,0,0,0,
02-may-19,VER.,"PLATON SANCHEZ, VER.",1,0,1,0,0,0,
03-may-19,CD. MÉX.,"VENUSTIANO CARRANZA, CD. MÉX.",1,0,1,0,0,0,
06-may-19,COAH.,"PIEDRAS NEGRAS, COAH.",1,0,1,0,0,0,
07-may-19,COAH.,"MONCLOVA, COAH.",1,0,1,0,0,0,
07-may-19,COAH.,"PIEDRAS NEGRAS, COAH.",1,0,1,0,0,0,
09-may-19,COAH.,"MONCLOVA, COAH.",1,0,1,0,0,49,
09-may-19,TAB.,"TEAPA, TAB.",1,0,1,0,0,0,
15-may-19,CHIH.,"OJINAGA, CHIH.",1,0,1,0,0,0,
16-may-19,CD. MÉX.,"AZCAPOTZALCO, CD. MÉX.",1,0,1,0,0,0,
16-may-19,COAH.,"PIEDRAS NEGRAS, COAH.",1,0,1,0,0,0,
16-may-19,ZAC.,"GUADALUPE, ZAC.",0,1,1,0,0,0,
17-may-19,COAH.,"PIEDRAS NEGRAS, COAH.",1,0,1,0,0,11,
17-may-19,ZAC.,"ZAC., ZAC.",1,0,1,1,0,0,
17-may-19,ZAC.,"FRESNILLO, ZAC.",1,0,1,1,0,0,
20-may-19,COAH.,"PIEDRAS NEGRAS, COAH.",0,1,1,0,0,0,
22-may-19,COAH.,"PIEDRAS NEGRAS, COAH.",0,1,1,0,0,4,
22-may-19,COAH.,"ACUÑA, COAH.",1,0,1,0,0,0,
23-may-19,ZAC.,"FRESNILLO, ZAC.",1,0,1,1,0,65,
24-may-19,ZAC.,"GUADALUPE, ZAC.",1,0,1,4,0,220,
27-may-19,COAH.,"ACUÑA, COAH.",0,1,1,0,0,0,
28-may-19,VER.,"NOGALES, VER.",1,0,1,0,0,0,
28-may-19,COAH.,"SALTILLO, COAH.",1,0,1,0,0,10,
28-may-19,ZAC.,"FRESNILLO, ZAC.",1,0,1,0,0,0,
30-may-19,VER.,"NOGALES, VER.",0,1,1,0,0,0,
30-may-19,ZAC.,"GUADALUPE, ZAC.",1,0,1,4,0,250,
30-may-19,CD. MÉX.,"AZCAPOTZALCO, CD. MÉX.",1,0,1,0,0,922,
01-jun-19,COL.,"COL., COL.",1,0,1,0,0,0,
03-jun-19,CD. MÉX.,"LA MAGDALENA CONTRERAS, CD. MÉX.",0,1,1,0,0,3,
04-jun-19,ZAC.,"ZAC., ZAC.",1,0,1,0,0,1100,
04-jun-19,COAH.,"PIEDRAS NEGRAS, COAH.",1,0,1,0,0,0,
04-jun-19,COAH.,"ACUÑA, COAH.",1,0,1,0,0,0,
05-jun-19,ZAC.,"GUADALUPE, ZAC.",1,0,1,0,0,800,
06-jun-19,CD. MÉX.,"LA MAGDALENA CONTRERAS, CD. MÉX.",0,1,1,0,0,0,
06-jun-19,QRO.,"CORREGIDORA, QRO.",0,1,1,0,0,0,
06-jun-19,MÉX.,"COACALCO DE BERRIOZABAL, MEX.",0,1,1,0,0,0,
11-jun-19,ZAC.,"FRESNILLO, ZAC.",1,0,1,0,0,0,
11-jun-19,Q. ROO.,"OTHON P. BLANCO, Q. ROO",1,0,1,0,23,0,
12-jun-19,QRO.,"AMEALCO DE BONFIL, QRO.",0,1,1,0,0,0,
12-jun-19,ZAC.,"FRESNILLO, ZAC.",0,1,1,0,0,75,
13-jun-19,VER.,"NAUTLA, VER.",1,0,1,0,0,0,
13-jun-19,ZAC.,"GUADALUPE, ZAC.",1,0,1,7,0,100,
13-jun-19,ZAC.,"FRESNILLO, ZAC.",1,0,1,0,0,0,
14-jun-19,COAH.,"SALTILLO, COAH.",0,1,1,0,1,309,
14-jun-19,Q. ROO.,"BENITO JUAREZ, Q. ROO",0,1,1,0,0,8,
14-jun-19,DGO.,"DGO., DGO.",0,1,1,0,0,0,
17-jun-19,CHIH.,"IGNACIO ZARAGOZA, CHIH.",0,1,1,0,0,0,
17-jun-19,CD. MÉX.,"TLAHUAC, CD. MÉX.",0,1,1,0,1,387,
17-jun-19,ZAC.,"FRESNILLO, ZAC.",0,1,1,0,0,0,
18-jun-19,CHIH.,"IGNACIO ZARAGOZA, CHIH.",1,0,1,0,1,0,
18-jun-19,ZAC.,"ZAC., ZAC.",1,0,1,0,0,2,
19-jun-19,ZAC.,"GUADALUPE, ZAC.",1,0,1,2,0,100,
19-jun-19,ZAC.,"ZAC., ZAC.",0,1,1,4,0,0,
19-jun-19,Q. ROO.,"BENITO JUAREZ, Q. ROO",1,0,1,0,0,0,
19-jun-19,VER.,"MINATITLAN, VER.",1,0,1,1,0,24,
20-jun-19,VER.,"PUEBLO VIEJO, VER.",0,1,1,0,0,0,
21-jun-19,VER.,"PUEBLO VIEJO, VER.",0,1,1,0,0,0,
21-jun-19,VER.,"NAUTLA, VER.",1,0,1,0,0,0,
21-jun-19,DGO.,"DGO., DGO.",1,0,1,1,0,0,
22-jun-19,QRO.,"PINAL DE AMOLES, QRO.",1,0,1,0,0,0,
26-jun-19,Q. ROO.,"SOLIDARIDAD, Q. ROO",1,0,1,0,0,57,
26-jun-19,DGO.,"DGO., DGO.",1,0,1,0,0,0,
27-jun-19,COAH.,"SALTILLO, COAH.",1,0,1,0,0,9,
29-jun-19,QRO.,"ARROYO SECO, QRO.",1,0,1,0,0,0,
30-jun-19,CHIS.,"BENEMÉRITO DE LAS AMÉRICAS, CHIS.",0,1,1,0,0,0,
01-jul-19,CD. MÉX.,"IZTAPALAPA, CD. MÉX.",1,0,1,0,0,73,
01-jul-19,AGS.,"AGS., AGS.",1,0,1,4,0,281,
02-jul-19,CD. MÉX.,"XOCHIMILCO, CD. MÉX.",1,0,1,0,0,0,
02-jul-19,CD. MÉX.,"IZTAPALAPA, CD. MÉX.",1,0,1,0,0,669,
03-jul-19,ZAC.,"FRESNILLO, ZAC.",0,1,1,0,0,0,
03-jul-19,AGS.,"AGS., AGS.",1,0,1,0,0,59,
04-jul-19,CD. MÉX.,"MILPA ALTA, CD. MÉX.",0,1,1,0,0,0,
05-jul-19,Q. ROO.,"BENITO JUAREZ, Q. ROO",1,0,1,0,0,7,
05-jul-19,CD. MÉX.,"XOCHIMILCO, CD. MÉX.",1,0,1,0,0,6,
05-jul-19,AGS.,"AGS., AGS.",1,0,1,3,0,106,
08-jul-19,ZAC.,"ZAC., ZAC.",1,0,1,0,0,1,
09-jul-19,VER.,"TAMPICO ALTO, VER.",0,1,1,0,0,0,
09-jul-19,AGS.,"AGS., AGS.",1,0,1,3,1,62,
10-jul-19,ZAC.,"ZAC., ZAC.",1,0,1,0,0,0,
10-jul-19,VER.,"SAN ANDRES TUXTLA, VER.",1,0,1,0,0,0,
11-jul-19,VER.,"MINATITLAN, VER.",0,1,1,0,0,0,
11-jul-19,CD. MÉX.,"IZTAPALAPA, CD. MÉX.",0,1,1,0,0,50,
14-jul-19,ZAC.,"FRESNILLO, ZAC.",1,0,1,6,1,0,
15-jul-19,CD. MÉX.,"TLAHUAC, CD. MÉX.",1,0,1,0,0,77,
16-jul-19,VER.,"COATZINTLA, VER.",1,0,1,0,0,161,
16-jul-19,AGS.,"AGS., AGS.",1,0,1,1,0,255,
16-jul-19,NAY.,"ACAPONETA, NAY.",1,0,1,0,0,0,
17-jul-19,VER.,"COATZINTLA, VER.",0,1,1,0,0,40,
17-jul-19,COAH.,"ACUÑA, COAH.",0,1,1,0,0,0,
17-jul-19,AGS.,"AGS., AGS.",1,0,1,1,0,0,
18-jul-19,AGS.,"AGS., AGS.",1,0,1,1,0,0,
18-jul-19,ZAC.,"FRESNILLO, ZAC.",1,0,1,0,0,43,
18-jul-19,NAY.,"ACAPONETA, NAY.",1,0,1,0,0,0,
18-jul-19,VER.,"COATZINTLA, VER.",1,0,1,0,0,111,
18-jul-19,CHIH.,"IGNACIO ZARAGOZA, CHIH.",1,0,1,2,0,52,
19-jul-19,ZAC.,"FRESNILLO, ZAC.",1,0,1,0,0,0,
19-jul-19,CD. MÉX.,"TLAHUAC, CD. MÉX.",1,0,1,0,0,274,
19-jul-19,CD. MÉX.,"CUAJIMALPA DE MOR., CD. MÉX.",1,0,1,0,0,0,
23-jul-19,JAL.,"SAYULA, JAL.",1,0,1,0,0,0,
23-jul-19,CD. MÉX.,"TLAHUAC, CD. MÉX.",0,1,1,0,0,0,
24-jul-19,NAY.,"XALISCO, NAY.",0,1,1,0,0,0,
24-jul-19,NAY.,"HUAJICORI, NAY.",1,0,1,1,0,0,
25-jul-19,CD. MÉX.,"BENITO JUAREZ, CD. MÉX.",1,0,1,0,0,0,
25-jul-19,CD. MÉX.,"IZTAPALAPA, CD. MÉX.",1,0,1,0,0,38,
25-jul-19,VER.,"COATZINTLA, VER.",1,0,1,0,0,0,
26-jul-19,AGS.,"COSÍO, AGS.",1,0,1,11,0,0,
30-jul-19,Q. ROO.,"BENITO JUAREZ, Q. ROO",1,0,1,0,0,95,
30-jul-19,NAY.,"COMPOSTELA, NAY.",1,0,1,2,0,0,
30-jul-19,VER.,"SAYULA DE ALEMAN, VER.",1,0,1,0,0,47,
31-jul-19,CD. MÉX.,"CUAUHTEMOC, CD. MÉX.",1,0,1,0,0,6,
31-jul-19,JAL.,"SAYULA, JAL.",1,0,1,1,0,0,
03-ago-19,JAL.,"SAYULA, JAL.",1,0,1,0,0,0,
05-ago-19,MOR.,"CUERNAVACA, MOR.",0,1,1,2,0,871,
05-ago-19,NAY.,"SANTIAGO IXCUINTLA, NAY.",1,0,1,0,0,0,
06-ago-19,NAY.,"SANTIAGO IXCUINTLA, NAY.",1,0,1,0,0,0,
06-ago-19,MÉX.,"COACALCO DE BERRIOZABAL, MEX.",0,1,1,0,0,0,
07-ago-19,NAY.,"SANTIAGO IXCUINTLA, NAY.",1,0,1,0,0,0,
07-ago-19,NAY.,"IXTLAN DEL RIO, NAY.",1,0,1,0,0,0,
07-ago-19,COAH.,"SALTILLO, COAH.",1,0,1,0,0,0,
07-ago-19,CD. MÉX.,"CUAUHTEMOC, CD. MÉX.",1,0,1,0,0,291,
07-ago-19,MÉX.,"COACALCO DE BERRIOZABAL, MEX.",1,0,1,0,0,0,
08-ago-19,COAH.,"ACUÑA, COAH.",0,1,1,0,0,0,
08-ago-19,NAY.,"SANTIAGO IXCUINTLA, NAY.",1,0,1,0,0,0,
08-ago-19,Q. ROO.,"SOLIDARIDAD, Q. ROO",1,0,1,1,0,7,
09-ago-19,NAY.,"SANTIAGO IXCUINTLA, NAY.",1,0,1,0,0,0,
10-ago-19,AGS.,"ASIENTOS, AGS.",1,0,1,10,0,50,
10-ago-19,MÉX.,"SAN MARTIN DE LAS PIRAMIDES, MEX.",1,0,1,0,0,0,
11-ago-19,JAL.,"SAYULA, JAL.",1,0,1,0,0,33,
12-ago-19,JAL.,"SAYULA, JAL.",1,0,1,0,0,0,
12-ago-19,ZAC.,"FRESNILLO, ZAC.",1,0,1,4,0,26,
13-ago-19,MÉX.,"COACALCO DE BERRIOZABAL, MEX.",1,0,1,0,0,0,
13-ago-19,NAY.,"TEPIC, NAY.",1,0,1,0,0,0,
13-ago-19,CHIH.,"NUEVO CASAS GRANDES, CHIH.",0,1,1,0,0,1,
13-ago-19,CD. MÉX.,"ALVARO OBREGON, CD. MÉX.",0,1,1,0,0,239,
13-ago-19,QRO.,"QUERETARO, QRO.",1,0,1,0,2,0,
14-ago-19,NAY.,"ACAPONETA, NAY.",0,1,1,0,0,0,
14-ago-19,MÉX.,"AMECAMECA, MEX.",1,0,1,1,4,0,
15-ago-19,CD. MÉX.,"ALVARO OBREGON, CD. MÉX.",1,0,1,0,0,249,
15-ago-19,MÉX.,"AMECAMECA, MEX.",1,0,1,0,1,19,
15-ago-19,S.L.P.,"RIOVERDE, S.L.P.",1,0,1,0,0,0,
16-ago-19,ZAC.,"FRESNILLO, ZAC.",1,0,1,0,0,641,
16-ago-19,S.L.P.,"SAN LUIS POTOSI, S.L.P.",1,0,1,0,0,0,
16-ago-19,QRO.,"QUERETARO, QRO.",1,0,1,0,0,0,
16-ago-19,NAY.,"ACAPONETA, NAY.",0,1,1,0,0,0,
17-ago-19,AGS.,"TEPEZALÁ, AGS.",1,0,1,7,0,0,
18-ago-19,S.L.P.,"SAN LUIS POTOSI, S.L.P.",1,0,1,10,0,99,
18-ago-19,S.L.P.,"SOLEDAD DE GRACIANO SANCHEZ, S.L.P.",0,1,1,0,0,0,
19-ago-19,MOR.,"CUERNAVACA, MOR.",0,1,1,4,0,135,
20-ago-19,MÉX.,"TECAMAC, MEX.",1,0,1,0,5,0,
20-ago-19,MOR.,"TEPOZTLAN, MOR.",0,1,1,0,0,73,
20-ago-19,S.L.P.,"SOLEDAD DE GRACIANO SANCHEZ, S.L.P.",1,0,1,0,0,0,
20-ago-19,S.L.P.,"SAN LUIS POTOSI, S.L.P.",1,0,1,0,0,0,
20-ago-19,MÉX.,"AXAPUSCO, MEX.",0,1,1,0,0,0,
21-ago-19,ZAC.,"FRESNILLO, ZAC.",1,0,1,0,0,0,
21-ago-19,CHIH.,"NUEVO CASAS GRANDES, CHIH.",0,1,1,0,0,0,
21-ago-19,S.L.P.,"SALINAS, S.L.P.",0,1,1,0,0,0,
21-ago-19,S.L.P.,"SAN LUIS POTOSI, S.L.P.",1,0,1,0,1,0,
21-ago-19,MOR.,"CUERNAVACA, MOR.",1,0,1,0,0,0,
21-ago-19,NAY.,"HUAJICORI, NAY.",1,0,1,0,0,0,
21-ago-19,MÉX.,"AXAPUSCO, MEX.",1,0,1,0,0,393,
21-ago-19,JAL.,"SAYULA, JAL.",0,1,1,0,0,0,
22-ago-19,NAY.,"XALISCO, NAY.",1,0,1,0,0,0,
22-ago-19,MÉX.,"AXAPUSCO, MEX.",0,1,1,1,0,0,
22-ago-19,QRO.,"EZEQUIEL MONTES, QRO.",1,0,1,0,0,0,
22-ago-19,VER.,"LAS CHOAPAS, VER.",1,0,1,0,0,0,
23-ago-19,TLAX.,"TLAX., TLAX.",1,0,1,0,0,0,
23-ago-19,COL.,"COL., COL.",1,0,1,0,0,0,
23-ago-19,NAY.,"XALISCO, NAY.",1,0,1,0,0,0,
23-ago-19,B.C.S.,"LA PAZ, B.C.S.",1,0,1,0,0,99,
23-ago-19,TAMPS.,"VICTORIA, TAMPS.",1,0,1,0,0,6,
23-ago-19,S.L.P.,"SAN LUIS POTOSI, S.L.P.",1,0,1,0,0,24,
23-ago-19,S.L.P.,"SOLEDAD DE GRACIANO SANCHEZ, S.L.P.",1,0,1,3,0,0,
23-ago-19,S.L.P.,"CEDRAL, S.L.P.",1,0,1,0,0,0,
23-ago-19,QRO.,"EZEQUIEL MONTES, QRO.",1,0,1,0,0,0,
23-ago-19,MOR.,"TEPOZTLAN, MOR.",1,0,1,15,1,0,
24-ago-19,AGS.,"PABELLÓN DE ARTEAGA, AGS.",1,0,1,1,0,0,
24-ago-19,S.L.P.,"EL NARANJO, S.L.P.",0,1,1,0,0,0,
24-ago-19,MÉX.,"ZACUALPAN, MEX.",0,1,1,0,0,0,
26-ago-19,VER.,"COATZINTLA, VER.",0,1,1,0,0,0,
26-ago-19,S.L.P.,"CIUDAD VALLES, S.L.P.",1,0,1,1,0,0,
26-ago-19,CD. MÉX.,"IZTAPALAPA, CD. MÉX.",1,0,1,0,1,76,
26-ago-19,TLAX.,"APIZACO, TLAX.",1,0,1,0,0,0,
26-ago-19,ZAC.,"ZAC., ZAC.",1,0,1,0,0,0,
26-ago-19,S.L.P.,"SOLEDAD DE GRACIANO SANCHEZ, S.L.P.",1,0,1,0,2,0,
27-ago-19,JAL.,"SAYULA, JAL.",1,0,1,0,0,15,
27-ago-19,VER.,"PLATON SANCHEZ, VER.",1,0,1,0,0,31,
27-ago-19,CD. MÉX.,"TLALPAN, CD. MÉX.",1,0,1,0,0,37,
27-ago-19,S.L.P.,"CIUDAD VALLES, S.L.P.",1,0,1,0,0,0,
27-ago-19,S.L.P.,"SAN LUIS POTOSI, S.L.P.",0,1,1,0,0,0,
27-ago-19,S.L.P.,"CEDRAL, S.L.P.",1,0,1,0,0,0,
27-ago-19,MOR.,"CUERNAVACA, MOR.",1,0,1,0,0,3,
27-ago-19,JAL.,"TOMATLAN, JAL.",0,1,1,0,0,26,
27-ago-19,VER.,"SANTIAGO TUXTLA, VER.",1,0,1,0,0,0,
28-ago-19,TLAX.,"HUAMANTLA, TLAX.",0,1,1,0,0,0,
28-ago-19,S.L.P.,"SOLEDAD DE GRACIANO SANCHEZ, S.L.P.",1,0,1,0,0,0,
28-ago-19,CD. MÉX.,"TLALPAN, CD. MÉX.",1,0,1,0,0,63,
28-ago-19,CD. MÉX.,"IZTAPALAPA, CD. MÉX.",0,1,1,0,0,0,
28-ago-19,MOR.,"CUERNAVACA, MOR.",1,0,1,30,4,45,
28-ago-19,ZAC.,"FRESNILLO, ZAC.",1,0,1,0,0,0,
29-ago-19,TLAX.,"APIZACO, TLAX.",1,0,1,0,0,0,
29-ago-19,TLAX.,"HUAMANTLA, TLAX.",1,0,1,0,0,0,
29-ago-19,MÉX.,"TECAMAC, MEX.",1,0,1,0,0,45,
29-ago-19,S.L.P.,"SAN LUIS POTOSI, S.L.P.",1,0,1,0,0,216,
29-ago-19,TAMPS.,"MATAMOROS, TAMPS.",1,0,1,1,0,14,
29-ago-19,GTO.,"IRAPUATO, GTO.",0,1,1,0,3,0,
30-ago-19,COAH.,"RAMOS ARIZPE, COAH.",1,0,1,0,0,222,
30-ago-19,S.L.P.,"SOLEDAD DE GRACIANO SANCHEZ, S.L.P.",1,0,1,0,0,0,
30-ago-19,S.L.P.,"SAN LUIS POTOSI, S.L.P.",1,0,1,6,0,66,
30-ago-19,CD. MÉX.,"MIGUEL HGO., CD. MÉX.",1,0,1,0,0,9,
30-ago-19,AGS.,"CALVILLO, AGS.",0,1,1,15,0,140,
30-ago-19,MÉX.,"ATLACOMULCO, MEX.",1,0,1,0,0,11,
30-ago-19,NAY.,"TECUALA, NAY.",1,0,1,1,0,0,
30-ago-19,NAY.,"COMPOSTELA, NAY.",0,1,1,0,0,0,
31-ago-19,TLAX.,"APIZACO, TLAX.",1,0,1,0,0,0,
31-ago-19,S.L.P.,"AHUALULCO, S.L.P.",1,0,1,0,0,0,
02-sep-19,ZAC.,"GUADALUPE, ZAC.",1,0,1,2,0,200,
02-sep-19,S.L.P.,"SAN LUIS POTOSI, S.L.P.",1,0,1,0,0,0,
02-sep-19,S.L.P.,"AHUALULCO, S.L.P.",1,0,1,0,0,0,
02-sep-19,TAMPS.,"TAMPICO, TAMPS.",1,0,1,0,0,0,
03-sep-19,NAY.,"IXTLAN DEL RIO, NAY.",0,1,1,0,0,0,
03-sep-19,TAMPS.,"TAMPICO, TAMPS.",1,0,1,0,0,65,
03-sep-19,TAMPS.,"VICTORIA, TAMPS.",1,0,1,0,0,0,
04-sep-19,TLAX.,"IXTACUIXTLA DE MARIANO MATAMOROS, TLAX.",0,1,1,0,0,0,
04-sep-19,NAY.,"IXTLAN DEL RIO, NAY.",0,1,1,0,0,0,
04-sep-19,S.L.P.,"CIUDAD VALLES, S.L.P.",1,0,1,0,0,0,
05-sep-19,ZAC.,"FRESNILLO, ZAC.",0,1,1,0,0,0,
05-sep-19,CD. MÉX.,"MIGUEL HGO., CD. MÉX.",1,0,1,0,0,1,
05-sep-19,TAMPS.,"VICTORIA, TAMPS.",1,0,1,0,0,0,
05-sep-19,TAMPS.,"MATAMOROS, TAMPS.",0,1,1,1,0,0,
05-sep-19,S.L.P.,"SAN LUIS POTOSI, S.L.P.",1,0,1,0,2,0,
05-sep-19,S.L.P.,"SOLEDAD DE GRACIANO SANCHEZ, S.L.P.",1,0,1,1,2,0,
05-sep-19,S.L.P.,"MATEHUALA, S.L.P.",1,0,1,0,0,0,
06-sep-19,ZAC.,"ZAC., ZAC.",1,0,1,0,0,0,
06-sep-19,JAL.,"SAYULA, JAL.",1,0,1,0,0,0,
06-sep-19,TLAX.,"IXTACUIXTLA DE MARIANO MATAMOROS, TLAX.",0,1,1,0,0,0,
06-sep-19,S.L.P.,"SOLEDAD DE GRACIANO SANCHEZ, S.L.P.",1,0,1,0,1,0,
06-sep-19,CD. MÉX.,"MIGUEL HGO., CD. MÉX.",1,0,1,0,0,0,
07-sep-19,AGS.,"RINCÓN DE ROMOS, AGS.",1,0,1,5,0,400,
07-sep-19,MÉX.,"TEMAMATLA, MEX.",0,1,1,0,0,0,
08-sep-19,S.L.P.,"CIUDAD VALLES, S.L.P.",1,0,1,0,2,0,
09-sep-19,TAMPS.,"REYNOSA, TAMPS.",1,0,1,5,0,0,
09-sep-19,CD. MÉX.,"MIGUEL HGO., CD. MÉX.",1,0,1,0,0,148,
10-sep-19,TAMPS.,"TAMPICO, TAMPS.",1,0,1,0,0,0,
10-sep-19,TAMPS.,"MATAMOROS, TAMPS.",1,0,1,2,0,135,
10-sep-19,TAMPS.,"REYNOSA, TAMPS.",1,0,1,34,0,0,
11-sep-19,CD. MÉX.,"MIGUEL HGO., CD. MÉX.",0,1,1,0,0,0,
11-sep-19,TAMPS.,"TAMPICO, TAMPS.",1,0,1,0,0,0,
12-sep-19,MÉX.,"NEZAHUALCOYOTL, MEX.",1,0,1,0,0,131,
13-sep-19,TAMPS.,"TAMPICO, TAMPS.",1,0,1,0,0,0,
17-sep-19,TAMPS.,"MATAMOROS, TAMPS.",1,0,1,1,0,47,
17-sep-19,CD. MÉX.,"LA MAGDALENA CONTRERAS, CD. MÉX.",1,0,1,0,0,132,
18-sep-19,CD. MÉX.,"LA MAGDALENA CONTRERAS, CD. MÉX.",1,0,1,0,0,100,
18-sep-19,TLAX.,"TLAXCO, TLAX.",0,1,1,0,0,0,
19-sep-19,MÉX.,"AMATEPEC, MEX.",1,0,1,1,0,0,
19-sep-19,COAH.,"MONCLOVA, COAH.",0,1,1,0,0,0,
19-sep-19,MÉX.,"NEZAHUALCOYOTL, MEX.",1,0,1,0,0,808,
19-sep-19,TAMPS.,"REYNOSA, TAMPS.",1,0,1,1,0,0,
20-sep-19,TAMPS.,"REYNOSA, TAMPS.",0,1,1,2,0,33,
20-sep-19,MOR.,"CUERNAVACA, MOR.",0,1,1,2,0,80,
20-sep-19,TAMPS.,"TAMPICO, TAMPS.",1,0,1,0,0,0,
20-sep-19,TLAX.,"TLAXCO, TLAX.",1,0,1,0,0,0,
21-sep-19,COAH.,"MONCLOVA, COAH.",0,1,1,0,0,27,
21-sep-19,TAMPS.,"REYNOSA, TAMPS.",0,1,1,0,0,0,
21-sep-19,MÉX.,"CHICOLOAPAN, MEX.",0,1,1,0,0,0,
23-sep-19,TAMPS.,"MATAMOROS, TAMPS.",1,0,1,0,0,0,
23-sep-19,TAMPS.,"REYNOSA, TAMPS.",1,0,1,0,0,620,
23-sep-19,MÉX.,"HUEHUETOCA, MEX.",1,0,1,0,0,108,
24-sep-19,COAH.,"SALTILLO, COAH.",1,0,1,0,0,133,
24-sep-19,TAMPS.,"TAMPICO, TAMPS.",1,0,1,0,0,0,
24-sep-19,TAMPS.,"REYNOSA, TAMPS.",0,1,1,0,0,0,
25-sep-19,TLAX.,"EL CARMEN TEQUEXQUITLA, TLAX.",1,0,1,0,0,0,
25-sep-19,MÉX.,"HUEHUETOCA, MEX.",1,0,1,0,0,98,
25-sep-19,CD. MÉX.,"IZTAPALAPA, CD. MÉX.",1,0,1,0,0,3127,
25-sep-19,TAMPS.,"REYNOSA, TAMPS.",1,0,1,0,0,0,
26-sep-19,TLAX.,"YAUHQUEMECAN, TLAX.",0,1,1,0,0,0,
26-sep-19,TLAX.,"EL CARMEN TEQUEXQUITLA, TLAX.",1,0,1,0,0,0,
26-sep-19,CHIS.,"TAPACHULA, CHIS.",1,0,1,0,0,295,
26-sep-19,CHIS.,"LAS MARGARITAS, CHIS.",0,1,1,0,0,92,
27-sep-19,CHIS.,"COMITAN DE DOMÍNGUEZ, CHIS.",0,1,1,7,0,136,
27-sep-19,TLAX.,"YAUHQUEMECAN, TLAX.",1,0,1,0,0,0,
27-sep-19,CHIS.,"TAPACHULA, CHIS.",0,1,1,0,0,493,
27-sep-19,CD. MÉX.,"TLALPAN, CD. MÉX.",1,0,1,0,0,3,
28-sep-19,CHIS.,"LAS MARGARITAS, CHIS.",1,0,1,1,0,60,
28-sep-19,TLAX.,"YAUHQUEMECAN, TLAX.",1,0,1,0,0,0,
28-sep-19,TLAX.,"EL CARMEN TEQUEXQUITLA, TLAX.",1,0,1,0,0,0,
29-sep-19,CHIS.,"LAS MARGARITAS, CHIS.",1,0,1,8,0,558,
30-sep-19,TLAX.,"TETLATLAHUCA, TLAX.",1,0,1,0,0,0,
30-sep-19,CD. MÉX.,"IZTAPALAPA, CD. MÉX.",1,0,1,0,0,100,
30-sep-19,MÉX.,"METEPEC, MEX.",1,0,1,0,0,0,
30-sep-19,MÉX.,"TENANCINGO, MEX.",0,1,1,0,0,0,
01-oct-19,TLAX.,"NATIVITAS, TLAX.",0,1,1,0,0,0,
01-oct-19,CD. MÉX.,"LA MAGDALENA CONTRERAS, CD. MÉX.",1,0,1,0,0,175,
01-oct-19,MÉX.,"TENANCINGO, MEX.",1,0,1,0,0,0,
02-oct-19,CD. MÉX.,"IZTAPALAPA, CD. MÉX.",0,1,1,0,0,0,
02-oct-19,TAMPS.,"TAMPICO, TAMPS.",1,0,1,0,0,0,
02-oct-19,MOR.,"EMILIANO ZAPATA, MOR.",1,0,1,9,0,274,
03-oct-19,TLAX.,"TETLATLAHUCA, TLAX.",0,1,1,0,0,0,
03-oct-19,TAMPS.,"REYNOSA, TAMPS.",1,0,1,1,0,26,
03-oct-19,CD. MÉX.,"TLALPAN, CD. MÉX.",1,0,1,0,0,2,
05-oct-19,TLAX.,"NATIVITAS, TLAX.",1,0,1,0,0,0,
05-oct-19,TAB.,"CENTRO, TAB.",1,0,1,0,0,0,
07-oct-19,CD. MÉX.,"IZTACALCO, CD. MÉX.",1,0,1,0,0,0,
07-oct-19,MOR.,"EMILIANO ZAPATA, MOR.",1,0,1,0,0,0,
08-oct-19,TLAX.,"TENANCINGO, TLAX.",1,0,1,0,0,0,
09-oct-19,TLAX.,"PANOTLA, TLAX.",1,0,1,0,0,0,
09-oct-19,CD. MÉX.,"IZTACALCO, CD. MÉX.",1,0,1,0,0,15,
10-oct-19,CD. MÉX.,"IZTAPALAPA, CD. MÉX.",0,1,1,0,0,0,
10-oct-19,B.C.S.,"LA PAZ, B.C.S.",1,0,1,0,0,0,
10-oct-19,MÉX.,"METEPEC, MEX.",1,0,1,0,0,0,
10-oct-19,MÉX.,"OTUMBA, MEX.",1,0,1,0,0,0,
10-oct-19,CHIS.,"COMITAN DE DOMÍNGUEZ, CHIS.",1,0,1,0,0,0,
11-oct-19,TLAX.,"TENANCINGO, TLAX.",1,0,1,0,0,0,
11-oct-19,TLAX.,"PAPALOTLA DE XICOHTENCATL, TLAX.",1,0,1,0,0,0,
11-oct-19,COL.,"COL., COL.",1,0,1,0,0,0,
12-oct-19,MÉX.,"OTUMBA, MEX.",0,1,1,0,0,250,
14-oct-19,MÉX.,"TENANGO DEL AIRE, MEX.",1,0,1,0,0,82,
14-oct-19,CD. MÉX.,"CUAJIMALPA DE MOR., CD. MÉX.",1,0,1,0,0,0,
15-oct-19,MÉX.,"ZINACANTEPEC, MEX.",0,1,1,0,13,2564,
15-oct-19,VER.,"IXHUATLAN DEL CAFE, VER.",1,0,1,0,0,0,
15-oct-19,ZAC.,"ZAC., ZAC.",1,0,1,11,0,316,
15-oct-19,ZAC.,"FRESNILLO, ZAC.",0,1,1,0,0,0,
16-oct-19,ZAC.,"GUADALUPE, ZAC.",1,0,1,0,0,0,
16-oct-19,ZAC.,"FRESNILLO, ZAC.",1,0,1,8,0,0,
16-oct-19,MÉX.,"TENANGO DEL AIRE, MEX.",1,0,1,0,0,3,
17-oct-19,MÉX.,"IXTAPALUCA, MEX.",1,0,1,0,0,102,
17-oct-19,CHIS.,"COMITAN DE DOMÍNGUEZ, CHIS.",1,0,1,0,0,0,
18-oct-19,B.C.S.,"LA PAZ, B.C.S.",1,0,1,0,0,0,
18-oct-19,ZAC.,"FRESNILLO, ZAC.",1,0,1,0,0,0,
21-oct-19,ZAC.,"FRESNILLO, ZAC.",1,0,1,0,0,8,
21-oct-19,CHIS.,"JIQUIPILAS, CHIS.",1,0,1,0,0,323,
21-oct-19,MOR.,"EMILIANO ZAPATA, MOR.",1,0,1,14,0,10,
21-oct-19,TLAX.,"CUAPIAXTLA, TLAX.",1,0,1,0,0,0,
22-oct-19,COAH.,"SALTILLO, COAH.",1,0,1,6,1,325,
22-oct-19,TLAX.,"ALTZAYANCA, TLAX.",1,0,1,0,0,0,
22-oct-19,TLAX.,"CUAPIAXTLA, TLAX.",1,0,1,0,0,0,
22-oct-19,TAB.,"CENTRO, TAB.",1,0,1,0,0,0,
22-oct-19,MÉX.,"CHALCO, MEX.",1,0,1,0,2,261,
23-oct-19,ZAC.,"ZAC., ZAC.",1,0,1,0,0,0,
24-oct-19,CD. MÉX.,"AZCAPOTZALCO, CD. MÉX.",0,1,1,0,0,633,
24-oct-19,TLAX.,"ALTZAYANCA, TLAX.",0,1,1,0,0,0,
25-oct-19,CD. MÉX.,"AZCAPOTZALCO, CD. MÉX.",0,1,1,0,0,0,
25-oct-19,COL.,"COL., COL.",0,1,1,0,0,0,
25-oct-19,CHIS.,"LA INDEPENDENCIA, CHIS.",0,1,1,0,0,0,
28-oct-19,CHIS.,"JIQUIPILAS, CHIS.",1,0,1,1,0,170,
28-oct-19,CD. MÉX.,"TLAHUAC, CD. MÉX.",1,0,1,0,0,6,
28-oct-19,VER.,"TUXPAM, VER.",1,0,1,0,0,0,
28-oct-19,MÉX.,"TEXCOCO, MEX.",1,0,1,1,1,12,
28-oct-19,MÉX.,"CHALCO, MEX.",0,1,1,0,0,1000,
29-oct-19,B.C.S.,"LOS CABOS, B.C.S.",1,0,1,0,0,0,
29-oct-19,CHIS.,"LA INDEPENDENCIA, CHIS.",0,1,1,0,0,0,
29-oct-19,VER.,"TUXPAM, VER.",1,0,1,0,0,0,
29-oct-19,CD. MÉX.,"TLAHUAC, CD. MÉX.",1,0,1,0,0,0,
30-oct-19,TLAX.,"XALOZTOC, TLAX.",1,0,1,0,0,0,
31-oct-19,MÉX.,"TEXCOCO, MEX.",1,0,1,1,7,85,
31-oct-19,MÉX.,"CHALCO, MEX.",1,0,1,0,0,366,
31-oct-19,VER.,"COSOLEACAQUE, VER.",1,0,1,1,0,37,
01-nov-19,VER.,"COSOLEACAQUE, VER.",1,0,1,0,0,0,
04-nov-19,MÉX.,"CHAPA DE MOTA, MEX.",0,1,1,0,0,0,
04-nov-19,MÉX.,"TEXCOCO, MEX.",1,0,1,0,0,313,
04-nov-19,MÉX.,"LA PAZ, MEX.",1,0,1,0,1,63,
04-nov-19,TLAX.,"LAZARO CARDENAS, TLAX.",1,0,1,0,0,0,
05-nov-19,MÉX.,"SAN MATEO ATENCO, MEX.",1,0,1,0,0,0,
05-nov-19,TAB.,"CENTRO, TAB.",1,0,1,0,0,8,
06-nov-19,TLAX.,"EMILIANO ZAPATA, TLAX.",0,1,1,0,0,0,
07-nov-19,MÉX.,"CHAPA DE MOTA, MEX.",1,0,1,0,0,0,
07-nov-19,CD. MÉX.,"TLAHUAC, CD. MÉX.",1,0,1,0,0,100,
07-nov-19,CHIH.,"CASAS GRANDES, CHIH.",0,1,1,0,0,310,
07-nov-19,TAB.,"CARDENAS, TAB.",1,0,1,0,0,0,
08-nov-19,CD. MÉX.,"TLAHUAC, CD. MÉX.",1,0,1,0,0,6,
08-nov-19,MÉX.,"TEXCOCO, MEX.",1,0,1,0,0,207,
08-nov-19,MÉX.,"CHAPA DE MOTA, MEX.",1,0,1,0,0,0,
09-nov-19,MÉX.,"CHAPA DE MOTA, MEX.",1,0,1,0,0,0,
09-nov-19,MÉX.,"TEXCOCO, MEX.",1,0,1,0,0,13,
11-nov-19,CD. MÉX.,"CUAUHTEMOC, CD. MÉX.",1,0,1,0,0,0,
12-nov-19,TLAX.,"TEOLOCHOLCO, TLAX.",1,0,1,0,0,0,
13-nov-19,COAH.,"SALTILLO, COAH.",1,0,1,2,0,1342,
13-nov-19,VER.,"VILLA ALDAMA, VER.",0,1,1,0,0,0,
14-nov-19,CHIS.,"CINTALAPA, CHIS.",1,0,1,0,0,164,
14-nov-19,CHIS.,"CHILÓN, CHIS.",1,0,1,0,0,0,
14-nov-19,MÉX.,"CUAUTITLAN IZCALLI, MEX.",0,1,1,0,1,225,
15-nov-19,CD. MÉX.,"CUAUHTEMOC, CD. MÉX.",1,0,1,0,0,0,
15-nov-19,MÉX.,"CUAUTITLAN, MEX.",1,0,1,0,0,109,
15-nov-19,CHIS.,"CINTALAPA, CHIS.",1,0,1,0,0,458,
15-nov-19,CHIS.,"CHILÓN, CHIS.",0,1,1,0,0,200,
15-nov-19,MÉX.,"EL ORO, MEX.",1,0,1,0,0,0,
15-nov-19,MÉX.,"EL ORO, MEX.",1,0,1,0,0,0,
15-nov-19,CHIS.,"SUCHIATE, CHIS.",1,0,1,0,0,6,
16-nov-19,CHIS.,"VILLAFLORES, CHIS.",0,1,1,0,0,0,
16-nov-19,CHIS.,"COMITAN DE DOMÍNGUEZ, CHIS.",0,1,1,0,0,0,
17-nov-19,CHIS.,"COMITAN DE DOMÍNGUEZ, CHIS.",1,0,1,0,1,160,
19-nov-19,TLAX.,"HUEYOTLIPAN, TLAX.",1,0,1,0,0,0,
20-nov-19,CD. MÉX.,"COYOACAN, CD. MÉX.",0,1,1,0,0,86,
20-nov-19,MÉX.,"COYOTEPEC, MEX.",1,0,1,0,0,248,
21-nov-19,CD. MÉX.,"COYOACAN, CD. MÉX.",1,0,1,0,0,870,
21-nov-19,MÉX.,"ALMOLOYA DE JUAREZ, MEX.",0,1,1,0,0,0,
21-nov-19,TAB.,"CENTRO, TAB.",0,1,1,0,0,0,
22-nov-19,MOR.,"JIUTEPEC, MOR.",0,1,1,1,0,0,
22-nov-19,CD. MÉX.,"IZTAPALAPA, CD. MÉX.",1,0,1,0,0,0,
25-nov-19,CD. MÉX.,"CUAUHTEMOC, CD. MÉX.",1,0,1,0,0,0,
26-nov-19,MOR.,"JIUTEPEC, MOR.",1,0,1,1,0,34,
27-nov-19,S.L.P.,"TAMAZUNCHALE, S.L.P.",1,0,1,0,0,0,
27-nov-19,S.L.P.,"SAN LUIS POTOSI, S.L.P.",1,0,1,0,0,0,
27-nov-19,CD. MÉX.,"XOCHIMILCO, CD. MÉX.",1,0,1,0,0,22,
27-nov-19,MOR.,"JIUTEPEC, MOR.",1,0,1,0,0,0,
28-nov-19,S.L.P.,"SAN LUIS POTOSI, S.L.P.",1,0,1,10,0,0,
28-nov-19,MOR.,"JIUTEPEC, MOR.",0,1,1,0,0,0,
28-nov-19,ZAC.,"ZAC., ZAC.",1,0,1,0,0,0,
29-nov-19,ZAC.,"GUADALUPE, ZAC.",0,1,1,15,0,0,
29-nov-19,S.L.P.,"TAMAZUNCHALE, S.L.P.",1,0,1,0,0,0,
29-nov-19,CD. MÉX.,"XOCHIMILCO, CD. MÉX.",1,0,1,0,0,0,
30-nov-19,S.L.P.,"SAN LUIS POTOSI, S.L.P.",1,0,1,8,3,0,
01-dic-19,S.L.P.,"SAN LUIS POTOSI, S.L.P.",1,0,1,0,0,0,
02-dic-19,ZAC.,"GUADALUPE, ZAC.",1,0,1,1,0,120,
02-dic-19,ZAC.,"FRESNILLO, ZAC.",1,0,1,1,0,1,
02-dic-19,B.C.,"TIJUANA, B.C.",1,0,1,2,0,57,
03-dic-19,ZAC.,"ZAC., ZAC.",1,0,1,0,0,0,
03-dic-19,COAH.,"RAMOS ARIZPE, COAH.",1,0,1,1,0,0,
03-dic-19,S.L.P.,"SOLEDAD DE GRACIANO SANCHEZ, S.L.P.",1,0,1,1,0,18,
04-dic-19,ZAC.,"GUADALUPE, ZAC.",1,0,1,3,0,21,
05-dic-19,ZAC.,"GUADALUPE, ZAC.",1,0,1,17,0,48,
05-dic-19,S.L.P.,"SAN LUIS POTOSI, S.L.P.",1,0,1,14,2,0,
05-dic-19,S.L.P.,"SOLEDAD DE GRACIANO SANCHEZ, S.L.P.",1,0,1,0,0,0,
05-dic-19,CD. MÉX.,"XOCHIMILCO, CD. MÉX.",0,1,1,0,0,140,
06-dic-19,ZAC.,"FRESNILLO, ZAC.",1,0,1,0,0,0,
06-dic-19,JAL.,"GUADALAJARA, JAL.",1,0,1,0,0,0,
07-dic-19,JAL.,"GUADALAJARA, JAL.",1,0,1,0,0,0,
09-dic-19,GTO.,"LEON, GTO.",0,1,1,0,0,0,
09-dic-19,CD. MÉX.,"IZTACALCO, CD. MÉX.",0,1,1,0,0,0,
09-dic-19,S.L.P.,"CIUDAD VALLES, S.L.P.",1,0,1,1,0,0,
10-dic-19,CD. MÉX.,"IZTACALCO, CD. MÉX.",1,0,1,0,0,129,
10-dic-19,JAL.,"SAN MARTIN HGO., JAL.",1,0,1,0,0,0,
10-dic-19,S.L.P.,"CIUDAD VALLES, S.L.P.",0,1,1,2,0,0,
10-dic-19,S.L.P.,"SOLEDAD DE GRACIANO SANCHEZ, S.L.P.",1,0,1,0,2,0,
11-dic-19,ZAC.,"FRESNILLO, ZAC.",1,0,1,4,0,107,
11-dic-19,CD. MÉX.,"IZTACALCO, CD. MÉX.",1,0,1,0,0,86,
11-dic-19,CD. MÉX.,"MIGUEL HGO., CD. MÉX.",1,0,1,0,0,5702,
11-dic-19,B.C.,"TIJUANA, B.C.",0,1,1,0,0,0,
12-dic-19,CD. MÉX.,"MIGUEL HGO., CD. MÉX.",0,1,1,0,0,0,
12-dic-19,JAL.,"GUADALAJARA, JAL.",0,1,1,0,0,0,
13-dic-19,N.L.,"GUADALUPE, N.L.",1,0,1,50,1,0,
14-dic-19,JAL.,"GUADALAJARA, JAL.",1,0,1,0,0,51,
15-dic-19,S.L.P.,"SAN LUIS POTOSI, S.L.P.",1,0,1,0,0,0,
15-dic-19,JAL.,"GUADALAJARA, JAL.",1,0,1,0,0,51,
16-dic-19,CD. MÉX.,"MIGUEL HGO., CD. MÉX.",1,0,1,0,3,1659,
17-dic-19,CD. MÉX.,"MIGUEL HGO., CD. MÉX.",0,1,1,0,0,0,
18-dic-19,B.C.,"ENSENADA, B.C.",1,0,1,0,0,0,
19-dic-19,JAL.,"GUADALAJARA, JAL.",1,0,1,0,0,0,
22-dic-19,S.L.P.,"CIUDAD VALLES, S.L.P.",1,0,1,0,0,0,
24-dic-19,S.L.P.,"SOLEDAD DE GRACIANO SANCHEZ, S.L.P.",1,0,1,0,2,0,
24-dic-19,S.L.P.,"CIUDAD VALLES, S.L.P.",0,1,1,2,0,0,
25-dic-19,S.L.P.,"CIUDAD VALLES, S.L.P.",1,0,1,1,1,0,
26-dic-19,S.L.P.,"CIUDAD VALLES, S.L.P.",0,1,1,0,0,0,
15-ene-20,SON.,"HERMOSILLO, SON.",1,0,1,0,0,0,
16-ene-20,B.C.,"TIJUANA, B.C.",1,0,1,0,0,0,
18-ene-20,CHIS.,"TAPACHULA, CHIS.",0,1,1,0,0,351,
18-ene-20,B.C.,"TIJUANA, B.C.",1,0,1,0,0,0,
22-ene-20,CHIS.,"COPAINALÁ, CHIS.",0,1,1,0,1,23,
22-ene-20,ZAC.,"GUADALUPE, ZAC.",1,0,1,10,0,358,
23-ene-20,CHIS.,"TAPACHULA, CHIS.",1,0,1,0,0,119,
23-ene-20,ZAC.,"GUADALUPE, ZAC.",1,0,1,1,0,0,
23-ene-20,ZAC.,"FRESNILLO, ZAC.",1,0,1,2,0,168,
24-ene-20,ZAC.,"GUADALUPE, ZAC.",1,0,1,2,0,250,
24-ene-20,ZAC.,"FRESNILLO, ZAC.",1,0,1,0,0,12,
27-ene-20,ZAC.,"FRESNILLO, ZAC.",1,0,1,0,0,0,
28-ene-20,ZAC.,"GUADALUPE, ZAC.",1,0,1,6,0,0,
28-ene-20,ZAC.,"ZAC., ZAC.",1,0,1,0,0,0,
28-ene-20,VER.,"MINATITLAN, VER.",1,0,1,0,0,0,
29-ene-20,CD. MÉX.,"MILPA ALTA, CD. MÉX.",1,0,1,0,0,50,
29-ene-20,ZAC.,"GUADALUPE, ZAC.",0,1,1,1,0,6,
29-ene-20,ZAC.,"ZAC., ZAC.",1,0,1,0,0,0,
31-ene-20,ZAC.,"GUADALUPE, ZAC.",0,1,1,0,0,167,
31-ene-20,CD. MÉX.,"IZTAPALAPA, CD. MÉX.",1,0,1,0,0,0,
04-feb-20,ZAC.,"GUADALUPE, ZAC.",1,0,1,16,0,0,
04-feb-20,ZAC.,"FRESNILLO, ZAC.",1,0,1,0,0,0,
04-feb-20,CD. MÉX.,"MILPA ALTA, CD. MÉX.",0,1,1,0,0,0,
04-feb-20,ZAC.,"GUADALUPE, ZAC.",0,1,1,0,0,0,
04-feb-20,ZAC.,"FRESNILLO, ZAC.",1,0,1,0,0,0,
05-feb-20,CD. MÉX.,"GUSTAVO A. MADERO, CD. MÉX.",1,0,1,0,0,14,
05-feb-20,ZAC.,"ZAC., ZAC.",1,0,1,0,0,0,
06-feb-20,ZAC.,"ZAC., ZAC.",1,0,1,9,0,62,
06-feb-20,COAH.,"MÚZQUIZ, COAH.",1,0,1,0,0,0,
07-feb-20,ZAC.,"GUADALUPE, ZAC.",1,0,1,1,0,640,
07-feb-20,ZAC.,"FRESNILLO, ZAC.",1,0,1,0,0,0,
11-feb-20,CD. MÉX.,"CUAUHTEMOC, CD. MÉX.",0,1,1,0,0,80,
11-feb-20,CD. MÉX.,"IZTAPALAPA, CD. MÉX.",1,0,1,0,0,35,
12-feb-20,SIN.,"GUASAVE, SIN.",1,0,1,0,0,0,
13-feb-20,SIN.,"CULIACAN, SIN.",1,0,1,0,0,0,
13-feb-20,SIN.,"SALVADOR ALVARADO, SIN.",1,0,1,0,0,0,
13-feb-20,SON.,"CAJEME, SON.",1,0,1,0,0,0,
14-feb-20,SON.,"HERMOSILLO, SON.",1,0,1,0,0,68,
16-feb-20,CHIH.,"ALDAMA, CHIH.",1,0,1,0,0,0,
17-feb-20,CD. MÉX.,"TLALPAN, CD. MÉX.",0,1,1,0,0,0,
17-feb-20,CD. MÉX.,"IZTAPALAPA, CD. MÉX.",1,0,1,0,0,0,
17-feb-20,SIN.,"MOCORITO, SIN.",1,0,1,0,0,0,
17-feb-20,SIN.,"ELOTA, SIN.",1,0,1,0,0,0,
17-feb-20,NAY.,"TEPIC, NAY.",1,0,1,1,0,0,
18-feb-20,CD. MÉX.,"TLALPAN, CD. MÉX.",1,0,1,0,0,201,
18-feb-20,SIN.,"CULIACAN, SIN.",1,0,1,0,0,0,
18-feb-20,NAY.,"TEPIC, NAY.",1,0,1,0,89,396,
19-feb-20,TAB.,"MACUSPANA, TAB.",1,0,1,0,0,0,
19-feb-20,NAY.,"TEPIC, NAY.",1,0,1,0,0,0,
20-feb-20,CD. MÉX.,"CUAUHTEMOC, CD. MÉX.",1,0,1,0,0,100,
20-feb-20,SON.,"HERMOSILLO, SON.",1,0,1,0,0,0,
20-feb-20,SON.,"CAJEME, SON.",1,0,1,1,0,0,
20-feb-20,COAH.,"FRANCISCO I. MADERO, COAH.",0,1,1,1,0,0,
20-feb-20,SIN.,"CULIACAN, SIN.",1,0,1,0,0,0,
20-feb-20,ZAC.,"GUADALUPE, ZAC.",1,0,1,0,0,0,
20-feb-20,ZAC.,"JEREZ, ZAC.",1,0,1,0,0,3,
21-feb-20,SIN.,"CULIACAN, SIN.",0,1,1,0,1,0,
21-feb-20,SIN.,"NAVOLATO, SIN.",0,1,1,0,0,0,
21-feb-20,SIN.,"ELOTA, SIN.",0,1,1,0,0,0,
22-feb-20,COAH.,"PIEDRAS NEGRAS, COAH.",1,0,1,3,0,126,
24-feb-20,TAB.,"MACUSPANA, TAB.",0,1,1,0,0,0,
24-feb-20,COAH.,"SALTILLO, COAH.",1,0,1,1,1,610,
24-feb-20,SIN.,"BADIRAGUATO, SIN.",1,0,1,0,0,0,
24-feb-20,ZAC.,"FRESNILLO, ZAC.",0,1,1,1,0,134,
24-feb-20,CD. MÉX.,"XOCHIMILCO, CD. MÉX.",1,0,1,0,0,754,
24-feb-20,CD. MÉX.,"IZTAPALAPA, CD. MÉX.",1,0,1,0,0,23,
25-feb-20,CD. MÉX.,"TLALPAN, CD. MÉX.",1,0,1,0,1,0,
25-feb-20,ZAC.,"GUADALUPE, ZAC.",1,0,1,0,0,0,
25-feb-20,ZAC.,"ZAC., ZAC.",1,0,1,0,1,69,
26-feb-20,ZAC.,"GUADALUPE, ZAC.",1,0,1,1,0,15,
26-feb-20,CHIS.,"SAN CRISTOBAL DE LAS CASAS, CHIS.",1,0,1,0,0,1277,
26-feb-20,CD. MÉX.,"XOCHIMILCO, CD. MÉX.",1,0,1,0,0,277,
26-feb-20,SON.,"CAJEME, SON.",1,0,1,0,0,0,
26-feb-20,COAH.,"TORREÓN, COAH.",0,1,1,2,0,338,
26-feb-20,COAH.,"PIEDRAS NEGRAS, COAH.",0,1,1,0,0,24,
27-feb-20,SON.,"CAJEME, SON.",0,1,1,0,0,0,
27-feb-20,ZAC.,"GUADALUPE, ZAC.",1,0,1,0,0,0,
27-feb-20,ZAC.,"ZAC., ZAC.",0,1,1,0,0,0,
27-feb-20,SIN.,"CHOIX, SIN.",0,1,1,0,0,0,
27-feb-20,COAH.,"FRANCISCO I. MADERO, COAH.",0,1,1,0,0,0,
27-feb-20,COAH.,"PIEDRAS NEGRAS, COAH.",0,1,1,0,0,17,
27-feb-20,COAH.,"MÚZQUIZ, COAH.",1,0,1,8,0,0,
28-feb-20,SIN.,"BADIRAGUATO, SIN.",0,1,1,0,4,0,
28-feb-20,ZAC.,"FRESNILLO, ZAC.",0,1,1,0,0,2,
28-feb-20,CD. MÉX.,"XOCHIMILCO, CD. MÉX.",1,0,1,0,0,0,
28-feb-20,CD. MÉX.,"BENITO JUAREZ, CD. MÉX.",0,1,1,0,0,9,
28-feb-20,COAH.,"MÚZQUIZ, COAH.",1,0,1,4,1,170,
28-feb-20,COAH.,"ACUÑA, COAH.",1,0,1,0,1,109,
02-mar-20,NAY.,"TEPIC, NAY.",0,1,1,0,0,0,
03-mar-20,SIN.,"ANGOSTURA, SIN.",1,0,1,0,0,0,
04-mar-20,NAY.,"XALISCO, NAY.",1,0,1,0,20,0,
05-mar-20,SIN.,"ANGOSTURA, SIN.",1,0,1,0,3,0,
05-mar-20,CD. MÉX.,"XOCHIMILCO, CD. MÉX.",1,0,1,0,0,300,
05-mar-20,COAH.,"PIEDRAS NEGRAS, COAH.",0,1,1,0,0,0,
05-mar-20,COAH.,"MÚZQUIZ, COAH.",0,1,1,3,0,31,
10-mar-20,CD. MÉX.,"CUAJIMALPA DE MOR., CD. MÉX.",1,0,1,0,0,0,
10-mar-20,VER.,"COATZACOALCOS, VER.",1,0,1,0,0,53,
10-mar-20,SIN.,"AHOME, SIN.",0,1,1,0,0,0,
10-mar-20,COAH.,"TORREÓN, COAH.",1,0,1,0,0,0,
10-mar-20,COAH.,"SALTILLO, COAH.",1,0,1,0,0,165,
11-mar-20,ZAC.,"ZAC., ZAC.",1,0,1,1,0,172,
11-mar-20,S.L.P.,"CIUDAD VALLES, S.L.P.",0,1,1,0,0,0,
11-mar-20,S.L.P.,"SAN LUIS POTOSI, S.L.P.",1,0,1,0,0,0,
11-mar-20,COAH.,"MÚZQUIZ, COAH.",0,1,1,0,0,0,
11-mar-20,NAY.,"XALISCO, NAY.",0,1,1,0,0,0,
11-mar-20,NAY.,"HUAJICORI, NAY.",1,0,1,0,0,0,
12-mar-20,COAH.,"SALTILLO, COAH.",1,0,1,7,0,77,
12-mar-20,COAH.,"MÚZQUIZ, COAH.",1,0,1,0,0,0,
13-mar-20,S.L.P.,"CIUDAD VALLES, S.L.P.",1,0,1,2,0,0,
13-mar-20,S.L.P.,"SAN LUIS POTOSI, S.L.P.",1,0,1,0,0,0,
13-mar-20,S.L.P.,"SOLEDAD DE GRACIANO SANCHEZ, S.L.P.",0,1,1,0,0,0,
13-mar-20,S.L.P.,"MATEHUALA, S.L.P.",1,0,1,0,0,0,
13-mar-20,VER.,"COATZACOALCOS, VER.",1,0,1,2,0,677,
13-mar-20,NAY.,"XALISCO, NAY.",0,1,1,0,0,0,
14-mar-20,S.L.P.,"MATEHUALA, S.L.P.",1,0,1,0,0,0,
14-mar-20,VER.,"VER., VER.",1,0,1,0,0,2289,
15-mar-20,S.L.P.,"SAN LUIS POTOSI, S.L.P.",1,0,1,25,0,0,
16-mar-20,VER.,"XALAPA, VER.",0,1,1,49,0,1193,
16-mar-20,S.L.P.,"CIUDAD VALLES, S.L.P.",1,0,1,0,0,0,
16-mar-20,S.L.P.,"MATEHUALA, S.L.P.",0,1,1,0,0,0,
17-mar-20,VER.,"VER., VER.",1,0,1,3,0,5526,
19-mar-20,NAY.,"XALISCO, NAY.",1,0,1,0,0,0,
19-mar-20,VER.,"VER., VER.",1,0,1,2,0,20817,
20-mar-20,S.L.P.,"SAN LUIS POTOSI, S.L.P.",0,1,1,0,0,1549,
20-mar-20,VER.,"COATZACOALCOS, VER.",1,0,1,2,0,204,
23-mar-20,COAH.,"SALTILLO, COAH.",1,0,1,0,0,0,
23-mar-20,COAH.,"MONCLOVA, COAH.",1,0,1,0,0,0,
25-mar-20,COAH.,"PIEDRAS NEGRAS, COAH.",1,0,1,2,0,15,
25-mar-20,S.L.P.,"SAN LUIS POTOSI, S.L.P.",1,0,1,7,1,0,
21-jul-20,CD. MÉX.,"GUSTAVO A. MADERO, CD. MÉX.",1,0,1,0,0,0,
22-jul-20,CD. MÉX.,"CUAUHTEMOC, CD. MÉX.",1,0,1,0,0,148,
22-jul-20,CD. MÉX.,"GUSTAVO A. MADERO, CD. MÉX.",1,0,1,0,0,0,
27-jul-20,CD. MÉX.,"GUSTAVO A. MADERO, CD. MÉX.",1,0,1,0,0,0,
11-ago-20,CD. MÉX.,"CUAUHTEMOC, CD. MÉX.",0,1,1,0,0,254,
12-ago-20,CD. MÉX.,"CUAUHTEMOC, CD. MÉX.",1,0,1,0,0,0,
14-ago-20,CD. MÉX.,"GUSTAVO A. MADERO, CD. MÉX.",1,0,1,0,0,45,
18-ago-20,CD. MÉX.,"GUSTAVO A. MADERO, CD. MÉX.",1,0,1,0,4,0,
20-ago-20,CD. MÉX.,"GUSTAVO A. MADERO, CD. MÉX.",1,0,1,0,0,0,
26-ago-20,CD. MÉX.,"CUAUHTEMOC, CD. MÉX.",1,0,1,0,1,18,
27-ago-20,CD. MÉX.,"CUAUHTEMOC, CD. MÉX.",1,0,1,0,0,23,
28-ago-20,CD. MÉX.,"GUSTAVO A. MADERO, CD. MÉX.",1,0,1,0,0,1275,
01-sep-20,CD. MÉX.,"CUAUHTEMOC, CD. MÉX.",1,0,1,0,0,109,
04-sep-20,CD. MÉX.,"GUSTAVO A. MADERO, CD. MÉX.",1,0,1,0,0,0,
19-sep-20,VER.,"MARTINEZ DE LA TORRE, VER.",1,0,1,0,0,0,
22-sep-20,CD. MÉX.,"CUAUHTEMOC, CD. MÉX.",1,0,1,0,0,0,
23-sep-20,VER.,"MARTINEZ DE LA TORRE, VER.",1,0,1,0,0,0,
24-sep-20,VER.,"MARTINEZ DE LA TORRE, VER.",1,0,1,0,0,700,
25-sep-20,VER.,"MARTINEZ DE LA TORRE, VER.",1,0,1,0,0,9,
30-sep-20,VER.,"CORDOBA, VER.",1,0,1,0,0,2110,
01-oct-20,VER.,"VEGA DE ALATORRE, VER.",1,0,1,0,3,176,
02-oct-20,CD. MÉX.,"GUSTAVO A. MADERO, CD. MÉX.",1,0,1,0,0,0,
02-oct-20,CD. MÉX.,"CUAUHTEMOC, CD. MÉX.",0,1,1,0,0,0,
05-oct-20,CD. MÉX.,"GUSTAVO A. MADERO, CD. MÉX.",1,0,1,0,0,0,
14-oct-20,CD. MÉX.,"GUSTAVO A. MADERO, CD. MÉX.",1,0,1,0,0,0,
19-oct-20,CD. MÉX.,"CUAUHTEMOC, CD. MÉX.",1,0,1,0,0,0,
20-oct-20,CD. MÉX.,"CUAUHTEMOC, CD. MÉX.",1,0,1,0,0,0,
21-oct-20,CD. MÉX.,"CUAUHTEMOC, CD. MÉX.",1,0,1,0,0,135,
29-oct-20,CD. MÉX.,"TLALPAN, CD. MÉX.",1,0,1,0,0,0,
30-oct-20,VER.,"VEGA DE ALATORRE, VER.",0,1,1,0,0,75,
04-nov-20,CD. MÉX.,"GUSTAVO A. MADERO, CD. MÉX.",0,1,1,0,0,199,
04-nov-20,VER.,"COATEPEC, VER.",1,0,1,1,0,564,
05-nov-20,CD. MÉX.,"TLALPAN, CD. MÉX.",1,0,1,0,0,1843,
09-nov-20,VER.,"COATEPEC, VER.",1,0,1,1,0,11604,
10-nov-20,CD. MÉX.,"GUSTAVO A. MADERO, CD. MÉX.",0,1,1,0,0,7762,
11-nov-20,VER.,"COATEPEC, VER.",1,0,1,0,0,6549,
12-nov-20,CD. MÉX.,"MIGUEL HGO., CD. MÉX.",0,1,1,0,0,0,
13-nov-20,VER.,"COATEPEC, VER.",1,0,1,0,0,4205,
17-nov-20,CD. MÉX.,"CUAUHTEMOC, CD. MÉX.",1,0,1,0,0,0,
24-nov-20,CD. MÉX.,"BENITO JUAREZ, CD. MÉX.",1,0,1,0,0,0,
27-nov-20,CD. MÉX.,"CUAUHTEMOC, CD. MÉX.",0,1,1,0,0,0,
30-nov-20,CD. MÉX.,"BENITO JUAREZ, CD. MÉX.",1,0,1,0,0,37,
30-nov-20,CD. MÉX.,"CUAUHTEMOC, CD. MÉX.",1,0,1,0,0,0,
01-dic-20,CD. MÉX.,"GUSTAVO A. MADERO, CD. MÉX.",0,1,1,0,0,0,
03-dic-20,CD. MÉX.,"CUAUHTEMOC, CD. MÉX.",1,0,1,0,0,79,
07-dic-20,CD. MÉX.,"VENUSTIANO CARRANZA, CD. MÉX.",1,0,1,0,0,0,
18-dic-20,CD. MÉX.,"VENUSTIANO CARRANZA, CD. MÉX.",1,0,1,0,15,4163,
14-jun-21,CD. MÉX.,"GUSTAVO A. MADERO, CD. MÉX.",1,0,1,0,0,0,
15-jun-21,CD. MÉX.,"CUAUHTEMOC, CD. MÉX.",1,0,1,0,0,0,
16-jun-21,CD. MÉX.,"GUSTAVO A. MADERO, CD. MÉX.",1,0,1,0,0,36,
17-jun-21,CD. MÉX.,"IZTAPALAPA, CD. MÉX.",0,1,1,0,0,0,
17-jun-21,CD. MÉX.,"ALVARO OBREGON, CD. MÉX.",1,0,1,0,0,206,
11-jul-21,VER.,"POZA RICA DE HGO., VER.",0,1,1,0,0,6674,
12-jul-21,VER.,"MARTINEZ DE LA TORRE, VER.",1,0,1,0,0,60,
12-jul-21,VER.,"POZA RICA DE HGO., VER.",1,0,1,1,1,1098,
13-jul-21,VER.,"POZA RICA DE HGO., VER.",1,0,1,0,0,39,
14-jul-21,COAH.,"SABINAS, COAH.",0,1,1,1,0,434,
14-jul-21,COAH.,"ACUÑA, COAH.",0,1,1,0,0,0,
15-jul-21,COAH.,"SABINAS, COAH.",1,0,1,0,0,68,
15-jul-21,VER.,"ALAMO, VER.",1,0,1,0,0,0,
16-jul-21,COAH.,"SAN PEDRO, COAH.",1,0,1,0,0,1,
16-jul-21,VER.,"MARTINEZ DE LA TORRE, VER.",0,1,1,0,0,1823,
19-jul-21,VER.,"MARTINEZ DE LA TORRE, VER.",0,1,1,0,0,95,
19-jul-21,COAH.,"SAN PEDRO, COAH.",1,0,1,0,0,3,
20-jul-21,VER.,"MARTINEZ DE LA TORRE, VER.",0,1,1,12,0,2808,
20-jul-21,COAH.,"TORREÓN, COAH.",0,1,1,0,0,0,
20-jul-21,VER.,"POZA RICA DE HGO., VER.",0,1,1,2,1,19,
20-jul-21,COAH.,"RAMOS ARIZPE, COAH.",1,0,1,0,0,28,
20-jul-21,COAH.,"SALTILLO, COAH.",1,0,1,0,0,0,
20-jul-21,COAH.,"SAN PEDRO, COAH.",0,1,1,0,0,0,
21-jul-21,VER.,"MINATITLAN, VER.",1,0,1,0,0,8509,
22-jul-21,COAH.,"ACUÑA, COAH.",0,1,1,0,0,0,
23-jul-21,VER.,"MINATITLAN, VER.",1,0,1,2,0,831,
20-sep-21,B.C.,"SAN QUINTÍN, B.C.",0,1,1,0,0,0,
23-sep-21,CHIH.,"CUAUHTÉMOC, CHIH.",0,1,1,0,1,27,
27-sep-21,CHIH.,"HGO. DEL PARRAL, CHIH.",1,0,1,0,0,164,
29-sep-21,CHIH.,"HGO. DEL PARRAL, CHIH.",1,0,1,0,0,144,
30-sep-21,B.C.,"SAN QUINTÍN, B.C.",0,1,1,0,0,0,
07-oct-21,B.C.,"SAN QUINTÍN, B.C.",0,1,1,1,0,0,
08-oct-21,B.C.,"ENSENADA, B.C.",1,0,1,7,0,96,
15-oct-21,B.C.,"SAN FELIPE, B.C.",1,0,1,0,0,0,
19-oct-21,B.C.,"SAN FELIPE, B.C.",1,0,1,0,0,0,
19-oct-21,B.C.,"TIJUANA, B.C.",1,0,1,0,0,0,
21-oct-21,CD. MÉX.,"IZTACALCO, CD. MÉX.",1,0,1,0,0,623,
22-oct-21,CD. MÉX.,"BENITO JUAREZ, CD. MÉX.",1,0,1,0,0,0,
25-oct-21,CD. MÉX.,"TLALPAN, CD. MÉX.",1,0,1,0,0,147,
01-nov-21,CD. MÉX.,"BENITO JUAREZ, CD. MÉX.",1,0,1,0,0,0,
01-nov-21,CD. MÉX.,"BENITO JUAREZ, CD. MÉX.",1,0,1,0,0,0,
03-nov-21,CD. MÉX.,"COYOACAN, CD. MÉX.",1,0,1,1,0,497,
03-nov-21,CD. MÉX.,"COYOACAN, CD. MÉX.",1,0,1,1,0,497,
05-nov-21,CD. MÉX.,"COYOACAN, CD. MÉX.",1,0,1,0,0,0,
08-nov-21,CD. MÉX.,"TLAHUAC, CD. MÉX.",1,0,1,0,0,11,
08-nov-21,TLAX.,"CONTLA DE JUAN CUAMATZI, TLAX.",1,0,1,0,0,0,
09-nov-21,TLAX.,"PANOTLA, TLAX.",0,1,1,0,0,0,
10-nov-21,TLAX.,"PANOTLA, TLAX.",1,0,1,0,0,0,
12-nov-21,VER.,"NOGALES, VER.",1,0,1,0,0,25,
13-nov-21,TLAX.,"TLAX., TLAX.",1,0,1,0,0,0,
13-nov-21,VER.,"SAYULA DE ALEMAN, VER.",1,0,1,0,0,0,
14-nov-21,VER.,"ALAMO, VER.",1,0,1,1,0,0,
14-nov-21,VER.,"SAYULA DE ALEMAN, VER.",1,0,1,0,0,559,
14-nov-21,VER.,"NOGALES, VER.",0,1,1,0,0,0,
15-nov-21,VER.,"SAYULA DE ALEMAN, VER.",1,0,1,1,0,59,
15-nov-21,VER.,"NOGALES, VER.",1,0,1,0,1,0,
15-nov-21,VER.,"ALAMO, VER.",0,1,1,1,0,66,
16-nov-21,TLAX.,"IXTACUIXTLA DE MARIANO MATAMOROS, TLAX.",1,0,1,2,0,44,
16-nov-21,TLAX.,"NATIVITAS, TLAX.",1,0,1,0,0,0,
17-nov-21,CD. MÉX.,"CUAJIMALPA DE MOR., CD. MÉX.",1,0,1,0,0,1329,
17-nov-21,TLAX.,"IXTACUIXTLA DE MARIANO MATAMOROS, TLAX.",0,1,1,0,0,0,
17-nov-21,TLAX.,"NATIVITAS, TLAX.",1,0,1,0,0,0,
17-nov-21,B.C.,"TIJUANA, B.C.",1,0,1,5,0,0,
19-nov-21,VER.,"NOGALES, VER.",1,0,1,0,0,60,
19-nov-21,VER.,"ALAMO, VER.",1,0,1,0,0,66,
20-nov-21,VER.,"ALAMO, VER.",1,0,1,0,0,66,
22-nov-21,CD. MÉX.,"MIGUEL HGO., CD. MÉX.",1,0,1,0,0,100,
22-nov-21,VER.,"NOGALES, VER.",0,1,1,20,0,100,
22-nov-21,TLAX.,"HUAMANTLA, TLAX.",1,0,1,0,0,46,
23-nov-21,VER.,"NOGALES, VER.",1,0,1,0,0,130,
23-nov-21,TLAX.,"ZITLALTEPEC DE TRINIDAD SANCHEZ SANTOS, TLAX.",1,0,1,0,0,0,
23-nov-21,VER.,"ALAMO, VER.",1,0,1,1,0,77,
24-nov-21,TLAX.,"ALTZAYANCA, TLAX.",1,0,1,0,0,0,
24-nov-21,VER.,"ALAMO, VER.",1,0,1,0,0,0,
25-nov-21,VER.,"ALAMO, VER.",0,1,1,0,0,0,
25-nov-21,VER.,"NOGALES, VER.",1,0,1,0,0,38,
25-nov-21,TLAX.,"ZITLALTEPEC DE TRINIDAD SANCHEZ SANTOS, TLAX.",0,1,1,0,0,0,
25-nov-21,TLAX.,"EL CARMEN TEQUEXQUITLA, TLAX.",0,1,1,0,0,0,
25-nov-21,CD. MÉX.,"ALVARO OBREGON, CD. MÉX.",0,1,1,0,0,0,
26-nov-21,TLAX.,"EL CARMEN TEQUEXQUITLA, TLAX.",1,0,1,0,0,0,
26-nov-21,VER.,"ALAMO, VER.",1,0,1,0,0,27,
26-nov-21,VER.,"NOGALES, VER.",1,0,1,1,0,626,
27-nov-21,VER.,"ALAMO, VER.",1,0,1,0,0,27,
28-nov-21,VER.,"ALAMO, VER.",1,0,1,0,0,27,
29-nov-21,CHIS.,"PALENQUE, CHIS.",0,1,1,0,0,0,
29-nov-21,TLAX.,"YAUHQUEMECAN, TLAX.",0,1,1,0,1,0,
30-nov-21,TLAX.,"TERRENATE, TLAX.",1,0,1,0,0,0,
30-nov-21,TLAX.,"TETLA DE LA SOLIDARIDAD, TLAX.",1,0,1,0,0,0,
01-dic-21,CHIS.,"CHALCHIHUITÁN, CHIS.",0,1,1,0,0,0,
01-dic-21,CHIS.,"TAPACHULA, CHIS.",1,0,1,0,0,0,
01-dic-21,SON.,"HERMOSILLO, SON.",0,1,1,0,0,0,
02-dic-21,CHIS.,"CHALCHIHUITÁN, CHIS.",1,0,1,0,0,0,
02-dic-21,SON.,"NOGALES, SON.",1,0,1,0,0,0,
02-dic-21,SON.,"MAGDALENA, SON.",1,0,1,0,0,0,
02-dic-21,SON.,"SAN LUIS RIO COLORADO, SON.",1,0,1,0,0,0,
02-dic-21,SON.,"CABORCA, SON.",1,0,1,10,0,0,
02-dic-21,TLAX.,"YAUHQUEMECAN, TLAX.",1,0,1,0,0,0,
02-dic-21,TLAX.,"TERRENATE, TLAX.",0,1,1,0,0,0,
04-dic-21,CHIS.,"BENEMÉRITO DE LAS AMÉRICAS, CHIS.",1,0,1,0,0,187,
05-dic-21,CHIS.,"TAPACHULA, CHIS.",1,0,1,1,0,85,
05-dic-21,OAX.,"OAX. DE JUAREZ, OAX.",1,0,1,0,0,97,
06-dic-21,CHIS.,"CHIAPA DE CORZO, CHIS.",1,0,1,0,0,213,
06-dic-21,TLAX.,"EMILIANO ZAPATA, TLAX.",0,1,1,0,0,0,
06-dic-21,CHIS.,"REFORMA, CHIS.",0,1,1,0,0,0,
06-dic-21,CHIS.,"YAJALÓN, CHIS.",1,0,1,0,0,18,
06-dic-21,CD. MÉX.,"AZCAPOTZALCO, CD. MÉX.",1,0,1,0,0,0,
07-dic-21,CHIS.,"COMITAN DE DOMÍNGUEZ, CHIS.",1,0,1,0,0,0,
07-dic-21,CHIS.,"TONALÁ, CHIS.",1,0,1,0,0,0,
07-dic-21,OAX.,"OAX. DE JUAREZ, OAX.",1,0,1,0,0,151,
08-dic-21,CHIS.,"TUXTLA GUTIÉRREZ, CHIS.",0,1,1,0,0,214,
08-dic-21,CHIS.,"CHIAPA DE CORZO, CHIS.",0,1,1,0,0,9,
08-dic-21,CD. MÉX.,"IZTAPALAPA, CD. MÉX.",0,1,1,0,0,361,
08-dic-21,TLAX.,"EMILIANO ZAPATA, TLAX.",0,1,1,0,0,0,
09-dic-21,CHIS.,"CHIAPA DE CORZO, CHIS.",0,1,1,0,0,153,
09-dic-21,CD. MÉX.,"ALVARO OBREGON, CD. MÉX.",1,0,1,0,0,392,
09-dic-21,OAX.,"OAX. DE JUAREZ, OAX.",1,0,1,0,0,51,
10-dic-21,CHIS.,"CHIAPA DE CORZO, CHIS.",1,0,1,0,0,398,
11-dic-21,CHIH.,"CHIH., CHIH.",1,0,1,0,0,217,
11-dic-21,CHIS.,"COMITAN DE DOMÍNGUEZ, CHIS.",1,0,1,0,0,348,
13-dic-21,CHIH.,"CHIH., CHIH.",0,1,1,0,0,703,
13-dic-21,OAX.,"OAX. DE JUAREZ, OAX.",1,0,1,0,0,205,
14-dic-21,CHIS.,"TUXTLA GUTIÉRREZ, CHIS.",1,0,1,0,0,50,
14-dic-21,CHIS.,"SAN CRISTOBAL DE LAS CASAS, CHIS.",0,1,1,0,0,205,
14-dic-21,CHIH.,"CHIH., CHIH.",0,1,1,0,0,968,
15-dic-21,CHIS.,"SAN CRISTOBAL DE LAS CASAS, CHIS.",1,0,1,0,0,0,
16-dic-21,CHIH.,"CHIH., CHIH.",1,0,1,0,0,298,
16-dic-21,CD. MÉX.,"IZTAPALAPA, CD. MÉX.",1,0,1,0,0,0,
16-dic-21,CHIS.,"OCOZOCOAUTLA DE ESPINOSA, CHIS.",1,0,1,0,0,610,
17-dic-21,CHIH.,"CHIH., CHIH.",1,0,1,0,0,379,
17-dic-21,CD. MÉX.,"CUAUHTEMOC, CD. MÉX.",1,0,1,0,0,0,
17-dic-21,CD. MÉX.,"IZTACALCO, CD. MÉX.",1,0,1,0,0,74,
18-dic-21,CHIS.,"TUXTLA GUTIÉRREZ, CHIS.",1,0,1,0,0,246,
18-dic-21,CHIS.,"BOCHIL, CHIS.",0,1,1,0,0,0,
19-dic-21,B.C.,"ENSENADA, B.C.",1,0,1,3,0,0,
04-ene-22,B.C.,"SAN QUINTÍN, B.C.",1,0,1,0,0,0,
14-ene-22,B.C.,"SAN QUINTÍN, B.C.",1,0,1,0,0,0,
21-ene-22,CD. MÉX.,"MIGUEL HGO., CD. MÉX.",1,0,1,0,0,78,
24-ene-22,CD. MÉX.,"VENUSTIANO CARRANZA, CD. MÉX.",1,0,1,0,0,0,
25-ene-22,CD. MÉX.,"CUAUHTEMOC, CD. MÉX.",1,0,1,0,0,0,
26-ene-22,CD. MÉX.,"CUAUHTEMOC, CD. MÉX.",1,0,1,0,0,0,
26-ene-22,CD. MÉX.,"VENUSTIANO CARRANZA, CD. MÉX.",1,0,1,0,0,0,
27-ene-22,CD. MÉX.,"VENUSTIANO CARRANZA, CD. MÉX.",1,0,1,0,10,949,
27-ene-22,CHIH.,"NUEVO CASAS GRANDES, CHIH.",1,0,1,6,0,115,
01-feb-22,CD. MÉX.,"IZTACALCO, CD. MÉX.",1,0,1,0,0,0,
02-feb-22,CD. MÉX.,"IZTACALCO, CD. MÉX.",1,0,1,0,0,70,
03-feb-22,CD. MÉX.,"IZTAPALAPA, CD. MÉX.",1,0,1,0,0,129,
04-feb-22,CD. MÉX.,"IZTAPALAPA, CD. MÉX.",1,0,1,0,0,145,
04-feb-22,CD. MÉX.,"BENITO JUAREZ, CD. MÉX.",1,0,1,0,0,6,
07-feb-22,GTO.,"PURISIMA DEL RINCON, GTO.",1,0,1,0,0,0,
09-feb-22,CD. MÉX.,"IZTAPALAPA, CD. MÉX.",1,0,1,0,0,0,
10-feb-22,CD. MÉX.,"IZTACALCO, CD. MÉX.",1,0,1,0,0,0,
10-feb-22,CD. MÉX.,"IZTAPALAPA, CD. MÉX.",1,0,1,0,0,14,
11-feb-22,CD. MÉX.,"BENITO JUAREZ, CD. MÉX.",1,0,1,0,0,0,
30-mar-22,CD. MÉX.,"CUAUHTEMOC, CD. MÉX.",1,0,1,0,0,198,
05-abr-22,CD. MÉX.,"CUAUHTEMOC, CD. MÉX.",1,0,1,0,0,0,
06-abr-22,CD. MÉX.,"CUAUHTEMOC, CD. MÉX.",1,0,1,0,0,167,
08-abr-22,CD. MÉX.,"CUAUHTEMOC, CD. MÉX.",1,0,1,0,0,51,
12-abr-22,CD. MÉX.,"CUAUHTEMOC, CD. MÉX.",1,0,1,0,0,0,
21-abr-22,CD. MÉX.,"TLAHUAC, CD. MÉX.",1,0,1,0,0,0,
22-abr-22,S.L.P.,"SOLEDAD DE GRACIANO SANCHEZ, S.L.P.",1,0,1,0,0,0,
22-abr-22,CD. MÉX.,"TLAHUAC, CD. MÉX.",0,1,1,0,0,0,
25-abr-22,S.L.P.,"SOLEDAD DE GRACIANO SANCHEZ, S.L.P.",1,0,1,11,0,0,
26-abr-22,CD. MÉX.,"CUAUHTEMOC, CD. MÉX.",1,0,1,0,0,249,
27-abr-22,S.L.P.,"CIUDAD VALLES, S.L.P.",1,0,1,0,0,4,
27-abr-22,CD. MÉX.,"CUAUHTEMOC, CD. MÉX.",1,0,1,0,0,17,
27-abr-22,CD. MÉX.,"TLAHUAC, CD. MÉX.",1,0,1,0,0,0,
28-abr-22,CD. MÉX.,"CUAUHTEMOC, CD. MÉX.",0,1,1,0,0,110,
06-may-22,CD. MÉX.,"CUAUHTEMOC, CD. MÉX.",1,0,1,0,0,919,
07-may-22,S.L.P.,"SAN LUIS POTOSI, S.L.P.",0,1,1,0,0,0,
11-may-22,SIN.,"CHOIX, SIN.",0,1,1,0,0,0,
11-may-22,SIN.,"SIN., SIN.",1,0,1,0,0,0,
11-may-22,CD. MÉX.,"CUAUHTEMOC, CD. MÉX.",1,0,1,0,2,1258,
12-may-22,SIN.,"EL FUERTE, SIN.",1,0,1,0,0,0,
13-may-22,CD. MÉX.,"TLAHUAC, CD. MÉX.",1,0,1,0,0,291,
16-may-22,SIN.,"CHOIX, SIN.",0,1,1,0,0,0,
17-may-22,SIN.,"CHOIX, SIN.",0,1,1,0,0,0,
18-may-22,SIN.,"SIN., SIN.",1,0,1,0,0,0,
19-may-22,CD. MÉX.,"CUAUHTEMOC, CD. MÉX.",1,0,1,0,0,0,
19-may-22,S.L.P.,"SAN LUIS POTOSI, S.L.P.",1,0,1,0,0,0,
19-may-22,S.L.P.,"CIUDAD VALLES, S.L.P.",1,0,1,0,0,0,
19-may-22,SIN.,"CHOIX, SIN.",1,0,1,0,0,0,
19-may-22,SIN.,"SIN., SIN.",1,0,1,0,0,0,
20-may-22,CD. MÉX.,"CUAUHTEMOC, CD. MÉX.",0,1,1,0,0,307,
22-may-22,VER.,"COATZACOALCOS, VER.",0,1,1,2,0,13,
22-may-22,SIN.,"EL FUERTE, SIN.",1,0,1,0,0,0,
23-may-22,CD. MÉX.,"GUSTAVO A. MADERO, CD. MÉX.",1,0,1,0,0,479,
24-may-22,CD. MÉX.,"VENUSTIANO CARRANZA, CD. MÉX.",1,0,1,0,0,3,
24-may-22,VER.,"XALAPA, VER.",0,1,1,3,0,26,
25-may-22,CD. MÉX.,"GUSTAVO A. MADERO, CD. MÉX.",1,0,1,0,0,479,
26-may-22,VER.,"XALAPA, VER.",1,0,1,23,0,443,
27-may-22,VER.,"XALAPA, VER.",0,1,1,30,0,134,
28-may-22,VER.,"XALAPA, VER.",1,0,1,1,0,33,
29-may-22,S.L.P.,"SAN LUIS POTOSI, S.L.P.",1,0,1,0,0,0,
29-may-22,S.L.P.,"TAMUIN, S.L.P.",0,1,1,0,0,0,
30-may-22,CD. MÉX.,"GUSTAVO A. MADERO, CD. MÉX.",1,0,1,0,0,208,
30-may-22,CD. MÉX.,"MIGUEL HGO., CD. MÉX.",1,0,1,0,0,0,
31-may-22,CD. MÉX.,"IZTAPALAPA, CD. MÉX.",0,1,1,0,0,0,
01-jun-22,CD. MÉX.,"IZTAPALAPA, CD. MÉX.",1,0,1,0,0,0,
02-jun-22,CD. MÉX.,"GUSTAVO A. MADERO, CD. MÉX.",1,0,1,0,0,43,
03-jun-22,VER.,"XALAPA, VER.",1,0,1,48,1,200,
03-jun-22,S.L.P.,"EBANO, S.L.P.",0,1,1,2,0,30,
03-jun-22,B.C.,"TIJUANA, B.C.",0,1,1,0,0,0,
04-jun-22,S.L.P.,"SAN LUIS POTOSI, S.L.P.",1,0,1,0,0,0,
06-jun-22,SIN.,"ANGOSTURA, SIN.",0,1,1,0,0,0,
07-jun-22,S.L.P.,"SAN LUIS POTOSI, S.L.P.",1,0,1,0,0,0,
07-jun-22,CD. MÉX.,"AZCAPOTZALCO, CD. MÉX.",1,0,1,0,0,119,
07-jun-22,CD. MÉX.,"MIGUEL HGO., CD. MÉX.",1,0,1,0,0,20,
07-jun-22,TLAX.,"PANOTLA, TLAX.",1,0,1,0,0,0,
08-jun-22,CD. MÉX.,"VENUSTIANO CARRANZA, CD. MÉX.",1,0,1,0,0,233,
08-jun-22,TLAX.,"APIZACO, TLAX.",1,0,1,1,0,30,
08-jun-22,TLAX.,"PANOTLA, TLAX.",0,1,1,0,0,0,
09-jun-22,TLAX.,"TLAX., TLAX.",1,0,1,0,0,0,
09-jun-22,TLAX.,"PANOTLA, TLAX.",1,0,1,0,0,0,
09-jun-22,SIN.,"ANGOSTURA, SIN.",0,1,1,0,0,0,
10-jun-22,TLAX.,"TLAX., TLAX.",1,0,1,0,0,42,
10-jun-22,CD. MÉX.,"VENUSTIANO CARRANZA, CD. MÉX.",1,0,1,0,0,118,
11-jun-22,TLAX.,"TLAX., TLAX.",1,0,1,1,0,10,
11-jun-22,TLAX.,"APIZACO, TLAX.",1,0,1,0,0,0,
12-jun-22,SIN.,"GUASAVE, SIN.",1,0,1,0,0,0,
12-jun-22,S.L.P.,"SAN LUIS POTOSI, S.L.P.",1,0,1,0,0,0,
13-jun-22,SIN.,"ANGOSTURA, SIN.",0,1,1,0,3,0,
14-jun-22,TLAX.,"NANACAMILPA DE MARIANO ARISTA, TLAX.",0,1,1,0,0,0,
14-jun-22,TLAX.,"EL CARMEN TEQUEXQUITLA, TLAX.",0,1,1,0,0,0,
14-jun-22,CD. MÉX.,"CUAUHTEMOC, CD. MÉX.",1,0,1,0,0,44,
14-jun-22,CD. MÉX.,"VENUSTIANO CARRANZA, CD. MÉX.",0,1,1,0,0,0,
14-jun-22,CD. MÉX.,"ALVARO OBREGON, CD. MÉX.",1,0,1,0,0,115,
16-jun-22,SIN.,"ANGOSTURA, SIN.",0,1,1,0,0,0,
16-jun-22,TLAX.,"CALPULALPAN, TLAX.",1,0,1,0,0,0,
17-jun-22,JAL.,"TLAJOMULCO DE ZUÑIGA, JAL.",1,0,1,1,0,5,
17-jun-22,SIN.,"AHOME, SIN.",1,0,1,0,0,0,
17-jun-22,S.L.P.,"SAN LUIS POTOSI, S.L.P.",1,0,1,0,0,0,
17-jun-22,TLAX.,"CALPULALPAN, TLAX.",0,1,1,0,0,0,
17-jun-22,TLAX.,"CUAPIAXTLA, TLAX.",1,0,1,0,0,0,
18-jun-22,SIN.,"ANGOSTURA, SIN.",0,1,1,0,0,0,
18-jun-22,S.L.P.,"SAN LUIS POTOSI, S.L.P.",1,0,1,0,0,0,
19-jun-22,SIN.,"AHOME, SIN.",1,0,1,0,0,0,
19-jun-22,SIN.,"GUASAVE, SIN.",1,0,1,0,0,0,
19-jun-22,QRO.,"JALPAN DE SERRA, QRO.",1,0,1,0,0,0,
21-jun-22,S.L.P.,"SAN LUIS POTOSI, S.L.P.",1,0,1,0,0,0,
21-jun-22,TLAX.,"TENANCINGO, TLAX.",1,0,1,0,0,0,
21-jun-22,TLAX.,"CHIAUTEMPAN, TLAX.",1,0,1,0,0,0,
21-jun-22,TLAX.,"SANTA CRUZ TLAX., TLAX.",1,0,1,0,0,0,
22-jun-22,TLAX.,"TENANCINGO, TLAX.",0,1,1,0,0,0,
22-jun-22,TLAX.,"CHIAUTEMPAN, TLAX.",1,0,1,0,0,1030,
23-jun-22,CD. MÉX.,"ALVARO OBREGON, CD. MÉX.",1,0,1,0,0,16,
23-jun-22,CD. MÉX.,"TLALPAN, CD. MÉX.",1,0,1,0,0,278,
23-jun-22,TLAX.,"CHIAUTEMPAN, TLAX.",1,0,1,0,0,0,
23-jun-22,TLAX.,"SANTA CRUZ TLAX., TLAX.",1,0,1,1,0,20,
24-jun-22,CHIH.,"JUÁREZ, CHIH.",1,0,1,6,0,122,
25-jun-22,TLAX.,"ZACATELCO, TLAX.",1,0,1,0,0,0,
25-jun-22,TLAX.,"CHIAUTEMPAN, TLAX.",1,0,1,0,0,20,
25-jun-22,TLAX.,"SANTA CRUZ TLAX., TLAX.",1,0,1,0,0,5,
27-jun-22,TLAX.,"ATLANGATEPEC, TLAX.",1,0,1,0,0,0,
27-jun-22,TLAX.,"SAN PABLO DEL MONTE, TLAX.",0,1,1,0,0,0,
27-jun-22,TAMPS.,"MIGUEL ALEMAN, TAMPS.",1,0,1,1,0,0,
28-jun-22,CHIH.,"JUÁREZ, CHIH.",0,1,1,0,0,0,
28-jun-22,B.C.,"SAN QUINTÍN, B.C.",0,1,1,11,0,30,
28-jun-22,JAL.,"TECALITLAN, JAL.",0,1,1,0,0,0,
29-jun-22,TLAX.,"ATLANGATEPEC, TLAX.",0,1,1,0,0,0,
29-jun-22,TLAX.,"TEOLOCHOLCO, TLAX.",1,0,1,1,0,155,
30-jun-22,CD. MÉX.,"CUAJIMALPA DE MOR., CD. MÉX.",1,0,1,0,0,571,
01-jul-22,JAL.,"ZAPOPAN, JAL.",0,1,1,3,0,649,
01-jul-22,CD. MÉX.,"CUAJIMALPA DE MOR., CD. MÉX.",1,0,1,0,0,0,
01-jul-22,TAMPS.,"MIGUEL ALEMAN, TAMPS.",1,0,1,0,0,0,
02-jul-22,TLAX.,"TEOLOCHOLCO, TLAX.",1,0,1,0,0,0,
02-jul-22,TLAX.,,1,0,1,0,0,0,
04-jul-22,CD. MÉX.,"BENITO JUAREZ, CD. MÉX.",1,0,1,0,0,258,
04-jul-22,CD. MÉX.,"CUAJIMALPA DE MOR., CD. MÉX.",1,0,1,0,0,38,
04-jul-22,CHIH.,"JUÁREZ, CHIH.",1,0,1,7,0,345,
05-jul-22,CD. MÉX.,"COYOACAN, CD. MÉX.",0,1,1,0,0,17,
05-jul-22,CD. MÉX.,"MIGUEL HGO., CD. MÉX.",1,0,1,0,0,27,
05-jul-22,SIN.,"MOCORITO, SIN.",1,0,1,0,1,0,
06-jul-22,CD. MÉX.,"COYOACAN, CD. MÉX.",1,0,1,0,0,26,
06-jul-22,CD. MÉX.,"ALVARO OBREGON, CD. MÉX.",1,0,1,0,0,209,
06-jul-22,SIN.,"SALVADOR ALVARADO, SIN.",1,0,1,0,0,0,
07-jul-22,CD. MÉX.,"MIGUEL HGO., CD. MÉX.",0,1,1,0,0,284,
07-jul-22,B.C.,"SAN QUINTÍN, B.C.",1,0,1,7,0,0,
07-jul-22,SIN.,"SALVADOR ALVARADO, SIN.",1,0,1,0,0,0,
07-jul-22,CHIH.,"JUÁREZ, CHIH.",0,1,1,1,0,0,
07-jul-22,JAL.,"JAMAY, JAL.",0,1,1,0,0,0,
07-jul-22,SIN.,"BADIRAGUATO, SIN.",0,1,1,0,0,0,
08-jul-22,JAL.,"TAMAZULA DE GORDIANO, JAL.",1,0,1,0,0,0,
08-jul-22,SIN.,"SALVADOR ALVARADO, SIN.",0,1,1,0,0,7,
08-jul-22,SIN.,"MOCORITO, SIN.",0,1,1,0,0,0,
08-jul-22,CD. MÉX.,"COYOACAN, CD. MÉX.",1,0,1,0,0,0,
08-jul-22,CD. MÉX.,"BENITO JUAREZ, CD. MÉX.",0,1,1,0,0,0,
08-jul-22,CD. MÉX.,"CUAJIMALPA DE MOR., CD. MÉX.",0,1,1,0,0,0,
09-jul-22,CHIH.,"JUÁREZ, CHIH.",0,1,1,1,0,437,
09-jul-22,DGO.,"DGO., DGO.",0,1,1,0,0,0,
09-jul-22,DGO.,"SANTIAGO PAPASQUIARO, DGO.",1,0,1,0,0,0,
09-jul-22,SIN.,"SALVADOR ALVARADO, SIN.",0,1,1,0,0,0,
10-jul-22,B.C.,"TIJUANA, B.C.",0,1,1,0,0,0,
10-jul-22,S.L.P.,"SAN LUIS POTOSI, S.L.P.",0,1,1,0,0,0,
10-jul-22,SIN.,"SALVADOR ALVARADO, SIN.",1,0,1,0,0,0,
11-jul-22,SIN.,"MOCORITO, SIN.",0,1,1,0,0,0,
11-jul-22,SIN.,"BADIRAGUATO, SIN.",0,1,1,0,0,0,
11-jul-22,JAL.,"TLAQUEPAQUE, JAL.",0,1,1,0,0,103,
12-jul-22,VER.,"TUXPAM, VER.",1,0,1,0,0,179,
12-jul-22,CD. MÉX.,"COYOACAN, CD. MÉX.",1,0,1,0,0,10,
12-jul-22,SIN.,"BADIRAGUATO, SIN.",1,0,1,0,0,0,
12-jul-22,S.L.P.,"SAN LUIS POTOSI, S.L.P.",1,0,1,0,0,0,
12-jul-22,TAMPS.,"VICTORIA, TAMPS.",1,0,1,0,1,0,
13-jul-22,S.L.P.,"SAN LUIS POTOSI, S.L.P.",1,0,1,0,0,0,
13-jul-22,VER.,"TUXPAM, VER.",1,0,1,0,1,140,
14-jul-22,CD. MÉX.,"BENITO JUAREZ, CD. MÉX.",0,1,1,0,0,525,
14-jul-22,SIN.,"SALVADOR ALVARADO, SIN.",0,1,1,0,0,0,
14-jul-22,JAL.,"TLAQUEPAQUE, JAL.",0,1,1,0,2,381,
14-jul-22,VER.,"TUXPAM, VER.",1,0,1,0,1,140,
14-jul-22,VER.,"VER., VER.",1,0,1,0,0,844,
14-jul-22,JAL.,"TECALITLAN, JAL.",1,0,1,0,0,0,
15-jul-22,SIN.,"SALVADOR ALVARADO, SIN.",1,0,1,0,0,100,
15-jul-22,SIN.,"MOCORITO, SIN.",1,0,1,0,0,0,
15-jul-22,S.L.P.,"SAN LUIS POTOSI, S.L.P.",1,0,1,0,5,0,
15-jul-22,VER.,"TUXPAM, VER.",1,0,1,0,1,140,
16-jul-22,SIN.,"BADIRAGUATO, SIN.",0,1,1,0,0,0,
17-jul-22,SIN.,"SALVADOR ALVARADO, SIN.",1,0,1,0,2,0,
18-jul-22,VER.,"TUXPAM, VER.",1,0,1,0,0,205,
21-jul-22,JAL.,"TONALA, JAL.",0,1,1,8,3,201,
21-jul-22,COL.,"TECOMÁN, COL.",1,0,1,0,0,0,
22-jul-22,CD. MÉX.,"AZCAPOTZALCO, CD. MÉX.",1,0,1,0,22,59,
22-jul-22,TAMPS.,"EL MANTE, TAMPS.",1,0,1,0,0,0,
24-jul-22,VER.,"TUXPAM, VER.",1,0,1,5,0,168,
24-jul-22,VER.,"VER., VER.",1,0,1,8,0,141,
25-jul-22,CHIS.,"LA TRINITARIA, CHIS.",1,0,1,0,0,16,
25-jul-22,VER.,"TUXPAM, VER.",0,1,1,8,0,476,
25-jul-22,B.C.,"SAN FELIPE, B.C.",1,0,1,0,0,4,
26-jul-22,B.C.S.,"LA PAZ, B.C.S.",1,0,1,0,0,252,
27-jul-22,B.C.S.,"LA PAZ, B.C.S.",1,0,1,0,0,2,
27-jul-22,JAL.,"TONALA, JAL.",1,0,1,2,0,9,
28-jul-22,JAL.,"ZAPOTLANEJO, JAL.",1,0,1,1,0,90,
29-jul-22,JAL.,"ZAPOTLANEJO, JAL.",1,0,1,0,0,0,
29-jul-22,CHIS.,"TECPATÁN, CHIS.",1,0,1,52,0,0,
30-jul-22,B.C.,"SAN FELIPE, B.C.",1,0,1,0,0,0,
31-jul-22,QRO.,"QUERETARO, QRO.",1,0,1,0,2,0,
01-ago-22,CHIS.,"LA TRINITARIA, CHIS.",1,0,1,51,0,0,
02-ago-22,CD. MÉX.,"COYOACAN, CD. MÉX.",1,0,1,0,0,22,
02-ago-22,COAH.,"MONCLOVA, COAH.",1,0,1,0,0,270,
02-ago-22,TAB.,"CARDENAS, TAB.",1,0,1,0,0,32,
03-ago-22,CD. MÉX.,"COYOACAN, CD. MÉX.",1,0,1,0,0,101,
03-ago-22,CHIS.,"CHENALHÓ, CHIS.",0,1,1,0,0,0,
04-ago-22,CD. MÉX.,"BENITO JUAREZ, CD. MÉX.",1,0,1,0,0,126,
04-ago-22,TAMPS.,"ALTAMIRA, TAMPS.",1,0,1,0,0,0,
05-ago-22,TAB.,"CARDENAS, TAB.",1,0,1,0,0,191,
05-ago-22,CHIS.,"TAPACHULA, CHIS.",0,1,1,4,0,608,
05-ago-22,CHIS.,"TONALÁ, CHIS.",1,0,1,0,0,99,
05-ago-22,CHIS.,"CINTALAPA, CHIS.",1,0,1,0,0,0,
07-ago-22,PUE.,"ATLIXCO, PUE.",1,0,1,0,0,0,
08-ago-22,S.L.P.,"SAN LUIS POTOSI, S.L.P.",1,0,1,0,0,0,
08-ago-22,CHIS.,"CINTALAPA, CHIS.",1,0,1,0,0,0,
08-ago-22,CHIS.,"CHENALHÓ, CHIS.",1,0,1,0,0,0,
09-ago-22,COAH.,"MONCLOVA, COAH.",1,0,1,0,0,7,
09-ago-22,TAB.,"CARDENAS, TAB.",0,1,1,0,0,0,
09-ago-22,CHIS.,"BERRIOZÁBAL, CHIS.",0,1,1,0,0,752,
10-ago-22,COAH.,"ARTEAGA, COAH.",1,0,1,0,0,0,
10-ago-22,CD. MÉX.,"COYOACAN, CD. MÉX.",1,0,1,0,0,0,
10-ago-22,TAMPS.,"VICTORIA, TAMPS.",1,0,1,0,0,0,
10-ago-22,TAB.,"CARDENAS, TAB.",0,1,1,0,0,0,
10-ago-22,CHIS.,"LA TRINITARIA, CHIS.",0,1,1,2,0,80,
10-ago-22,TAB.,"CARDENAS, TAB.",1,0,1,0,0,191,
10-ago-22,TAMPS.,"REYNOSA, TAMPS.",0,1,1,0,0,0,
11-ago-22,CD. MÉX.,"ALVARO OBREGON, CD. MÉX.",1,0,1,0,0,0,
11-ago-22,CD. MÉX.,"COYOACAN, CD. MÉX.",1,0,1,0,0,0,
11-ago-22,CD. MÉX.,"BENITO JUAREZ, CD. MÉX.",1,0,1,0,0,0,
11-ago-22,TAB.,"CENTRO, TAB.",1,0,1,0,0,0,
11-ago-22,CHIS.,"OSUMACINTA, CHIS.",0,1,1,0,0,169,
11-ago-22,CHIS.,"TAPACHULA, CHIS.",1,0,1,0,0,450,
11-ago-22,CHIS.,"YAJALÓN, CHIS.",0,1,1,0,0,4,
11-ago-22,TAMPS.,"VICTORIA, TAMPS.",1,0,1,0,0,0,
11-ago-22,TAMPS.,"ALTAMIRA, TAMPS.",1,0,1,1,0,47,
11-ago-22,TAMPS.,"REYNOSA, TAMPS.",0,1,1,1,0,70,
12-ago-22,CHIS.,"TONALÁ, CHIS.",1,0,1,0,0,0,
12-ago-22,CD. MÉX.,"ALVARO OBREGON, CD. MÉX.",1,0,1,0,0,0,
12-ago-22,COAH.,"FRONTERA, COAH.",1,0,1,2,0,190,
12-ago-22,COAH.,"ARTEAGA, COAH.",0,1,1,0,0,303,
15-ago-22,CD. MÉX.,"COYOACAN, CD. MÉX.",1,0,1,0,0,25,
15-ago-22,CD. MÉX.,"GUSTAVO A. MADERO, CD. MÉX.",0,1,1,0,0,213,
15-ago-22,QRO.,"LANDA DE MATAMOROS, QRO.",1,0,1,0,0,0,
15-ago-22,PUE.,"TEHUACAN, PUE.",0,1,1,0,0,0,
16-ago-22,DGO.,"DGO., DGO.",1,0,1,0,0,13,
16-ago-22,DGO.,"GOMEZ PALACIO, DGO.",1,0,1,0,0,0,
16-ago-22,CD. MÉX.,"GUSTAVO A. MADERO, CD. MÉX.",1,0,1,0,0,0,
16-ago-22,COAH.,"MONCLOVA, COAH.",1,0,1,1,0,0,
16-ago-22,SIN.,"SIN., SIN.",1,0,1,0,0,0,
16-ago-22,TAMPS.,"VICTORIA, TAMPS.",1,0,1,0,0,0,
16-ago-22,TAMPS.,"ALTAMIRA, TAMPS.",1,0,1,0,0,0,
17-ago-22,CD. MÉX.,"IZTACALCO, CD. MÉX.",1,0,1,0,0,9,
17-ago-22,CHIS.,"BERRIOZÁBAL, CHIS.",1,0,1,0,0,424,
17-ago-22,TAMPS.,"VICTORIA, TAMPS.",1,0,1,0,0,0,
18-ago-22,COAH.,"FRONTERA, COAH.",1,0,1,3,0,2,
18-ago-22,COAH.,"RAMOS ARIZPE, COAH.",1,0,1,3,0,19,
19-ago-22,CD. MÉX.,"IZTACALCO, CD. MÉX.",1,0,1,0,0,144,
19-ago-22,CD. MÉX.,"GUSTAVO A. MADERO, CD. MÉX.",1,0,1,0,0,0,
19-ago-22,COAH.,"TORREÓN, COAH.",1,0,1,0,0,84,
19-ago-22,SIN.,"SIN., SIN.",0,1,1,0,1,0,
19-ago-22,DGO.,"DGO., DGO.",1,0,1,0,0,0,
19-ago-22,DGO.,"GOMEZ PALACIO, DGO.",1,0,1,0,0,0,
19-ago-22,CHIS.,"BERRIOZÁBAL, CHIS.",0,1,1,2,0,266,
19-ago-22,TAMPS.,"ALTAMIRA, TAMPS.",1,0,1,0,0,144,
20-ago-22,SIN.,"SIN., SIN.",1,0,1,0,0,0,
20-ago-22,CHIS.,"TAPACHULA, CHIS.",1,0,1,0,0,100,
20-ago-22,CHIS.,"JIQUIPILAS, CHIS.",0,1,1,0,0,55,
20-ago-22,B.C.,"SAN FELIPE, B.C.",1,0,1,0,0,0,
22-ago-22,N.L.,"APODACA, N.L.",1,0,1,0,0,0,
22-ago-22,MÉX.,"AMECAMECA, MEX.",1,0,1,0,3,19,
22-ago-22,MÉX.,"CHIMALHUACAN, MEX.",1,0,1,0,0,0,
22-ago-22,COAH.,"ACUÑA, COAH.",0,1,1,0,0,0,
22-ago-22,COAH.,"MATAMOROS, COAH.",1,0,1,0,0,0,
23-ago-22,SIN.,"ESCUINAPA, SIN.",1,0,1,0,0,0,
23-ago-22,SIN.,"ROSARIO, SIN.",1,0,1,0,0,0,
23-ago-22,TAMPS.,"VICTORIA, TAMPS.",1,0,1,0,0,0,
23-ago-22,COAH.,"ACUÑA, COAH.",1,0,1,2,0,0,
24-ago-22,SIN.,"ROSARIO, SIN.",0,1,1,0,0,0,
24-ago-22,CHIS.,"VILLAFLORES, CHIS.",0,1,1,3,0,589,
24-ago-22,DGO.,"GOMEZ PALACIO, DGO.",1,0,1,1,0,0,
24-ago-22,TAMPS.,"REYNOSA, TAMPS.",0,1,1,3,0,28,
25-ago-22,CD. MÉX.,"IZTACALCO, CD. MÉX.",1,0,1,0,0,0,
25-ago-22,CD. MÉX.,"IZTAPALAPA, CD. MÉX.",0,1,1,0,0,0,
25-ago-22,CD. MÉX.,"GUSTAVO A. MADERO, CD. MÉX.",1,0,1,0,0,71,
25-ago-22,SIN.,"ESCUINAPA, SIN.",1,0,1,0,0,0,
25-ago-22,MÉX.,"AMECAMECA, MEX.",1,0,1,1,0,36,
25-ago-22,MÉX.,"CHIMALHUACAN, MEX.",1,0,1,0,0,7,
25-ago-22,MÉX.,"HUIXQUILUCAN, MEX.",1,0,1,0,0,18,
26-ago-22,CD. MÉX.,"IZTACALCO, CD. MÉX.",1,0,1,0,0,0,
26-ago-22,CD. MÉX.,"IZTAPALAPA, CD. MÉX.",1,0,1,0,0,24,
26-ago-22,CD. MÉX.,"VENUSTIANO CARRANZA, CD. MÉX.",1,0,1,0,0,2,
26-ago-22,CD. MÉX.,"CUAUHTEMOC, CD. MÉX.",0,1,1,0,0,116,
26-ago-22,SIN.,"ESCUINAPA, SIN.",1,0,1,0,0,0,
26-ago-22,MÉX.,"AMECAMECA, MEX.",1,0,1,0,0,26,
26-ago-22,MÉX.,"NEZAHUALCOYOTL, MEX.",1,0,1,0,0,71,
26-ago-22,TAMPS.,"ALTAMIRA, TAMPS.",1,0,1,0,1,0,
26-ago-22,CHIS.,"ARRIAGA, CHIS.",1,0,1,0,0,0,
26-ago-22,TAMPS.,"REYNOSA, TAMPS.",1,0,1,7,0,115,
27-ago-22,COAH.,"NUEVA ROSITA, COAH.",0,1,1,0,0,10,
28-ago-22,SIN.,"ESCUINAPA, SIN.",1,0,1,0,0,0,
29-ago-22,CD. MÉX.,"IZTACALCO, CD. MÉX.",0,1,1,0,0,8,
29-ago-22,CD. MÉX.,"IZTAPALAPA, CD. MÉX.",1,0,1,0,0,0,
29-ago-22,CD. MÉX.,"VENUSTIANO CARRANZA, CD. MÉX.",1,0,1,0,0,0,
29-ago-22,COAH.,"NUEVA ROSITA, COAH.",1,0,1,2,0,10,
29-ago-22,N.L.,"APODACA, N.L.",0,1,1,0,0,53,
29-ago-22,COAH.,"NUEVA ROSITA, COAH.",0,1,1,1,0,0,
29-ago-22,CHIS.,"SUCHIATE, CHIS.",0,1,1,0,0,239,
30-ago-22,CD. MÉX.,"IZTACALCO, CD. MÉX.",1,0,1,0,0,29,
30-ago-22,CHIS.,"ARRIAGA, CHIS.",1,0,1,0,0,489,
30-ago-22,TAMPS.,"ALTAMIRA, TAMPS.",1,0,1,1,0,6,
31-ago-22,CD. MÉX.,"IZTAPALAPA, CD. MÉX.",1,0,1,0,0,0,
31-ago-22,COAH.,"NUEVA ROSITA, COAH.",0,1,1,0,0,0,
31-ago-22,CHIS.,"ARRIAGA, CHIS.",0,1,1,1,0,511,
31-ago-22,B.C.,"TIJUANA, B.C.",0,1,1,0,0,0,
31-ago-22,COAH.,"ACUÑA, COAH.",1,0,1,0,0,299,
31-ago-22,COAH.,"PIEDRAS NEGRAS, COAH.",1,0,1,1,0,17,
31-ago-22,TAMPS.,"ALTAMIRA, TAMPS.",1,0,1,1,0,0,
01-sep-22,CD. MÉX.,"XOCHIMILCO, CD. MÉX.",1,0,1,0,0,35,
01-sep-22,COAH.,"MONCLOVA, COAH.",1,0,1,0,0,0,
01-sep-22,ZAC.,"GUADALUPE, ZAC.",1,0,1,0,0,48,
02-sep-22,CD. MÉX.,"XOCHIMILCO, CD. MÉX.",1,0,1,0,0,0,
02-sep-22,MÉX.,"HUIXQUILUCAN, MEX.",0,1,1,0,0,0,
02-sep-22,COAH.,"TORREÓN, COAH.",1,0,1,0,0,0,
02-sep-22,B.C.,"SAN QUINTÍN, B.C.",1,0,1,0,0,0,
03-sep-22,QRO.,"QUERETARO, QRO.",1,0,1,0,1,0,
03-sep-22,MÉX.,"HUIXQUILUCAN, MEX.",0,1,1,0,0,21,
05-sep-22,ZAC.,"FRESNILLO, ZAC.",1,0,1,0,0,50,
05-sep-22,COAH.,"PIEDRAS NEGRAS, COAH.",1,0,1,1,0,0,
05-sep-22,TAMPS.,"JAUMAVE, TAMPS.",0,1,1,0,0,0,
06-sep-22,CD. MÉX.,"XOCHIMILCO, CD. MÉX.",1,0,1,0,0,10,
06-sep-22,TAMPS.,"JAUMAVE, TAMPS.",1,0,1,0,0,0,
06-sep-22,MÉX.,"TOLUCA, MEX.",1,0,1,0,0,32,
07-sep-22,TAMPS.,"JAUMAVE, TAMPS.",1,0,1,0,0,0,
07-sep-22,COAH.,"FRONTERA, COAH.",1,0,1,0,0,0,
07-sep-22,CD. MÉX.,"COYOACAN, CD. MÉX.",1,0,1,0,0,0,
07-sep-22,MÉX.,"TOLUCA, MEX.",1,0,1,0,0,267,
07-sep-22,TAMPS.,"MATAMOROS, TAMPS.",1,0,1,1,0,0,
09-sep-22,CD. MÉX.,"TLAHUAC, CD. MÉX.",1,0,1,0,0,178,
09-sep-22,CD. MÉX.,"AZCAPOTZALCO, CD. MÉX.",0,1,1,0,0,20,
12-sep-22,COAH.,"MÚZQUIZ, COAH.",0,1,1,0,0,0,
13-sep-22,MOR.,"CUERNAVACA, MOR.",0,1,1,4,1,738,
13-sep-22,TAMPS.,"MATAMOROS, TAMPS.",0,1,1,0,0,5,
14-sep-22,CD. MÉX.,"TLAHUAC, CD. MÉX.",1,0,1,0,0,0,
14-sep-22,TAMPS.,"JAUMAVE, TAMPS.",1,0,1,0,0,0,
15-sep-22,COAH.,"SABINAS, COAH.",0,1,1,0,0,12,
16-sep-22,COAH.,"SABINAS, COAH.",0,1,1,0,0,0,
17-sep-22,MÉX.,"NAUCALPAN DE JUAREZ, MEX.",0,1,1,0,0,1228,
17-sep-22,COAH.,"PIEDRAS NEGRAS, COAH.",1,0,1,0,0,724,
17-sep-22,COAH.,"ACUÑA, COAH.",0,1,1,0,0,0,
19-sep-22,CD. MÉX.,"CUAUHTEMOC, CD. MÉX.",1,0,1,0,3,55,
20-sep-22,CD. MÉX.,"TLAHUAC, CD. MÉX.",1,0,1,0,0,0,
20-sep-22,CD. MÉX.,"CUAUHTEMOC, CD. MÉX.",1,0,1,0,0,68,
20-sep-22,MOR.,"CUERNAVACA, MOR.",0,1,1,1,0,0,
20-sep-22,COAH.,"ACUÑA, COAH.",0,1,1,0,0,0,
21-sep-22,CD. MÉX.,"COYOACAN, CD. MÉX.",1,0,1,0,0,243,
21-sep-22,CD. MÉX.,"AZCAPOTZALCO, CD. MÉX.",1,0,1,0,0,0,
21-sep-22,VER.,"POZA RICA DE HGO., VER.",1,0,1,0,0,59,
22-sep-22,COAH.,"CASTAÑOS, COAH.",1,0,1,0,0,0,
22-sep-22,VER.,"POZA RICA DE HGO., VER.",1,0,1,1,0,90,
22-sep-22,CD. MÉX.,"COYOACAN, CD. MÉX.",1,0,1,0,0,0,
23-sep-22,COAH.,"CASTAÑOS, COAH.",1,0,1,0,0,0,
23-sep-22,TAMPS.,"JAUMAVE, TAMPS.",1,0,1,0,0,0,
23-sep-22,MÉX.,"TECAMAC, MEX.",1,0,1,0,0,0,
24-sep-22,MÉX.,"NEZAHUALCOYOTL, MEX.",1,0,1,0,0,357,
26-sep-22,CD. MÉX.,"GUSTAVO A. MADERO, CD. MÉX.",1,0,1,0,0,164,
26-sep-22,CD. MÉX.,"VENUSTIANO CARRANZA, CD. MÉX.",0,1,1,0,0,0,
26-sep-22,COAH.,"FRONTERA, COAH.",0,1,1,1,0,70,
26-sep-22,COAH.,"CASTAÑOS, COAH.",1,0,1,0,0,5,
26-sep-22,MÉX.,"OCOYOACAC, MEX.",1,0,1,0,0,14,
26-sep-22,MÉX.,"NEZAHUALCOYOTL, MEX.",1,0,1,0,0,0,
26-sep-22,N.L.,"APODACA, N.L.",1,0,1,6,0,58,
27-sep-22,MÉX.,"ALMOLOYA DE JUAREZ, MEX.",1,0,1,0,0,0,
27-sep-22,MÉX.,"NEZAHUALCOYOTL, MEX.",1,0,1,0,0,0,
27-sep-22,MOR.,"CUERNAVACA, MOR.",1,0,1,0,1,83,
28-sep-22,COAH.,"FRONTERA, COAH.",0,1,1,0,0,0,
28-sep-22,COAH.,"MONCLOVA, COAH.",1,0,1,0,0,0,
28-sep-22,MOR.,"CUERNAVACA, MOR.",1,0,1,0,0,4,
28-sep-22,MÉX.,"TECAMAC, MEX.",0,1,1,0,0,0,
29-sep-22,S.L.P.,"SAN LUIS POTOSI, S.L.P.",1,0,1,0,0,0,
29-sep-22,QRO.,"CORREGIDORA, QRO.",1,0,1,1,0,12,
29-sep-22,MÉX.,"ALMOLOYA DE JUAREZ, MEX.",0,1,1,0,0,0,
29-sep-22,MOR.,"CUERNAVACA, MOR.",0,1,1,7,7,358,
29-sep-22,CD. MÉX.,"VENUSTIANO CARRANZA, CD. MÉX.",0,1,1,0,3,0,
30-sep-22,CD. MÉX.,"GUSTAVO A. MADERO, CD. MÉX.",0,1,1,0,0,0,
30-sep-22,TAMPS.,"MATAMOROS, TAMPS.",1,0,1,1,0,238,
30-sep-22,CHIH.,"JUÁREZ, CHIH.",0,1,1,0,0,129,
01-oct-22,MÉX.,"NEZAHUALCOYOTL, MEX.",1,0,1,0,0,0,
03-oct-22,CD. MÉX.,"VENUSTIANO CARRANZA, CD. MÉX.",1,0,1,0,0,0,
03-oct-22,CD. MÉX.,"GUSTAVO A. MADERO, CD. MÉX.",1,0,1,0,0,59,
03-oct-22,CD. MÉX.,"LA MAGDALENA CONTRERAS, CD. MÉX.",1,0,1,0,0,6,
03-oct-22,MÉX.,"CHALCO, MEX.",1,0,1,0,0,106,
03-oct-22,TLAX.,"TEPETITLA DE LARDIZABAL, TLAX.",1,0,1,1,0,0,
03-oct-22,COAH.,"FRONTERA, COAH.",1,0,1,0,0,0,
03-oct-22,MÉX.,"XALATLACO, MEX.",1,0,1,0,0,0,
03-oct-22,MÉX.,"ATLACOMULCO, MEX.",0,1,1,0,0,0,
03-oct-22,TLAX.,"HUAMANTLA, TLAX.",0,1,1,0,0,0,
04-oct-22,CD. MÉX.,"CUAUHTEMOC, CD. MÉX.",1,0,1,0,0,41,
04-oct-22,COAH.,"MONCLOVA, COAH.",1,0,1,0,0,0,
04-oct-22,MÉX.,"XALATLACO, MEX.",1,0,1,0,0,0,
05-oct-22,VER.,"POZA RICA DE HGO., VER.",1,0,1,1,0,71,
06-oct-22,COAH.,"FRONTERA, COAH.",1,0,1,0,0,21,
06-oct-22,TLAX.,"TLAX., TLAX.",1,0,1,0,0,40,
06-oct-22,TLAX.,"HUAMANTLA, TLAX.",1,0,1,0,0,0,
06-oct-22,MÉX.,"TULTEPEC, MEX.",1,0,1,0,0,0,
07-oct-22,CD. MÉX.,"GUSTAVO A. MADERO, CD. MÉX.",0,1,1,0,0,283,
07-oct-22,TLAX.,"HUAMANTLA, TLAX.",0,1,1,0,0,0,
08-oct-22,TLAX.,"TLAX., TLAX.",0,1,1,0,0,0,
10-oct-22,SIN.,"CONCORDIA, SIN.",1,0,1,0,0,0,
10-oct-22,SIN.,"SAN IGNACIO, SIN.",0,1,1,0,0,0,
10-oct-22,JAL.,"PUERTO VALLARTA, JAL.",1,0,1,0,0,0,
11-oct-22,TLAX.,"TERRENATE, TLAX.",0,1,1,0,0,0,
11-oct-22,CHIH.,"JUÁREZ, CHIH.",1,0,1,2,0,200,
11-oct-22,CD. MÉX.,"ALVARO OBREGON, CD. MÉX.",1,0,1,0,0,85,
11-oct-22,CD. MÉX.,"TLALPAN, CD. MÉX.",1,0,1,0,0,2,
11-oct-22,SIN.,"SAN IGNACIO, SIN.",0,1,1,0,0,0,
12-oct-22,CD. MÉX.,"TLALPAN, CD. MÉX.",0,1,1,0,0,0,
12-oct-22,COAH.,"PIEDRAS NEGRAS, COAH.",1,0,1,0,0,0,
13-oct-22,SIN.,"SAN IGNACIO, SIN.",0,1,1,0,0,505,
14-oct-22,CD. MÉX.,"CUAUHTEMOC, CD. MÉX.",1,0,1,0,0,13,
14-oct-22,CD. MÉX.,"TLALPAN, CD. MÉX.",0,1,1,0,0,175,
14-oct-22,TLAX.,"APIZACO, TLAX.",0,1,1,0,0,0,
14-oct-22,TLAX.,"XALOZTOC, TLAX.",1,0,1,0,0,0,
14-oct-22,SIN.,"SAN IGNACIO, SIN.",1,0,1,0,0,1483,
14-oct-22,COAH.,"FRONTERA, COAH.",0,1,1,0,0,0,
14-oct-22,COAH.,"CUATROCIÉNEGAS, COAH.",1,0,1,0,0,10,
14-oct-22,MÉX.,"OTZOLOTEPEC, MEX.",1,0,1,0,0,80,
15-oct-22,MÉX.,"OTZOLOTEPEC, MEX.",1,0,1,0,1,0,
15-oct-22,TLAX.,"SANCTORUM DE LAZARO CARDENAS, TLAX.",0,1,1,0,0,0,
15-oct-22,TLAX.,"APIZACO, TLAX.",1,0,1,0,0,0,
15-oct-22,TLAX.,"XALOZTOC, TLAX.",1,0,1,0,0,0,
17-oct-22,TLAX.,"IXTACUIXTLA DE MARIANO MATAMOROS, TLAX.",1,0,1,0,0,0,
17-oct-22,TLAX.,"APETATITLAN DE ANTONIO CARVAJAL, TLAX.",1,0,1,0,0,0,
17-oct-22,MÉX.,"METEPEC, MEX.",1,0,1,0,0,0,
17-oct-22,CD. MÉX.,"TLALPAN, CD. MÉX.",0,1,1,0,0,225,
17-oct-22,TAMPS.,"NUEVO LAREDO, TAMPS.",1,0,1,0,0,298,
17-oct-22,MOR.,"PUENTE DE IXTLA, MOR.",1,0,1,0,0,26,
18-oct-22,MOR.,"PUENTE DE IXTLA, MOR.",0,1,1,0,0,0,
18-oct-22,TAMPS.,"NUEVO LAREDO, TAMPS.",0,1,1,0,0,0,
19-oct-22,CD. MÉX.,"VENUSTIANO CARRANZA, CD. MÉX.",1,0,1,0,0,0,
19-oct-22,CD. MÉX.,"ALVARO OBREGON, CD. MÉX.",1,0,1,0,0,365,
19-oct-22,B.C.,"SAN FELIPE, B.C.",0,1,1,0,0,0,
19-oct-22,COAH.,"CASTAÑOS, COAH.",0,1,1,0,0,0,
19-oct-22,SIN.,"CONCORDIA, SIN.",1,0,1,0,0,1242,
19-oct-22,TLAX.,"IXTACUIXTLA DE MARIANO MATAMOROS, TLAX.",0,1,1,0,0,0,
19-oct-22,MOR.,"PUENTE DE IXTLA, MOR.",0,1,1,0,0,0,
19-oct-22,TAMPS.,"NUEVO LAREDO, TAMPS.",0,1,1,0,0,258,
20-oct-22,CHIH.,"JUÁREZ, CHIH.",0,1,1,0,0,0,
20-oct-22,SIN.,"SAN IGNACIO, SIN.",1,0,1,0,0,42,
20-oct-22,MÉX.,"METEPEC, MEX.",1,0,1,0,2,0,
20-oct-22,TLAX.,"TLAX., TLAX.",1,0,1,0,0,0,
20-oct-22,TAMPS.,"NUEVO LAREDO, TAMPS.",1,0,1,0,0,260,
21-oct-22,CD. MÉX.,"TLALPAN, CD. MÉX.",1,0,1,0,12,0,
21-oct-22,MÉX.,"METEPEC, MEX.",1,0,1,0,0,20,
21-oct-22,TLAX.,"TLAX., TLAX.",0,1,1,0,0,0,
21-oct-22,TLAX.,"PANOTLA, TLAX.",1,0,1,0,0,0,
21-oct-22,MOR.,"YECAPIXTLA, MOR.",1,0,1,31,0,1570,
21-oct-22,TAMPS.,"NUEVO LAREDO, TAMPS.",1,0,1,0,0,27,
22-oct-22,MÉX.,"HUEHUETOCA, MEX.",1,0,1,0,0,0,
24-oct-22,CD. MÉX.,"ALVARO OBREGON, CD. MÉX.",1,0,1,0,0,92,
24-oct-22,SIN.,"MAZATLAN, SIN.",1,0,1,0,0,38,
25-oct-22,MÉX.,"LERMA, MEX.",0,1,1,0,0,0,
25-oct-22,MÉX.,"COYOTEPEC, MEX.",0,1,1,0,0,0,
26-oct-22,CD. MÉX.,"LA MAGDALENA CONTRERAS, CD. MÉX.",1,0,1,0,0,21,
26-oct-22,CD. MÉX.,"VENUSTIANO CARRANZA, CD. MÉX.",1,0,1,0,0,137,
26-oct-22,CD. MÉX.,"GUSTAVO A. MADERO, CD. MÉX.",1,0,1,0,0,0,
26-oct-22,CD. MÉX.,"TLALPAN, CD. MÉX.",0,1,1,0,0,0,
26-oct-22,TLAX.,"SANTA ANA NOPALUCAN, TLAX.",1,0,1,0,0,0,
26-oct-22,MÉX.,"LERMA, MEX.",1,0,1,0,0,0,
26-oct-22,N.L.,"GRAL. ESCOBEDO, N.L.",0,1,1,1,0,184,
26-oct-22,TAMPS.,"NUEVO LAREDO, TAMPS.",1,0,1,0,0,247,
27-oct-22,CD. MÉX.,"LA MAGDALENA CONTRERAS, CD. MÉX.",0,1,1,0,5,0,
27-oct-22,CD. MÉX.,"GUSTAVO A. MADERO, CD. MÉX.",1,0,1,0,0,46,
27-oct-22,CHIH.,"JUÁREZ, CHIH.",1,0,1,4,0,293,
27-oct-22,MÉX.,"MEXICALTZINGO, MEX.",1,0,1,0,0,0,
27-oct-22,MÉX.,"NEXTLALPAN, MEX., MEX.",1,0,1,0,0,0,
27-oct-22,MÉX.,"COYOTEPEC, MEX.",0,1,1,0,0,49,
27-oct-22,COAH.,"PIEDRAS NEGRAS, COAH.",1,0,1,0,0,154,
27-oct-22,N.L.,"GRAL. ESCOBEDO, N.L.",1,0,1,0,0,70,
28-oct-22,CHIH.,"JUÁREZ, CHIH.",1,0,1,4,0,22,
28-oct-22,COAH.,"FRONTERA, COAH.",0,1,1,0,1,0,
28-oct-22,TLAX.,"TLAX., TLAX.",1,0,1,0,0,0,
28-oct-22,MÉX.,"NEXTLALPAN, MEX., MEX.",1,0,1,0,0,191,
28-oct-22,MÉX.,"COYOTEPEC, MEX.",0,1,1,0,0,0,
29-oct-22,MÉX.,"LERMA, MEX.",0,1,1,0,0,0,
29-oct-22,TLAX.,"TLAX., TLAX.",0,1,1,0,0,0,
31-oct-22,CD. MÉX.,"TLALPAN, CD. MÉX.",1,0,1,0,0,0,
31-oct-22,SIN.,"ELOTA, SIN.",1,0,1,0,0,0,
31-oct-22,TLAX.,"TLAX., TLAX.",0,1,1,0,0,0,
01-nov-22,TLAX.,"IXTACUIXTLA DE MARIANO MATAMOROS, TLAX.",1,0,1,0,0,0,
01-nov-22,TLAX.,"CONTLA DE JUAN CUAMATZI, TLAX.",1,0,1,0,0,0,
01-nov-22,SIN.,"ELOTA, SIN.",1,0,1,0,0,0,
01-nov-22,CD. MÉX.,"TLAHUAC, CD. MÉX.",0,1,1,0,0,0,
02-nov-22,TLAX.,"IXTACUIXTLA DE MARIANO MATAMOROS, TLAX.",1,0,1,0,0,0,
02-nov-22,COAH.,"PIEDRAS NEGRAS, COAH.",0,1,1,0,0,250,
03-nov-22,CD. MÉX.,"CUAUHTEMOC, CD. MÉX.",1,0,1,0,0,7,
03-nov-22,CHIS.,"JIQUIPILAS, CHIS.",1,0,1,0,0,0,
03-nov-22,TAMPS.,"NUEVO LAREDO, TAMPS.",1,0,1,0,0,130,
04-nov-22,CD. MÉX.,"TLALPAN, CD. MÉX.",1,0,1,0,0,0,
05-nov-22,MÉX.,"SAN MATEO ATENCO, MEX.",1,0,1,0,0,51,
07-nov-22,CD. MÉX.,"CUAUHTEMOC, CD. MÉX.",1,0,1,0,0,50,
07-nov-22,CD. MÉX.,"GUSTAVO A. MADERO, CD. MÉX.",1,0,1,0,0,330,
07-nov-22,CHIS.,"BERRIOZÁBAL, CHIS.",1,0,1,0,0,0,
07-nov-22,CHIS.,"TUXTLA GUTIÉRREZ, CHIS.",1,0,1,0,0,0,
07-nov-22,COAH.,"SAN JUAN DE SABINAS, COAH.",0,1,1,0,0,0,
08-nov-22,CD. MÉX.,"CUAUHTEMOC, CD. MÉX.",0,1,1,0,0,0,
08-nov-22,SIN.,"ELOTA, SIN.",1,0,1,0,0,0,
08-nov-22,CHIS.,"TUXTLA GUTIÉRREZ, CHIS.",1,0,1,1,0,94,
08-nov-22,MÉX.,"IXTAPALUCA, MEX.",1,0,1,0,0,25,
08-nov-22,COAH.,"NUEVA ROSITA, COAH.",1,0,1,0,0,0,
08-nov-22,VER.,"ACAYUCAN, VER.",1,0,1,0,1,0,
09-nov-22,MÉX.,"SAN MARTIN DE LAS PIRAMIDES, MEX.",1,0,1,0,1,0,
09-nov-22,SIN.,"COSALA, SIN.",0,1,1,0,0,400,
09-nov-22,JAL.,"TOMATLAN, JAL.",0,1,1,0,0,0,
09-nov-22,JAL.,"MELAQUE, JAL.",1,0,1,0,0,0,
10-nov-22,MOR.,"AYALA, MOR.",1,0,1,0,0,400,
11-nov-22,JAL.,"AUTLAN DE NAVARRO, JAL.",0,1,1,0,0,0,
11-nov-22,JAL.,"PUERTO VALLARTA, JAL.",1,0,1,0,0,0,
11-nov-22,JAL.,"MELAQUE, JAL.",1,0,1,0,0,0,
11-nov-22,SIN.,"COSALA, SIN.",0,1,1,0,0,200,
13-nov-22,VER.,"PAPANTLA, VER.",0,1,1,0,0,19,
13-nov-22,JAL.,"TOMATLAN, JAL.",1,0,1,0,0,170,
14-nov-22,CD. MÉX.,"CUAUHTEMOC, CD. MÉX.",1,0,1,0,0,44,
14-nov-22,AGS.,"CALVILLO, AGS.",0,1,1,0,0,0,
14-nov-22,VER.,"PAPANTLA, VER.",0,1,1,0,0,30,
15-nov-22,CD. MÉX.,"IZTAPALAPA, CD. MÉX.",1,0,1,0,0,0,
15-nov-22,VER.,"PAPANTLA, VER.",0,1,1,2,0,306,
16-nov-22,VER.,"ACAYUCAN, VER.",1,0,1,1,0,0,
16-nov-22,JAL.,"PUERTO VALLARTA, JAL.",1,0,1,0,0,0,
16-nov-22,HGO.,"CUAUTEPEC DE HINOJOSA, HGO.",1,0,1,5,1,64,
17-nov-22,JAL.,"TOMATLAN, JAL.",0,1,1,0,0,0,
17-nov-22,HGO.,"ATOTONILCO DE TULA, HGO.",1,0,1,1,0,0,
18-nov-22,CD. MÉX.,"CUAUHTEMOC, CD. MÉX.",1,0,1,0,0,0,
18-nov-22,HGO.,"ATOTONILCO DE TULA, HGO.",1,0,1,1,0,39,
18-nov-22,VER.,"ACAYUCAN, VER.",1,0,1,7,0,117,
18-nov-22,CHIS.,"OCOSINGO, CHIS.",0,1,1,7,0,322,
18-nov-22,JAL.,"PUERTO VALLARTA, JAL.",1,0,1,0,0,0,
22-nov-22,JAL.,"PUERTO VALLARTA, JAL.",1,0,1,0,0,0,
23-nov-22,CD. MÉX.,"COYOACAN, CD. MÉX.",1,0,1,0,0,0,
23-nov-22,CHIS.,"CHIAPA DE CORZO, CHIS.",1,0,1,0,0,300,
23-nov-22,CHIS.,"COAPILLA, CHIS.",1,0,1,0,0,0,
24-nov-22,CHIS.,"CHIAPA DE CORZO, CHIS.",1,0,1,0,0,246,
24-nov-22,CHIS.,"TONALÁ, CHIS.",1,0,1,0,0,0,
25-nov-22,CD. MÉX.,"TLAHUAC, CD. MÉX.",1,0,1,0,0,0,
25-nov-22,JAL.,"PUERTO VALLARTA, JAL.",0,1,1,0,0,0,
25-nov-22,CHIS.,"TAPACHULA, CHIS.",1,0,1,0,0,122,
25-nov-22,Q. ROO.,"BENITO JUAREZ, Q. ROO",0,1,1,2,0,1265,
27-nov-22,Q. ROO.,"BENITO JUAREZ, Q. ROO",0,1,1,2,0,104,
28-nov-22,CHIS.,"CHIAPA DE CORZO, CHIS.",1,0,1,0,0,210,
28-nov-22,CHIS.,"COMITAN DE DOMÍNGUEZ, CHIS.",0,1,1,1,0,124,
30-nov-22,CD. MÉX.,"AZCAPOTZALCO, CD. MÉX.",1,0,1,0,0,0,
30-nov-22,CD. MÉX.,"TLAHUAC, CD. MÉX.",0,1,1,0,0,41,
30-nov-22,JAL.,"PUERTO VALLARTA, JAL.",1,0,1,3,0,23,
30-nov-22,JAL.,"MELAQUE, JAL.",0,1,1,0,0,0,
01-dic-22,CD. MÉX.,"TLAHUAC, CD. MÉX.",0,1,1,0,0,0,
01-dic-22,B.C.,"SAN FELIPE, B.C.",1,0,1,3,0,23,
02-dic-22,JAL.,"MELAQUE, JAL.",1,0,1,0,0,0,
03-dic-22,S.L.P.,"ZARAGOZA, S.L.P.",1,0,1,0,0,0,
05-dic-22,CD. MÉX.,"VENUSTIANO CARRANZA, CD. MÉX.",1,0,1,0,0,45,
05-dic-22,CD. MÉX.,"TLAHUAC, CD. MÉX.",1,0,1,0,0,0,
05-dic-22,SON.,"HERMOSILLO, SON.",1,0,1,0,0,0,
07-dic-22,CHIH.,"JUÁREZ, CHIH.",1,0,1,3,0,65,
08-dic-22,CHIH.,"JUÁREZ, CHIH.",0,1,1,0,0,0,
09-dic-22,CD. MÉX.,"VENUSTIANO CARRANZA, CD. MÉX.",1,0,1,0,0,79,
09-dic-22,CHIH.,"JUÁREZ, CHIH.",1,0,1,7,0,60,
09-dic-22,CHIH.,"OJINAGA, CHIH.",1,0,1,1,0,0,
09-dic-22,S.L.P.,"ZARAGOZA, S.L.P.",0,1,1,0,0,0,
12-dic-22,SON.,"HERMOSILLO, SON.",0,1,1,0,1,0,
13-dic-22,CD. MÉX.,"GUSTAVO A. MADERO, CD. MÉX.",1,0,1,0,0,0,
13-dic-22,TAMPS.,"MATAMOROS, TAMPS.",1,0,1,0,0,0,
14-dic-22,SIN.,"CULIACAN, SIN.",1,0,1,0,0,971,
15-dic-22,CD. MÉX.,"COYOACAN, CD. MÉX.",0,1,1,0,0,40,
16-dic-22,CHIH.,"JUÁREZ, CHIH.",1,0,1,16,0,170,
27-ene-23,Jalisco,"AUTLAN DE NAVARRO, JAL.",1,0,1,0,0,0,
04-feb-23,Jalisco,"CUAUTITLAN DE GARCIA BARRAGAN, JAL.",1,0,1,0,0,0,
09-feb-23,Jalisco,"AUTLAN DE NAVARRO, JAL.",1,0,1,0,0,0,
10-feb-23,Cd. de México,"ALVARO OBREGON, CD. MÉX.",1,0,1,0,0,90,
10-feb-23,Cd. de México,"TLALPAN, CD. MÉX.",1,0,1,0,0,884,
14-feb-23,Tamaulipas,"NUEVO LAREDO, TAMPS.",0,1,1,1,0,114,
14-feb-23,Cd. de México,"TLALPAN, CD. MÉX.",1,0,1,0,0,52,
15-feb-23,Cd. de México,"TLAHUAC, CD. MÉX.",1,0,1,0,0,223,
16-feb-23,Cd. de México,"ALVARO OBREGON, CD. MÉX.",1,0,1,0,0,0,
16-feb-23,Cd. de México,"ALVARO OBREGON, CD. MÉX.",1,0,1,0,0,0,
16-feb-23,Tamaulipas,"NUEVO LAREDO, TAMPS.",0,1,1,2,0,652,
17-feb-23,Tamaulipas,"NUEVO LAREDO, TAMPS.",1,0,1,6,0,363,
20-feb-23,Cd. de México,"ALVARO OBREGON, CD. MÉX.",1,0,1,0,0,0,
20-feb-23,Cd. de México,"BENITO JUAREZ, CD. MÉX.",1,0,1,0,0,32,
27-feb-23,Tamaulipas,"NUEVO LAREDO, TAMPS.",1,0,1,0,0,0,
27-feb-23,Cd. de México,"CUAUHTEMOC, CD. MÉX.",1,0,1,0,0,55,
27-feb-23,Cd. de México,"AZCAPOTZALCO, CD. MÉX.",1,0,1,0,0,1,
01-mar-23,Morelos,"ZACATEPEC, MOR.",0,1,1,0,0,0,
03-mar-23,Cd. de México,"IZTAPALAPA, CD. MÉX.",1,0,1,0,0,0,
03-mar-23,Veracruz,"LA PERLA, VER.",1,0,1,0,0,0,
03-mar-23,Chiapas,"COMITAN DE DOMÍNGUEZ, CHIS.",1,0,1,0,0,165,
03-mar-23,Coahuila,"ACUÑA, COAH.",0,1,1,0,0,0,
03-mar-23,Cd. de México,"CUAUHTEMOC, CD. MÉX.",0,1,1,0,0,9,
04-mar-23,Veracruz,"JALTIPAN, VER.",1,0,1,0,0,"10,882",
05-mar-23,Veracruz,"LA PERLA, VER.",1,0,1,0,0,0,
06-mar-23,Cd. de México,"CUAUHTEMOC, CD. MÉX.",0,1,1,0,0,0,
07-mar-23,Cd. de México,"IZTAPALAPA, CD. MÉX.",1,0,1,0,0,0,
07-mar-23,Cd. de México,"CUAUHTEMOC, CD. MÉX.",1,0,1,0,0,66,
07-mar-23,Cd. de México,"IZTACALCO, CD. MÉX.",1,0,1,0,0,2,
08-mar-23,México,"COACALCO DE BERRIOZABAL, MEX.",1,0,1,0,0,0,
08-mar-23,Cd. de México,"AZCAPOTZALCO, CD. MÉX.",1,0,1,0,0,46,
08-mar-23,México,"ATIZAPAN, MEX.",1,0,1,0,0,6,
09-mar-23,Coahuila,"ACUÑA, COAH.",0,1,1,0,0,0,
09-mar-23,México,"ATIZAPAN, MEX.",1,0,1,0,0,51,
09-mar-23,México,"COACALCO DE BERRIOZABAL, MEX.",1,0,1,1,0,52,
10-mar-23,Cd. de México,"IZTACALCO, CD. MÉX.",1,0,1,0,0,0,
10-mar-23,Veracruz,"JALTIPAN, VER.",1,0,1,1,0,"4,957",
10-mar-23,Cd. de México,"IZTAPALAPA, CD. MÉX.",0,1,1,0,0,0,
14-mar-23,Veracruz,"JALTIPAN, VER.",1,0,1,27,0,"4,287",
14-mar-23,Cd. de México,"IZTAPALAPA, CD. MÉX.",1,0,1,0,0,0,
14-mar-23,Chiapas,"COMITAN DE DOMÍNGUEZ, CHIS.",0,1,1,2,0,179,
15-mar-23,Cd. de México,"IZTAPALAPA, CD. MÉX.",1,0,1,0,0,0,
16-mar-23,Cd. de México,"IZTACALCO, CD. MÉX.",1,0,1,0,0,158,
16-mar-23,Veracruz,"JALTIPAN, VER.",0,1,1,68,0,"3,053",
17-mar-23,Cd. de México,"IZTAPALAPA, CD. MÉX.",1,0,1,0,0,34,
17-mar-23,México,"ECATEPEC DE MORELOS, MEX.",1,0,1,0,0,0,
18-mar-23,México,"COACALCO DE BERRIOZABAL, MEX.",1,0,1,0,0,89,
22-mar-23,Cd. de México,"GUSTAVO A. MADERO, CD. MÉX.",1,0,1,0,0,0,
23-mar-23,Cd. de México,"GUSTAVO A. MADERO, CD. MÉX.",1,0,1,0,0,113,
23-mar-23,Guanajuato,"SAN DIEGO DE LA UNION, GTO.",1,0,1,0,0,0,
24-mar-23,Cd. de México,"TLAHUAC, CD. MÉX.",1,0,1,0,0,0,
25-mar-23,México,"NAUCALPAN DE JUAREZ, MEX.",1,0,1,0,0,0,
27-mar-23,Cd. de México,"LA MAGDALENA CONTRERAS, CD. MÉX.",1,0,1,0,0,0,
27-mar-23,Chiapas,"LA TRINITARIA, CHIS.",0,1,1,1,0,204,
27-mar-23,Guanajuato,"SAN DIEGO DE LA UNION, GTO.",1,0,1,0,0,0,
27-mar-23,Coahuila,"PIEDRAS NEGRAS, COAH.",0,1,1,0,0,0,
28-mar-23,México,"NAUCALPAN DE JUAREZ, MEX.",1,0,1,0,0,0,
29-mar-23,Cd. de México,"TLAHUAC, CD. MÉX.",1,0,1,0,1,3,
29-mar-23,México,"CUAUTITLAN IZCALLI, MEX.",1,0,1,0,4,0,
29-mar-23,México,"TOLUCA, MEX.",1,0,1,0,0,0,
30-mar-23,Cd. de México,"LA MAGDALENA CONTRERAS, CD. MÉX.",1,0,1,0,0,0,
30-mar-23,México,"NAUCALPAN DE JUAREZ, MEX.",1,0,1,0,0,0,
30-mar-23,México,"TLALNEPANTLA DE BAZ, MEX.",0,1,1,0,0,219,
30-mar-23,México,"CUAUTITLAN IZCALLI, MEX.",1,0,1,0,0,0,
31-mar-23,Coahuila,"MONCLOVA, COAH.",0,1,1,0,0,1,
31-mar-23,Cd. de México,"LA MAGDALENA CONTRERAS, CD. MÉX.",1,0,1,0,0,0,
31-mar-23,Cd. de México,"ALVARO OBREGON, CD. MÉX.",1,0,1,0,0,28,
31-mar-23,México,"TOLUCA, MEX.",0,1,1,0,0,0,
10-abr-23,Coahuila,"PIEDRAS NEGRAS, COAH.",1,0,1,1,0,11,
11-abr-23,Cd. de México,"TLAHUAC, CD. MÉX.",1,0,1,0,0,0,
11-abr-23,Guanajuato,"ACAMBARO, GTO.",1,0,1,0,0,0,
13-abr-23,Morelos,"TEMIXCO, MOR.",1,0,1,0,0,0,
13-abr-23,Cd. de México,"AZCAPOTZALCO, CD. MÉX.",1,0,1,0,0,0,
14-abr-23,Cd. de México,"TLALPAN, CD. MÉX.",0,1,1,0,0,0,
19-abr-23,Cd. de México,"BENITO JUAREZ, CD. MÉX.",1,0,1,0,0,150,
20-abr-23,Cd. de México,"CUAUHTEMOC, CD. MÉX.",1,0,1,0,0,0,
20-abr-23,Querétaro,"CORREGIDORA, QRO.",0,1,1,0,0,0,
21-abr-23,Cd. de México,"IZTAPALAPA, CD. MÉX.",1,0,1,0,0,0,
21-abr-23,Cd. de México,"CUAUHTEMOC, CD. MÉX.",1,0,1,0,1,158,
24-abr-23,Cd. de México,"BENITO JUAREZ, CD. MÉX.",1,0,1,0,0,21,
25-abr-23,Cd. de México,"IZTAPALAPA, CD. MÉX.",1,0,1,0,0,12,
25-abr-23,Cd. de México,"CUAUHTEMOC, CD. MÉX.",1,0,1,0,0,58,
25-abr-23,Cd. de México,"IZTACALCO, CD. MÉX.",0,1,1,0,0,0,
27-abr-23,Cd. de México,"COYOACAN, CD. MÉX.",1,0,1,0,0,0,
28-abr-23,Cd. de México,"IZTACALCO, CD. MÉX.",1,0,1,0,0,36,
02-may-23,Michoacán,"MORELIA, MICH.",0,1,1,2,0,0,
03-may-23,Cd. de México,"IZTACALCO, CD. MÉX.",0,1,1,0,0,111,
03-may-23,Querétaro,"CORREGIDORA, QRO.",1,0,1,0,0,0,
04-may-23,Cd. de México,"IZTAPALAPA, CD. MÉX.",1,0,1,0,0,0,
04-may-23,Michoacán,"MORELIA, MICH.",0,1,1,70,0,156,
05-may-23,Sinaloa,"NAVOLATO, SIN.",0,1,1,0,0,0,
06-may-23,Cd. de México,"XOCHIMILCO, CD. MÉX.",1,0,1,0,0,0,
08-may-23,Querétaro,"CORREGIDORA, QRO.",1,0,1,0,0,0,
10-may-23,Cd. de México,"MIGUEL HIDALGO, CD. MÉX.",1,0,1,0,0,24,
10-may-23,Querétaro,"CORREGIDORA, QRO.",1,0,1,0,1,0,
11-may-23,Cd. de México,"MIGUEL HIDALGO, CD. MÉX.",0,1,1,0,0,34,
11-may-23,Cd. de México,"CUAUHTEMOC, CD. MÉX.",1,0,1,0,0,119,
11-may-23,Sinaloa,"NAVOLATO, SIN.",1,0,1,0,0,681,
12-may-23,Cd. de México,"MIGUEL HIDALGO, CD. MÉX.",0,1,1,0,0,55,
12-may-23,Cd. de México,"CUAUHTEMOC, CD. MÉX.",1,0,1,0,0,169,
13-may-23,Michoacán,"TARIMBARO, MICH.",1,0,1,58,0,0,
14-may-23,Querétaro,"SAN JUAN DEL RIO, QRO.",0,1,1,3,0,55,
15-may-23,Michoacán,"JACONA, MICH.",0,1,1,1,0,32,
17-may-23,Querétaro,"SAN JUAN DEL RIO, QRO.",1,0,1,0,0,0,
17-may-23,Michoacán,"JACONA, MICH.",0,1,1,10,0,221,
17-may-23,Cd. de México,"GUSTAVO A. MADERO, CD. MÉX.",0,1,1,0,0,0,
19-may-23,Cd. de México,"GUSTAVO A. MADERO, CD. MÉX.",1,0,1,0,0,142,
22-may-23,Cd. de México,"CUAUHTEMOC, CD. MÉX.",1,0,1,0,0,217,
25-may-23,Cd. de México,"AZCAPOTZALCO, CD. MÉX.",1,0,1,0,0,10,
28-may-23,Michoacán,"HIDALGO, MICH.",0,1,1,4,0,0,
29-may-23,Querétaro,"QUERETARO, QRO.",0,1,1,0,0,15,
30-may-23,Sinaloa,"CHOIX, SIN.",1,0,1,0,0,0,
31-may-23,Michoacán,"HIDALGO, MICH.",1,0,1,2,0,0,
04-jun-23,Aguascalientes,"SAN FRANCISCO DE LOS ROMO, AGS.",1,0,1,0,0,25,
04-jun-23,Aguascalientes,"PABELLÓN DE ARTEAGA, AGS.",1,0,1,0,0,48,
07-jun-23,Sinaloa,"CHOIX, SIN.",0,1,1,0,0,0,
07-jun-23,Cd. de México,"COYOACAN, CD. MÉX.",1,0,1,0,0,150,
08-jun-23,Querétaro,"QUERETARO, QRO.",0,1,1,0,0,100,
09-jun-23,Cd. de México,"ALVARO OBREGON, CD. MÉX.",1,0,1,0,0,0,
09-jun-23,Sinaloa,"SINALOA, SIN.",1,0,1,0,0,0,
11-jun-23,Aguascalientes,"CALVILLO, AGS.",1,0,1,1,0,70,
14-jun-23,Querétaro,"QUERETARO, QRO.",0,1,1,0,0,0,
14-jun-23,México,"JILOTEPEC, MEX.",1,0,1,0,0,36,
15-jun-23,Puebla,"ATLIXCO, PUE.",1,0,1,1,0,0,
15-jun-23,Chihuahua,"NUEVO CASAS GRANDES, CHIH.",1,0,1,1,0,272,
16-jun-23,Chihuahua,"NUEVO CASAS GRANDES, CHIH.",0,1,1,0,0,0,
16-jun-23,México,"JILOTEPEC, MEX.",1,0,1,1,0,0,
16-jun-23,Cd. de México,"VENUSTIANO CARRANZA, CD. MÉX.",0,1,1,0,0,0,
17-jun-23,México,"LERMA, MEX.",1,0,1,0,0,43,
18-jun-23,Aguascalientes,"JESÚS MARÍA, AGS.",1,0,1,0,0,982,
19-jun-23,Tlaxcala,"TLAXCALA, TLAX.",1,0,1,0,0,0,
19-jun-23,México,"ZINACANTEPEC, MEX.",1,0,1,0,0,0,
20-jun-23,Tlaxcala,"TLAXCALA, TLAX.",1,0,1,0,0,0,
20-jun-23,Tlaxcala,"HUAMANTLA, TLAX.",1,0,1,0,0,0,
20-jun-23,Puebla,"ATLIXCO, PUE.",1,0,1,0,0,50,
20-jun-23,Cd. de México,"CUAUHTEMOC, CD. MÉX.",1,0,1,0,0,7,
21-jun-23,Querétaro,"QUERETARO, QRO.",1,0,1,2,0,75,
21-jun-23,Tlaxcala,"HUAMANTLA, TLAX.",0,1,1,0,0,0,
21-jun-23,Tlaxcala,"APIZACO, TLAX.",1,0,1,0,0,0,
21-jun-23,Cd. de México,"VENUSTIANO CARRANZA, CD. MÉX.",1,0,1,0,0,0,
21-jun-23,México,"ZINACANTEPEC, MEX.",1,0,1,0,0,7,
22-jun-23,México,"NICOLAS ROMERO, MEX.",1,0,1,0,0,197,
23-jun-23,Querétaro,"QUERETARO, QRO.",1,0,1,4,0,0,
23-jun-23,Puebla,"ATLIXCO, PUE.",0,1,1,0,0,295,
23-jun-23,Cd. de México,"VENUSTIANO CARRANZA, CD. MÉX.",0,1,1,0,0,0,
23-jun-23,Morelos,"CUERNAVACA, MOR.",1,0,1,0,0,0,
23-jun-23,Tlaxcala,"TLAXCALA, TLAX.",1,0,1,0,0,0,
24-jun-23,Guanajuato,"VALLE DE SANTIAGO, GTO.",1,0,1,0,0,99,
24-jun-23,Veracruz,"MARTINEZ DE LA TORRE, VER.",1,0,1,1,0,78,
24-jun-23,México,"NICOLAS ROMERO, MEX.",1,0,1,0,0,20,
24-jun-23,Tlaxcala,"CONTLA DE JUAN CUAMATZI, TLAX.",0,1,1,0,0,0,
26-jun-23,Tlaxcala,"PANOTLA, TLAX.",1,0,1,0,0,0,
26-jun-23,Veracruz,"MISANTLA, VER.",1,0,1,0,0,0,
26-jun-23,México,"VILLA VICTORIA, MEX.",1,0,1,0,0,0,
26-jun-23,Tlaxcala,"TLAXCALA, TLAX.",0,1,1,0,0,0,
27-jun-23,Puebla,"ATLIXCO, PUE.",0,1,1,0,0,156,
27-jun-23,Tlaxcala,"IXTACUIXTLA DE MARIANO MATAMOROS, TLAX.",0,1,1,0,0,0,
27-jun-23,Cd. de México,"VENUSTIANO CARRANZA, CD. MÉX.",1,0,1,0,0,53,
27-jun-23,Cd. de México,"CUAUHTEMOC, CD. MÉX.",1,0,1,0,0,358,
28-jun-23,México,"METEPEC, MEX.",1,0,1,0,0,30,
28-jun-23,Guanajuato,"APASEO EL GRANDE, GTO.",1,0,1,0,0,"7,708",
29-jun-23,Sinaloa,"ANGOSTURA, SIN.",1,0,1,0,0,0,
29-jun-23,Tlaxcala,"TLAXCALA, TLAX.",1,0,1,0,0,0,
30-jun-23,Tlaxcala,"TLAXCALA, TLAX.",1,0,1,0,0,0,
30-jun-23,Tlaxcala,"CALPULALPAN, TLAX.",1,0,1,0,0,0,
30-jun-23,Tlaxcala,"PANOTLA, TLAX.",1,0,1,0,0,0,
30-jun-23,Sinaloa,"ANGOSTURA, SIN.",1,0,1,0,0,0,
30-jun-23,Cd. de México,"CUAUHTEMOC, CD. MÉX.",1,0,1,0,0,62,
30-jun-23,Cd. de México,"ALVARO OBREGON, CD. MÉX.",0,1,1,0,0,0,
01-jul-23,Tlaxcala,"TLAXCALA, TLAX.",1,0,1,0,0,0,
03-jul-23,Sinaloa,"ANGOSTURA, SIN.",1,0,1,0,0,0,
04-jul-23,Chiapas,"SAN CRISTOBAL DE LAS CASAS, CHIS.",0,1,1,0,0,64,
04-jul-23,Tlaxcala,"SAN PABLO DEL MONTE, TLAX.",1,0,1,0,0,0,
04-jul-23,Cd. de México,"MIGUEL HIDALGO, CD. MÉX.",0,1,1,0,0,0,
04-jul-23,Tamaulipas,"VICTORIA, TAMPS.",0,1,1,0,0,0,
05-jul-23,Chiapas,"CHIAPA DE CORZO, CHIS.",0,1,1,0,0,0,
05-jul-23,Chiapas,"SAN CRISTOBAL DE LAS CASAS, CHIS.",0,1,1,0,0,0,
05-jul-23,Tlaxcala,"SAN PABLO DEL MONTE, TLAX.",1,0,1,0,0,0,
05-jul-23,Tlaxcala,"SANTA CRUZ TLAXCALA, TLAX.",1,0,1,0,0,0,
05-jul-23,Sinaloa,"ANGOSTURA, SIN.",0,1,1,0,0,0,
05-jul-23,Tamaulipas,"VICTORIA, TAMPS.",0,1,1,0,0,0,
05-jul-23,Cd. de México,"CUAUHTEMOC, CD. MÉX.",1,0,1,0,0,146,
06-jul-23,Chiapas,"CHIAPA DE CORZO, CHIS.",1,0,1,0,0,0,
06-jul-23,Cd. de México,"BENITO JUAREZ, CD. MÉX.",1,0,1,0,0,19,
06-jul-23,Sinaloa,"ANGOSTURA, SIN.",1,0,1,0,0,0,
06-jul-23,Tlaxcala,"SANTA CRUZ TLAXCALA, TLAX.",0,1,1,0,0,0,
06-jul-23,Veracruz,"VEGA DE ALATORRE, VER.",1,0,1,0,0,0,
07-jul-23,Cd. de México,"CUAUHTEMOC, CD. MÉX.",1,0,1,0,0,13,
07-jul-23,México,"VALLE DE CHALCO SOLIDARIDAD, MEX.",0,1,1,0,0,0,
07-jul-23,Tlaxcala,"SAN PABLO DEL MONTE, TLAX.",0,1,1,0,0,0,
07-jul-23,México,"OTZOLOTEPEC, MEX.",1,0,1,0,0,138,
07-jul-23,Tlaxcala,"TLAXCALA, TLAX.",1,0,1,0,0,0,
07-jul-23,Tlaxcala,"SANTA CRUZ TLAXCALA, TLAX.",0,1,1,0,0,0,
07-jul-23,Chiapas,"CHIAPA DE CORZO, CHIS.",1,0,1,0,0,0,
08-jul-23,México,"CHALCO, MEX.",0,1,1,0,2,14,
08-jul-23,Veracruz,"VEGA DE ALATORRE, VER.",0,1,1,28,0,"2,420",
09-jul-23,Tlaxcala,"TLAXCALA, TLAX.",0,1,1,0,0,0,
09-jul-23,Tlaxcala,"TEOLOCHOLCO, TLAX.",1,0,1,0,0,0,
10-jul-23,Cd. de México,"CUAUHTEMOC, CD. MÉX.",1,0,1,0,0,0,
10-jul-23,Tlaxcala,"TERRENATE, TLAX.",1,0,1,0,0,0,
10-jul-23,México,"VALLE DE BRAVO, MEX.",1,0,1,0,0,0,
11-jul-23,Tlaxcala,"APIZACO, TLAX.",0,1,1,0,0,0,
11-jul-23,Tlaxcala,"TERRENATE, TLAX.",1,0,1,0,0,0,
11-jul-23,México,"CHIMALHUACAN, MEX.",1,0,1,0,0,0,
12-jul-23,Cd. de México,"IZTAPALAPA, CD. MÉX.",1,0,1,0,0,49,
12-jul-23,México,"COYOTEPEC, MEX.",1,0,1,0,0,15,
12-jul-23,Tamaulipas,"VICTORIA, TAMPS.",1,0,1,0,0,0,
13-jul-23,México,"IXTAPAN DE LA SAL, MEX.",0,1,1,0,0,0,
13-jul-23,Chiapas,"CHIAPA DE CORZO, CHIS.",1,0,1,0,0,212,
14-jul-23,Chiapas,"TUXTLA GUTIÉRREZ, CHIS.",1,0,1,0,0,677,
14-jul-23,México,"IXTAPAN DE LA SAL, MEX.",0,1,1,0,0,0,
14-jul-23,Tlaxcala,"TERRENATE, TLAX.",0,1,1,0,0,0,
15-jul-23,Chiapas,"TAPACHULA, CHIS.",1,0,1,0,2,72,
15-jul-23,Chiapas,"OCOZOCOAUTLA DE ESPINOSA, CHIS.",0,1,1,0,0,362,
15-jul-23,Tlaxcala,"APIZACO, TLAX.",1,0,1,0,0,0,
15-jul-23,Tlaxcala,"TETLA DE LA SOLIDARIDAD, TLAX.",0,1,1,0,0,0,
15-jul-23,Tlaxcala,"TLAXCALA, TLAX.",1,0,1,0,0,0,
15-jul-23,México,"IXTAPAN DE LA SAL, MEX.",0,1,1,0,0,0,
15-jul-23,México,"VALLE DE BRAVO, MEX.",1,0,1,0,0,0,
17-jul-23,Tlaxcala,"EMILIANO ZAPATA, TLAX.",1,0,1,0,0,0,
17-jul-23,Tlaxcala,"ZACATELCO, TLAX.",1,0,1,0,0,0,
17-jul-23,Cd. de México,"CUAUHTEMOC, CD. MÉX.",1,0,1,0,0,41,
17-jul-23,Chiapas,"MAZAPA DE MADERO, CHIS.",1,0,1,1,0,0,
18-jul-23,Chiapas,"TAPACHULA, CHIS.",1,0,1,810,0,0,
18-jul-23,Tlaxcala,"EMILIANO ZAPATA, TLAX.",0,1,1,0,0,0,
18-jul-23,Querétaro,"CORREGIDORA, QRO.",1,0,1,3,0,20,
19-jul-23,Cd. de México,"CUAUHTEMOC, CD. MÉX.",1,0,1,0,0,348,
19-jul-23,Tlaxcala,"EMILIANO ZAPATA, TLAX.",1,0,1,0,0,0,
19-jul-23,Chiapas,"BERRIOZÁBAL, CHIS.",1,0,1,0,0,913,
19-jul-23,Chiapas,"OCOSINGO, CHIS.",1,0,1,1,0,87,
20-jul-23,Cd. de México,"CUAUHTEMOC, CD. MÉX.",0,1,1,0,0,0,
20-jul-23,Tlaxcala,"ZACATELCO, TLAX.",1,0,1,0,0,0,
22-jul-23,Durango,"GOMEZ PALACIO, DGO.",1,0,1,1,0,22,
22-jul-23,Querétaro,"CORREGIDORA, QRO.",1,0,1,8,0,500,
22-jul-23,Durango,"DURANGO, DGO.",1,0,1,1,0,0,
24-jul-23,Chiapas,"BERRIOZÁBAL, CHIS.",1,0,1,0,0,600,
26-jul-23,Cd. de México,"CUAUHTEMOC, CD. MÉX.",1,0,1,0,0,0,
27-jul-23,Chiapas,"VILLAFLORES, CHIS.",0,1,1,0,0,618,
28-jul-23,Cd. de México,"MIGUEL HIDALGO, CD. MÉX.",1,0,1,0,0,23,
28-jul-23,Chiapas,"HUIXTÁN, CHIS.",0,1,1,0,0,250,
28-jul-23,Chiapas,"LA INDEPENDENCIA, CHIS.",1,0,1,0,0,55,
30-jul-23,Chiapas,"LA INDEPENDENCIA, CHIS.",1,0,1,0,0,90,
31-jul-23,Baja California Sur,"LA PAZ, B.C.S.",1,0,1,0,0,0,
01-ago-23,México,"XONACATLAN, MEX.",1,0,1,0,0,64,
01-ago-23,México,"CHICOLOAPAN, MEX.",1,0,1,0,0,2,
02-ago-23,México,"HUIXQUILUCAN, MEX.",1,0,1,0,0,108,
03-ago-23,Chiapas,"SUCHIATE, CHIS.",1,0,1,0,0,0,
03-ago-23,Tamaulipas,"VICTORIA, TAMPS.",1,0,1,0,0,0,
03-ago-23,Cd. de México,"IZTAPALAPA, CD. MÉX.",1,0,1,0,0,0,
03-ago-23,Cd. de México,"VENUSTIANO CARRANZA, CD. MÉX.",1,0,1,0,0,0,
04-ago-23,México,"CUAUTITLAN, MEX.",1,0,1,0,18,0,
07-ago-23,Cd. de México,"IZTAPALAPA, CD. MÉX.",1,0,1,0,0,44,
08-ago-23,México,"SAN MARTIN DE LAS PIRAMIDES, MEX.",1,0,1,0,0,6,
08-ago-23,Chiapas,"TAPACHULA, CHIS.",1,0,1,0,0,20,
08-ago-23,México,"MALINALCO, MEX.",1,0,1,0,0,0,
09-ago-23,México,"MALINALCO, MEX.",1,0,1,0,0,0,
09-ago-23,Cd. de México,"CUAUHTEMOC, CD. MÉX.",1,0,1,0,0,6,
10-ago-23,Chiapas,"CHENALHÓ, CHIS.",0,1,1,0,0,0,
10-ago-23,Cd. de México,"IZTACALCO, CD. MÉX.",0,1,1,0,0,0,
10-ago-23,Tamaulipas,"VICTORIA, TAMPS.",1,0,1,0,0,0,
10-ago-23,México,"TEPETLAOXTOC, MEX.",0,1,1,0,0,0,
10-ago-23,Chiapas,"LA INDEPENDENCIA, CHIS.",1,0,1,0,0,0,
11-ago-23,México,"MALINALCO, MEX.",1,0,1,0,0,0,
12-ago-23,México,"MALINALCO, MEX.",0,1,1,0,0,0,
12-ago-23,México,"SAN MARTIN DE LAS PIRAMIDES, MEX.",0,1,1,0,0,0,
12-ago-23,México,"TEPETLAOXTOC, MEX.",1,0,1,0,0,39,
13-ago-23,Michoacán,"ALVARO OBREGON, MICH.",0,1,1,0,0,42,
14-ago-23,Puebla,"PALMAR DE BRAVO, PUE.",1,0,1,0,0,91,
14-ago-23,Sinaloa,"BADIRAGUATO, SIN.",0,1,1,0,0,0,
14-ago-23,Cd. de México,"TLAHUAC, CD. MÉX.",1,0,1,0,0,0,
14-ago-23,Cd. de México,"CUAUHTEMOC, CD. MÉX.",1,0,1,0,0,7,
14-ago-23,Tamaulipas,"VICTORIA, TAMPS.",1,0,1,0,0,0,
15-ago-23,Cd. de México,"GUSTAVO A. MADERO, CD. MÉX.",1,0,1,0,0,0,
15-ago-23,Cd. de México,"TLAHUAC, CD. MÉX.",0,1,1,0,0,0,
15-ago-23,Puebla,"PALMAR DE BRAVO, PUE.",1,0,1,0,0,91,
15-ago-23,Guerrero,"EDUARDO NERI, GRO.",1,0,1,0,0,0,
16-ago-23,Michoacán,"ALVARO OBREGON, MICH.",1,0,1,0,0,0,
16-ago-23,Tamaulipas,"VICTORIA, TAMPS.",1,0,1,0,0,0,
16-ago-23,Querétaro,"PEDRO ESCOBEDO, QRO.",1,0,1,0,0,0,
16-ago-23,Sinaloa,"BADIRAGUATO, SIN.",1,0,1,0,0,0,
17-ago-23,Querétaro,"CADEREYTA DE MONTES, QRO.",1,0,1,0,0,16,
17-ago-23,Cd. de México,"IZTACALCO, CD. MÉX.",0,1,1,0,0,0,
18-ago-23,Sinaloa,"SALVADOR ALVARADO, SIN.",1,0,1,0,0,93,
18-ago-23,Sinaloa,"MOCORITO, SIN.",0,1,1,0,0,0,
19-ago-23,Michoacán,"CUITZEO, MICH.",0,1,1,0,0,0,
19-ago-23,Querétaro,"CADEREYTA DE MONTES, QRO.",0,1,1,0,0,0,
21-ago-23,Puebla,"PALMAR DE BRAVO, PUE.",1,0,1,0,0,0,
21-ago-23,Sinaloa,"SALVADOR ALVARADO, SIN.",1,0,1,0,0,176,
23-ago-23,Michoacán,"COPANDARO, MICH.",0,1,1,0,0,0,
23-ago-23,Cd. de México,"CUAUHTEMOC, CD. MÉX.",1,0,1,0,0,0,
23-ago-23,Sinaloa,"SALVADOR ALVARADO, SIN.",0,1,1,0,0,376,
23-ago-23,Chiapas,"TUXTLA GUTIÉRREZ, CHIS.",1,0,1,0,0,639,
23-ago-23,Chiapas,"OSUMACINTA, CHIS.",1,0,1,0,0,800,
23-ago-23,Sinaloa,"MOCORITO, SIN.",1,0,1,0,0,0,
24-ago-23,Michoacán,"COPANDARO, MICH.",0,1,1,1,0,0,
24-ago-23,Querétaro,"HUIMILPAN, QRO.",1,0,1,0,0,154,
24-ago-23,Guerrero,"TIXTLA DE GUERRERO, GRO.",0,1,1,0,0,0,
24-ago-23,Cd. de México,"CUAUHTEMOC, CD. MÉX.",1,0,1,0,1,61,
25-ago-23,Guerrero,"TIXTLA DE GUERRERO, GRO.",0,1,1,0,0,19,
25-ago-23,Puebla,"LIBRES, PUE.",1,0,1,3,0,246,
25-ago-23,Sinaloa,"MOCORITO, SIN.",1,0,1,0,0,0,
25-ago-23,Cd. de México,"CUAUHTEMOC, CD. MÉX.",1,0,1,0,0,0,
27-ago-23,Michoacán,"COPANDARO, MICH.",1,0,1,0,0,0,
28-ago-23,Michoacán,"CUITZEO, MICH.",0,1,1,0,0,0,
28-ago-23,Chiapas,"CHANAL, CHIS.",0,1,1,0,0,0,
28-ago-23,Guerrero,"TIXTLA DE GUERRERO, GRO.",1,0,1,0,0,3,
28-ago-23,Cd. de México,"GUSTAVO A. MADERO, CD. MÉX.",1,0,1,0,0,163,
29-ago-23,Morelos,"JIUTEPEC, MOR.",1,0,1,3,2,"1,084",
29-ago-23,Tabasco,"HUIMANGUILLO, TAB.",1,0,1,0,0,0,
29-ago-23,Chiapas,"TUXTLA GUTIÉRREZ, CHIS.",1,0,1,0,0,0,
30-ago-23,Morelos,"JIUTEPEC, MOR.",1,0,1,0,0,0,
30-ago-23,Tamaulipas,"MATAMOROS, TAMPS.",1,0,1,0,0,0,
31-ago-23,Chiapas,"TUXTLA GUTIÉRREZ, CHIS.",0,1,1,0,0,0,
31-ago-23,Tabasco,"CARDENAS, TAB.",1,0,1,1,0,702,
01-sep-23,Michoacán,"ZITACUARO, MICH.",1,0,1,4,1,168,
04-sep-23,Cd. de México,"BENITO JUAREZ, CD. MÉX.",1,0,1,0,0,0,
04-sep-23,Tabasco,"SUNUAPA, CHIS.",0,1,1,0,0,0,
04-sep-23,Cd. de México,"CUAUHTEMOC, CD. MÉX.",0,1,1,0,0,89,
04-sep-23,Tabasco,"JONUTA, TAB.",1,0,1,0,0,0,
05-sep-23,Tamaulipas,"REYNOSA, TAMPS.",1,0,1,6,0,222,
06-sep-23,Tabasco,"OSTUACÁN, CHIS.",0,1,1,0,0,0,
06-sep-23,Cd. de México,"BENITO JUAREZ, CD. MÉX.",0,1,1,0,0,0,
07-sep-23,Puebla,"TEHUACAN, PUE.",1,0,1,0,2,64,
07-sep-23,Michoacán,"MARAVATIO, MICH.",1,0,1,45,0,281,
07-sep-23,Cd. de México,"BENITO JUAREZ, CD. MÉX.",1,0,1,0,0,111,
08-sep-23,Cd. de México,"BENITO JUAREZ, CD. MÉX.",1,0,1,0,0,0,
11-sep-23,Chihuahua,"JUÁREZ, CHIH.",0,1,1,15,0,113,
12-sep-23,Cd. de México,"BENITO JUAREZ, CD. MÉX.",1,0,1,0,0,49,
18-sep-23,Puebla,"TEHUACAN, PUE.",1,0,1,0,1,150,
18-sep-23,Chihuahua,"JUÁREZ, CHIH.",0,1,1,0,0,100,
21-sep-23,Cd. de México,"BENITO JUAREZ, CD. MÉX.",0,1,1,0,0,0,
21-sep-23,Cd. de México,"XOCHIMILCO, CD. MÉX.",1,0,1,0,0,0,
25-sep-23,Cd. de México,"CUAUHTEMOC, CD. MÉX.",1,0,1,0,0,0,
26-sep-23,Chihuahua,"JUÁREZ, CHIH.",1,0,1,0,0,0,
28-sep-23,Chihuahua,"JUÁREZ, CHIH.",1,0,1,23,0,160,
28-sep-23,Veracruz,"TIHUATLAN, VER.",1,0,1,0,0,757,
29-sep-23,Cd. de México,"CUAUHTEMOC, CD. MÉX.",1,0,1,0,0,0,
29-sep-23,Chihuahua,"JUÁREZ, CHIH.",1,0,1,24,1,141,
01-oct-23,Sinaloa,"CONCORDIA, SIN.",0,1,1,0,0,0,
02-oct-23,Sinaloa,"ESCUINAPA, SIN.",1,0,1,0,0,0,
04-oct-23,Cd. de México,"VENUSTIANO CARRANZA, CD. MÉX.",1,0,1,0,0,0,
05-oct-23,Chihuahua,"JUÁREZ, CHIH.",0,1,1,0,0,0,
05-oct-23,Sinaloa,"ESCUINAPA, SIN.",0,1,1,0,0,60,
06-oct-23,Sinaloa,"ESCUINAPA, SIN.",1,0,1,0,0,0,
09-oct-23,Tamaulipas,"VICTORIA, TAMPS.",1,0,1,1,0,8,
09-oct-23,Cd. de México,"CUAUHTEMOC, CD. MÉX.",0,1,1,0,0,0,
10-oct-23,Cd. de México,"CUAUHTEMOC, CD. MÉX.",1,0,1,0,0,0,
10-oct-23,Chiapas,"CHENALHÓ, CHIS.",0,1,1,0,0,0,
11-oct-23,Chihuahua,"CHIHUAHUA, CHIH.",1,0,1,0,0,241,
11-oct-23,Tamaulipas,"VICTORIA, TAMPS.",1,0,1,0,0,0,
11-oct-23,Sinaloa,"MAZATLAN, SIN.",1,0,1,0,0,205,
11-oct-23,Chiapas,"EL PORVENIR, CHIS.",1,0,1,0,0,0,
13-oct-23,Tamaulipas,"VICTORIA, TAMPS.",1,0,1,0,0,0,
13-oct-23,Sinaloa,"ESCUINAPA, SIN.",1,0,1,0,0,0,
13-oct-23,Cd. de México,"VENUSTIANO CARRANZA, CD. MÉX.",0,1,1,0,0,0,
13-oct-23,Chiapas,"CHENALHÓ, CHIS.",0,1,1,0,0,0,
15-oct-23,Tamaulipas,"VICTORIA, TAMPS.",1,0,1,0,0,0,
19-oct-23,Cd. de México,"GUSTAVO A. MADERO, CD. MÉX.",1,0,1,0,0,"1,152",
19-oct-23,Chiapas,"TONALÁ, CHIS.",1,0,1,0,0,0,
20-oct-23,Cd. de México,"VENUSTIANO CARRANZA, CD. MÉX.",1,0,1,0,0,4,
20-oct-23,Coahuila,"FRONTERA, COAH.",1,0,1,1,0,0,
20-oct-23,Cd. de México,"CUAUHTEMOC, CD. MÉX.",1,0,1,0,0,21,
22-oct-23,Tamaulipas,"VICTORIA, TAMPS.",1,0,1,0,0,0,
24-oct-23,Tlaxcala,"APETATITLAN DE ANTONIO CARVAJAL, TLAX.",0,1,1,0,0,0,
24-oct-23,Cd. de México,"VENUSTIANO CARRANZA, CD. MÉX.",1,0,1,0,0,50,
26-oct-23,Chiapas,"TONALÁ, CHIS.",1,0,1,0,0,0,
26-oct-23,Tlaxcala,"APETATITLAN DE ANTONIO CARVAJAL, TLAX.",1,0,1,0,0,0,
26-oct-23,Coahuila,"FRONTERA, COAH.",0,1,1,5,0,108,
27-oct-23,Tamaulipas,"VICTORIA, TAMPS.",1,0,1,0,0,0,
27-oct-23,Coahuila,"MONCLOVA, COAH.",1,0,1,0,0,52,
27-oct-23,Cd. de México,"IZTAPALAPA, CD. MÉX.",1,0,1,0,0,24,
27-oct-23,Tlaxcala,"APETATITLAN DE ANTONIO CARVAJAL, TLAX.",0,1,1,0,0,0,
27-oct-23,Tlaxcala,"HUAMANTLA, TLAX.",0,1,1,1,0,14,
28-oct-23,Tlaxcala,"TOTOLAC, TLAX.",0,1,1,0,0,0,
28-oct-23,Tlaxcala,"HUAMANTLA, TLAX.",0,1,1,0,0,0,
29-oct-23,Chiapas,"TONALÁ, CHIS.",0,1,1,0,0,13,
30-oct-23,Coahuila,"MONCLOVA, COAH.",1,0,1,1,0,400,
30-oct-23,Sinaloa,"SAN IGNACIO, SIN.",0,1,1,0,0,5,
30-oct-23,Sinaloa,"CONCORDIA, SIN.",1,0,1,0,0,0,
30-oct-23,Cd. de México,"IZTAPALAPA, CD. MÉX.",1,0,1,0,0,0,
30-oct-23,Cd. de México,"CUAUHTEMOC, CD. MÉX.",1,0,1,0,0,109,
31-oct-23,Sinaloa,"CONCORDIA, SIN.",1,0,1,0,0,0,
31-oct-23,Tlaxcala,"SANTA CRUZ TLAXCALA, TLAX.",1,0,1,0,0,0,
31-oct-23,Tlaxcala,"HUAMANTLA, TLAX.",1,0,1,0,0,0,
01-nov-23,Tlaxcala,"SANTA CRUZ TLAXCALA, TLAX.",1,0,1,0,0,0,
01-nov-23,Cd. de México,"IZTAPALAPA, CD. MÉX.",0,1,1,0,0,4,
01-nov-23,Cd. de México,"CUAUHTEMOC, CD. MÉX.",1,0,1,0,0,0,
01-nov-23,Tlaxcala,"APIZACO, TLAX.",1,0,1,0,0,0,
02-nov-23,Sinaloa,"SAN IGNACIO, SIN.",0,1,1,0,5,41,
03-nov-23,Cd. de México,"GUSTAVO A. MADERO, CD. MÉX.",1,0,1,0,0,122,
03-nov-23,Sinaloa,"COSALA, SIN.",0,1,1,0,0,0,
03-nov-23,Sinaloa,"SAN IGNACIO, SIN.",0,1,1,0,4,149,
03-nov-23,Tlaxcala,"APIZACO, TLAX.",1,0,1,0,0,0,
04-nov-23,Tlaxcala,"HUAMANTLA, TLAX.",1,0,1,0,0,0,
06-nov-23,Cd. de México,"CUAUHTEMOC, CD. MÉX.",1,0,1,0,0,32,
06-nov-23,Tlaxcala,"CHIAUTEMPAN, TLAX.",1,0,1,0,0,0,
06-nov-23,Tlaxcala,"IXTACUIXTLA DE MARIANO MATAMOROS, TLAX.",1,0,1,1,0,0,
07-nov-23,Cd. de México,"IZTAPALAPA, CD. MÉX.",0,1,1,0,0,0,
07-nov-23,Tlaxcala,"CHIAUTEMPAN, TLAX.",1,0,1,0,0,0,
07-nov-23,Sinaloa,"COSALA, SIN.",1,0,1,0,0,0,
07-nov-23,Cd. de México,"GUSTAVO A. MADERO, CD. MÉX.",1,0,1,0,0,0,
08-nov-23,Cd. de México,"CUAJIMALPA DE MORELOS, CD. MÉX.",1,0,1,0,0,0,
08-nov-23,Sinaloa,"CONCORDIA, SIN.",1,0,1,0,0,0,
09-nov-23,Sinaloa,"COSALA, SIN.",1,0,1,0,0,0,
09-nov-23,Sinaloa,"CONCORDIA, SIN.",0,1,1,0,0,0,
10-nov-23,Tlaxcala,"TLAXCALA, TLAX.",1,0,1,0,0,0,
10-nov-23,Tlaxcala,"CHIAUTEMPAN, TLAX.",1,0,1,0,0,0,
10-nov-23,Sinaloa,"CONCORDIA, SIN.",1,0,1,0,0,0,
10-nov-23,Cd. de México,"CUAJIMALPA DE MORELOS, CD. MÉX.",1,0,1,0,0,0,
10-nov-23,Tlaxcala,"IXTACUIXTLA DE MARIANO MATAMOROS, TLAX.",1,0,1,0,0,0,
11-nov-23,Guanajuato,"PENJAMO, GTO.",1,0,1,0,0,0,
11-nov-23,Tlaxcala,"TLAXCALA, TLAX.",1,0,1,0,0,0,
13-nov-23,Tlaxcala,"TLAXCALA, TLAX.",1,0,1,0,0,0,
13-nov-23,Guanajuato,"PENJAMO, GTO.",1,0,1,0,0,0,
13-nov-23,Cd. de México,"BENITO JUAREZ, CD. MÉX.",1,0,1,0,0,5,
14-nov-23,Cd. de México,"CUAUHTEMOC, CD. MÉX.",1,0,1,0,0,434,
14-nov-23,Tlaxcala,"TLAXCALA, TLAX.",0,1,1,0,0,0,
14-nov-23,Tlaxcala,"MAZATECOCHCO DE JOSE MARIA MORELOS, TLAX.",1,0,1,0,0,0,
16-nov-23,Cd. de México,"CUAUHTEMOC, CD. MÉX.",1,0,1,0,2,388,
16-nov-23,Cd. de México,"CUAJIMALPA DE MORELOS, CD. MÉX.",1,0,1,0,0,8,
16-nov-23,Tlaxcala,"TLAXCALA, TLAX.",0,1,1,0,0,0,
16-nov-23,Tamaulipas,"TAMPICO, TAMPS.",1,0,1,0,0,0,
17-nov-23,Tamaulipas,"TAMPICO, TAMPS.",1,0,1,0,0,187,
17-nov-23,Tlaxcala,"MAZATECOCHCO DE JOSE MARIA MORELOS, TLAX.",0,1,1,0,0,0,
17-nov-23,Cd. de México,"CUAUHTEMOC, CD. MÉX.",0,1,1,0,2,"3,443",
23-nov-23,Cd. de México,"CUAUHTEMOC, CD. MÉX.",0,1,1,0,0,0,
23-nov-23,Cd. de México,"CUAJIMALPA DE MORELOS, CD. MÉX.",1,0,1,0,0,0,
25-nov-23,Tamaulipas,"TAMPICO, TAMPS.",1,0,1,0,0,49,
26-nov-23,Morelos,"CUAUTLA, MOR.",1,0,1,5,0,687,
28-nov-23,Cd. de México,"BENITO JUAREZ, CD. MÉX.",0,1,1,0,0,0,
29-nov-23,Chiapas,"CHICOMUSELO, CHIS.",1,0,1,0,0,0,
29-nov-23,Puebla,"PUEBLA, PUE.",0,1,1,0,0,0,
29-nov-23,Sinaloa,"CULIACAN, SIN.",1,0,1,0,0,0,
01-dic-23,Hidalgo,"HUASCA DE OCAMPO, HGO.",1,0,1,0,0,0,
01-dic-23,Sinaloa,"ELOTA, SIN.",0,1,1,0,0,0,
01-dic-23,Puebla,"PUEBLA, PUE.",1,0,1,0,0,0,
05-dic-23,Coahuila,"SACRAMENTO, COAH.",0,1,1,0,0,0,
05-dic-23,Hidalgo,"CUAUTEPEC DE HINOJOSA, HGO.",0,1,1,0,0,41,
05-dic-23,Sinaloa,"ELOTA, SIN.",1,0,1,0,0,0,
05-dic-23,Cd. de México,"CUAUHTEMOC, CD. MÉX.",1,0,1,0,0,0,
05-dic-23,Hidalgo,"ZACUALTIPAN DE ANGELES, HGO.",1,0,1,1,0,15,
06-dic-23,Hidalgo,"CUAUTEPEC DE HINOJOSA, HGO.",1,0,1,0,1,44,
06-dic-23,Hidalgo,"ZACUALTIPAN DE ANGELES, HGO.",1,0,1,0,0,13,
06-dic-23,Hidalgo,"ATOTONILCO DE TULA, HGO.",1,0,1,0,0,223,
06-dic-23,Cd. de México,"CUAJIMALPA DE MORELOS, CD. MÉX.",1,0,1,0,0,0,
06-dic-23,Cd. de México,"COYOACAN, CD. MÉX.",0,1,1,0,0,0,
07-dic-23,Cd. de México,"CUAUHTEMOC, CD. MÉX.",0,1,1,0,0,0,
07-dic-23,Sinaloa,"CULIACAN, SIN.",1,0,1,0,0,"1,616",
07-dic-23,Coahuila,"SACRAMENTO, COAH.",1,0,1,0,0,0,
07-dic-23,Sinaloa,"ELOTA, SIN.",1,0,1,0,0,81,
08-dic-23,Sinaloa,"ELOTA, SIN.",0,1,1,0,0,6,
11-dic-23,Cd. de México,"CUAUHTEMOC, CD. MÉX.",1,0,1,0,0,344,
12-dic-23,Chiapas,"CHENALHÓ, CHIS.",0,1,1,1,0,225,
13-dic-23,Sinaloa,"ELOTA, SIN.",0,1,1,0,0,0,
13-dic-23,Cd. de México,"CUAUHTEMOC, CD. MÉX.",1,0,1,0,0,0,
15-dic-23,Cd. de México,"IZTAPALAPA, CD. MÉX.",1,0,1,0,0,28,
18-dic-23,Chiapas,"TUXTLA GUTIÉRREZ, CHIS.",1,0,1,0,0,465,
18-dic-23,Chiapas,"CHENALHÓ, CHIS.",0,1,1,0,0,130,
20-dic-23,Chiapas,"TUXTLA GUTIÉRREZ, CHIS.",1,0,1,0,0,313,
21-dic-23,Chihuahua,"JUÁREZ, CHIH.",0,1,1,0,0,162,
28-dic-23,Zacatecas,"GUADALUPE, ZAC.",1,0,1,15,0,202,
29-dic-23,Zacatecas,"GUADALUPE, ZAC.",1,0,1,10,0,623,
09-ene-24,Zacatecas,"OJOCALIENTE, ZAC.",1,0,1,0,0,0,
16-ene-24,Zacatecas,"JEREZ, ZAC.",1,0,1,11,0,219,
17-ene-24,Zacatecas,"VILLANUEVA, ZAC.",1,0,1,0,0,0,
18-ene-24,Zacatecas,"VILLANUEVA, ZAC.",1,0,1,21,0,0,
27-ene-24,Zacatecas,"ZACATECAS, ZAC.",1,0,1,0,0,0,
01-feb-24,Zacatecas,"ZACATECAS, ZAC.",1,0,1,0,0,0,
09-feb-24,Zacatecas,"TLALTENANGO DE SANCHEZ ROMAN, ZAC.",1,0,1,4,0,100,
13-feb-24,Zacatecas,"FRESNILLO, ZAC.",1,0,1,11,0,190,
16-feb-24,Zacatecas,"FRESNILLO, ZAC.",1,0,1,8,0,148,
28-feb-24,Cd. de México,"GUSTAVO A. MADERO, CD. MÉX.",1,0,1,0,0,0,
08-mar-24,Cd. de México,"TLALPAN, CD. MÉX.",0,1,1,0,0,"1,111",
11-mar-24,Cd. de México,"GUSTAVO A. MADERO, CD. MÉX.",1,0,1,0,0,0,
11-mar-24,Cd. de México,"CUAUHTEMOC, CD. MÉX.",1,0,1,0,0,365,
06-mar-24,Zacatecas,"FRESNILLO, ZAC.",0,1,1,3,0,92,
13-mar-24,Cd. de México,"CUAUHTEMOC, CD. MÉX.",0,1,1,0,0,214,
14-mar-24,Cd. de México,"CUAUHTEMOC, CD. MÉX.",1,0,1,0,0,0,
15-mar-24,Cd. de México,"GUSTAVO A. MADERO, CD. MÉX.",0,1,1,0,0,0,
18-mar-24,Cd. de México,"CUAUHTEMOC, CD. MÉX.",1,0,1,0,0,26,
18-mar-24,Cd. de México,"IZTAPALAPA, CD. MÉX.",1,0,1,0,0,149,
26-mar-24,Cd. de México,"TLALPAN, CD. MÉX.",1,0,1,0,0,0,
27-mar-24,Cd. de México,"CUAUHTEMOC, CD. MÉX.",1,0,1,0,0,74,
27-mar-24,Cd. de México,"GUSTAVO A. MADERO, CD. MÉX.",1,0,1,0,0,0,
15-abr-24,Cd. de México,"GUSTAVO A. MADERO, CD. MÉX.",1,0,1,0,0,0,
15-abr-24,Cd. de México,"TLAHUAC, CD. MÉX.",1,0,1,0,0,11,
18-abr-24,Cd. de México,"CUAUHTEMOC, CD. MÉX.",1,0,1,0,0,0,
22-abr-24,Cd. de México,"LA MAGDALENA CONTRERAS, CD. MÉX.",1,0,1,0,0,57,
25-abr-24,Cd. de México,"LA MAGDALENA CONTRERAS, CD. MÉX.",1,0,1,0,0,0,
26-abr-24,Cd. de México,"CUAUHTEMOC, CD. MÉX.",1,0,1,0,0,161,
30-abr-24,Cd. de México,"COYOACAN, CD. MÉX.",0,1,1,0,0,0,
07-may-24,Cd. de México,"IZTAPALAPA, CD. MÉX.",1,0,1,0,0,0,
09-may-24,Cd. de México,"CUAUHTEMOC, CD. MÉX.",1,0,1,0,0,0,
13-may-24,Zacatecas,"FRESNILLO, ZAC.",1,0,1,4,0,45,
15-may-24,Cd. de México,"CUAUHTEMOC, CD. MÉX.",1,0,1,0,0,49,
16-may-24,Cd. de México,"MILPA ALTA, CD. MÉX.",1,0,1,0,0,0,
20-may-24,Cd. de México,"VENUSTIANO CARRANZA, CD. MÉX.",0,1,1,0,0,0,
23-may-24,Cd. de México,"CUAUHTEMOC, CD. MÉX.",1,0,1,0,0,0,
27-may-24,Cd. de México,"CUAUHTEMOC, CD. MÉX.",1,0,1,0,0,0,
30-may-24,Cd. de México,"VENUSTIANO CARRANZA, CD. MÉX.",0,1,1,0,0,0,
03-jun-24,Cd. de México,"CUAUHTEMOC, CD. MÉX.",1,0,1,0,0,0,
05-jun-24,Cd. de México,"CUAUHTEMOC, CD. MÉX.",1,0,1,0,0,0,
05-jun-24,Cd. de México,"ALVARO OBREGON, CD. MÉX.",1,0,1,0,0,0,
11-jun-24,Cd. de México,"AZCAPOTZALCO, CD. MÉX.",0,1,1,0,0,20,
17-jun-24,Cd. de México,"AZCAPOTZALCO, CD. MÉX.",1,0,1,0,0,0,
17-jun-24,Sinaloa,"MOCORITO, SIN.",1,0,1,0,0,336,
17-jun-24,Sinaloa,"COSALA, SIN.",0,1,1,0,0,0,
18-jun-24,Sinaloa,"BADIRAGUATO, SIN.",1,0,1,0,1,0,
19-jun-24,Sinaloa,"CULIACAN, SIN.",1,0,1,0,1,364,
19-jun-24,Cd. de México,"CUAUHTEMOC, CD. MÉX.",1,0,1,0,0,0,
19-jun-24,Cd. de México,"ALVARO OBREGON, CD. MÉX.",1,0,1,0,0,30,
20-jun-24,Cd. de México,"BENITO JUAREZ, CD. MÉX.",1,0,1,0,0,0,
20-jun-24,Cd. de México,"ALVARO OBREGON, CD. MÉX.",1,0,1,0,0,0,
18-jun-24,Michoacán,"MORELIA, MICH.",1,0,1,2,0,183,
21-jun-24,Cd. de México,"CUAUHTEMOC, CD. MÉX.",1,0,1,0,0,0,
21-jun-24,Cd. de México,"BENITO JUAREZ, CD. MÉX.",1,0,1,0,0,0,
21-jun-24,Cd. de México,"ALVARO OBREGON, CD. MÉX.",1,0,1,0,0,0,
20-jun-24,Sinaloa,"COSALA, SIN.",1,0,1,0,0,0,
21-jun-24,Sinaloa,"COSALA, SIN.",1,0,1,0,0,0,
21-jun-24,Sinaloa,"MAZATLAN, SIN.",1,0,1,61,0,52,
23-jun-24,Sinaloa,"MAZATLAN, SIN.",1,0,1,25,0,0,
24-jun-24,Cd. de México,"CUAUHTEMOC, CD. MÉX.",1,0,1,0,0,112,
24-jun-24,Cd. de México,"ALVARO OBREGON, CD. MÉX.",1,0,1,0,0,5,
25-jun-24,Cd. de México,"CUAUHTEMOC, CD. MÉX.",1,0,1,0,0,0,
25-jun-24,Cd. de México,"AZCAPOTZALCO, CD. MÉX.",1,0,1,0,0,6,
26-jun-24,Cd. de México,"BENITO JUAREZ, CD. MÉX.",1,0,1,0,0,"1,456",
26-jun-24,Cd. de México,"GUSTAVO A. MADERO, CD. MÉX.",1,0,1,0,0,0,
25-jun-24,Sinaloa,"COSALA, SIN.",1,0,1,0,0,0,
28-jun-24,Cd. de México,"BENITO JUAREZ, CD. MÉX.",1,0,1,0,0,26,
28-jun-24,Cd. de México,"GUSTAVO A. MADERO, CD. MÉX.",1,0,1,0,0,0,
28-jun-24,Cd. de México,"IZTACALCO, CD. MÉX.",1,0,1,0,0,1,
27-jun-24,Sinaloa,"BADIRAGUATO, SIN.",0,1,1,0,0,100,
26-jun-24,Sinaloa,"COSALA, SIN.",1,0,1,0,0,0,
16-feb-13,B.C.,"MEXICALI, B.C.",0,0,0,0,3,0,
20-feb-13,GRO.,"ACAPULCO DE JUAREZ, GRO.",0,0,0,0,3,0,
21-feb-13,CHIH.,"CHIH., CHIH.",0,0,0,0,0,60,
23-feb-13,TAMPS.,"TAMPICO, TAMPS.",0,0,0,13,1,689,
23-feb-13,HGO.,"TULANCINGO DE BRAVO, HGO.",0,0,0,0,0,200,
27-feb-13,MEX.,"COACALCO DE BERRIOZABAL, MEX.",0,0,0,4,5,426,
01-mar-13,CHIH.,"GALEANA, CHIH.",0,0,0,0,0,56,
01-mar-13,Q. ROO,"COZUMEL, Q. ROO",0,0,0,0,0,55,
04-mar-13,TAMPS.,"VICTORIA, TAMPS.",0,0,0,0,4,0,
05-mar-13,CHIH.,"ROSALES, CHIH.",0,0,0,0,0,11,
05-mar-13,Q. ROO,"TULUM, Q. ROO",0,0,0,0,0,18,
06-mar-13,N.L.,"GRAL. ESCOBEDO, N.L.",0,0,0,0,0,674,
06-mar-13,CHIH.,"CHIH., CHIH.",0,0,0,6,0,58,
07-mar-13,Q. ROO,"COZUMEL, Q. ROO",0,0,0,0,0,21,
08-mar-13,N.L.,"GARCIA, N.L.",0,0,0,1,0,16176,
08-mar-13,Q. ROO,"COZUMEL, Q. ROO",0,0,0,0,1,336,
08-mar-13,TAMPS.,"VICTORIA, TAMPS.",0,0,0,2,0,156,
09-mar-13,N.L.,"JUAREZ, N.L.",0,0,0,1,0,200,
09-mar-13,N.L.,"SANTA CATARINA, N.L.",0,0,0,0,0,8074,
10-mar-13,N.L.,"APODACA, N.L.",0,0,0,1,0,81,
10-mar-13,N.L.,"SAN PEDRO GARZA GARCIA, N.L.",0,0,0,0,0,1000,
10-mar-13,TAMPS.,"ALTAMIRA, TAMPS.",0,0,0,0,0,60,
12-mar-13,TAMPS.,"VICTORIA, TAMPS.",0,0,0,0,0,240,
13-mar-13,VER.,"TUXPAM, VER.",0,0,0,0,0,0,
13-mar-13,TAMPS.,"VICTORIA, TAMPS.",0,0,0,0,2,75,
14-mar-13,VER.,"TUXPAM, VER.",0,0,0,0,0,0,
15-mar-13,Q. ROO,"COZUMEL, Q. ROO",0,0,0,0,0,33,
16-mar-13,HGO.,"ACTOPAN, HGO.",0,0,0,0,1,300,
16-mar-13,Q. ROO,"COZUMEL, Q. ROO",0,0,0,0,0,73,
18-mar-13,N.L.,"SABINAS HGO., N.L.",0,0,0,0,0,0,
20-mar-13,TAMPS.,"VICTORIA, TAMPS.",0,0,0,20,0,28,
21-mar-13,Q. ROO,"COZUMEL, Q. ROO",0,0,0,0,0,25,
22-mar-13,Q. ROO,"SOLIDARIDAD, Q. ROO",0,0,0,0,0,12,
22-mar-13,TAMPS.,"VICTORIA, TAMPS.",0,0,0,1,0,37,
22-mar-13,TAMPS.,"ALTAMIRA, TAMPS.",0,0,0,1,0,62,
22-mar-13,Q. ROO,"COZUMEL, Q. ROO",0,0,0,0,0,51,
25-mar-13,CHIH.,"CHIH., CHIH.",0,0,0,0,0,231,
25-mar-13,TAMPS.,"VICTORIA, TAMPS.",0,0,0,0,1,0,
26-mar-13,N.L.,"SANTIAGO, N.L.",0,0,0,9,0,6000,
27-mar-13,CHIH.,"CHIH., CHIH.",0,0,0,2,0,337,
28-mar-13,N.L.,"SANTIAGO, N.L.",0,0,0,0,0,2817,
29-mar-13,VER.,"VER., VER.",0,0,0,0,0,29,
30-mar-13,Q. ROO,"OTHON P. BLANCO, Q. ROO",0,0,0,0,0,280,
01-abr-13,TAMPS.,"VICTORIA, TAMPS.",0,0,0,0,6,0,
01-abr-13,COL.,"MANZANILLO, COL.",0,0,0,0,1,0,
05-abr-13,Q. ROO,"BENITO JUAREZ, Q. ROO",0,0,0,0,0,66,
06-abr-13,Q. ROO,"OTHON P. BLANCO, Q. ROO",0,0,0,0,6,25,
10-abr-13,Q. ROO,"OTHON P. BLANCO, Q. ROO",0,0,0,0,5,0,
10-abr-13,VER.,"COATEPEC, VER.",0,0,0,0,0,28,
10-abr-13,MEX.,"TEJUPILCO, MEX.",0,0,0,4,0,0,
10-abr-13,MEX.,"MALINALCO, MEX.",0,0,0,0,0,0,
10-abr-13,MEX.,"TEJUPILCO, MEX.",0,0,0,0,0,0,
11-abr-13,AGS.,"COSÍO, AGS.",0,0,0,0,0,6,
11-abr-13,Q. ROO,"BENITO JUAREZ, Q. ROO",0,0,0,0,0,109,
11-abr-13,Q. ROO,"OTHON P. BLANCO, Q. ROO",0,0,0,0,0,32,
11-abr-13,Q. ROO,"BENITO JUAREZ, Q. ROO",0,0,0,0,0,81,
13-abr-13,Q. ROO,"OTHON P. BLANCO, Q. ROO",0,0,0,0,0,28,
13-abr-13,Q. ROO,"BENITO JUAREZ, Q. ROO",0,0,0,0,0,311,
14-abr-13,VER.,"ACULA, VER.",0,0,0,0,1,0,
14-abr-13,VER.,"COATEPEC, VER.",0,0,0,0,0,25,
14-abr-13,TAMPS.,"CIUDAD MADERO, TAMPS.",0,0,0,0,0,37,
14-abr-13,TAMPS.,"ALTAMIRA, TAMPS.",0,0,0,0,0,86,
15-abr-13,Q. ROO,"OTHON P. BLANCO, Q. ROO",0,0,0,0,0,117,
17-abr-13,TAMPS.,"VICTORIA, TAMPS.",0,0,0,0,0,150,
20-abr-13,VER.,"MEDELLIN, VER.",0,0,0,0,0,40,
20-abr-13,TAMPS.,"TAMPICO, TAMPS.",0,0,0,12,0,500,
20-abr-13,TAMPS.,"CIUDAD MADERO, TAMPS.",0,0,0,0,1,65,
20-abr-13,TAMPS.,"VICTORIA, TAMPS.",0,0,0,0,1,0,
20-abr-13,VER.,"MEDELLIN, VER.",0,0,0,0,0,40,
21-abr-13,HGO.,"HUEHUETLA, HGO.",0,0,0,0,0,10,
22-abr-13,CHIH.,"NUEVO CASAS GRANDES, CHIH.",0,0,0,0,0,0,
22-abr-13,VER.,"MEDELLIN, VER.",0,0,0,0,0,32,
22-abr-13,TAMPS.,"VICTORIA, TAMPS.",0,0,0,0,0,50,
25-abr-13,TAMPS.,"VICTORIA, TAMPS.",0,0,0,0,0,50,
25-abr-13,TAMPS.,"NUEVO LAREDO, TAMPS.",0,0,0,0,1,131,
26-abr-13,VER.,"BOCA DEL RIO, VER.",0,0,0,0,1,0,
26-abr-13,TAMPS.,"VICTORIA, TAMPS.",0,0,0,0,1,0,
29-abr-13,N.L.,"GRAL. ZUAZUA, N.L.",0,0,0,1,0,50,
02-may-13,VER.,"BOCA DEL RIO, VER.",0,0,0,0,1,0,
02-may-13,VER.,"BOCA DEL RIO, VER.",0,0,0,3,0,45,
06-may-13,CHIH.,"MEOQUI, CHIH.",0,0,0,0,0,63,
09-may-13,TAMPS.,"VICTORIA, TAMPS.",0,0,0,0,0,64,
11-may-13,N.L.,"MARIN, N.L.",0,0,0,27,0,400,
13-may-13,N.L.,"DR. GONZALEZ, N.L.",0,0,0,3,0,0,
15-may-13,SIN.,"SIN., SIN.",0,0,0,0,2,0,
15-may-13,CHIH.,"NUEVO CASAS GRANDES, CHIH.",0,0,0,0,0,71,
15-may-13,N.L.,"PESQUERIA, N.L.",0,0,0,4,0,150,
17-may-13,TAMPS.,"VICTORIA, TAMPS.",0,0,0,0,1,0,
18-may-13,DGO.,"DGO., DGO.",0,0,0,0,0,204,
19-may-13,QRO.,"QUERETARO, QRO.",0,0,0,0,7,0,
20-may-13,CHIH.,"CUAUHTÉMOC, CHIH.",0,0,0,0,0,115,
20-may-13,OAX.,"CIUDAD IXTEPEC, OAX.",0,0,0,0,1,28,
20-may-13,MICH.,"APATZINGAN, MICH.",0,0,0,0,0,7,
22-may-13,B.C.,"ENSENADA, B.C.",0,0,0,0,1,0,
22-may-13,TAMPS.,"VICTORIA, TAMPS.",0,0,0,0,0,20,
23-may-13,AGS.,"PABELLÓN DE ARTEAGA, AGS.",0,0,0,0,0,0,
25-may-13,N.L.,"GRAL. ZARAGOZA, N.L.",0,0,0,5,0,0,
26-may-13,N.L.,"DR. ARROYO, N.L.",0,0,0,1,0,0,
29-may-13,AGS.,"SAN JOSÉ DE GRACIA, AGS.",0,0,0,0,0,117,
31-may-13,OAX.,"CIUDAD IXTEPEC, OAX.",0,0,0,0,0,58,
31-may-13,N.L.,"MIER Y NORIEGA, N.L.",0,0,0,1,0,0,
01-jun-13,OAX.,"MIAHUATLAN DE PORFIRIO DIAZ, OAX.",0,0,0,0,1,262,
18-jun-13,TAB.,"CENTRO, TAB.",0,0,0,0,2,29,
21-jun-13,TAB.,"COMALCALCO, TAB.",0,0,0,0,2,0,
24-jun-13,TAB.,"COMALCALCO, TAB.",0,0,0,0,0,45,
24-jun-13,TAB.,"COMALCALCO, TAB.",0,0,0,0,0,45,
01-jul-13,CHIS.,"METAPA, CHIS.",0,0,0,0,1,0,
03-jul-13,PUE.,"XICOTEPEC, PUE.",0,0,0,0,0,150,
04-jul-13,OAX.,"MIAHUATLAN DE PORFIRIO DIAZ, OAX.",0,0,0,0,0,719,
04-jul-13,COAH.,"MÚZQUIZ, COAH.",0,0,0,0,0,50,
04-jul-13,CHIS.,"CINTALAPA, CHIS.",0,0,0,1,0,10,
07-jul-13,JAL.,"CIHUATLAN, JAL.",0,0,0,0,2,0,
10-jul-13,CHIS.,"CINTALAPA, CHIS.",0,0,0,0,0,32,
12-jul-13,N.L.,"JUAREZ, N.L.",0,0,0,5,0,0,
12-jul-13,B.C.,"MEXICALI, B.C.",0,0,0,0,0,0,
13-jul-13,PUE.,"ZARAGOZA, PUE.",0,0,0,0,0,40,
14-jul-13,N.L.,"JUAREZ, N.L.",0,0,0,0,0,300,
15-jul-13,PUE.,"HUITZILAN DE SERDAN, PUE.",0,0,0,0,1,0,
17-jul-13,CHIS.,"LA TRINITARIA, CHIS.",0,0,0,0,0,50,
18-jul-13,N.L.,"APODACA, N.L.",0,0,0,2,0,0,
19-jul-13,CHIS.,"MAPASTEPEC, CHIS.",0,0,0,0,0,127,
19-jul-13,N.L.,"GRAL. ESCOBEDO, N.L.",0,0,0,0,0,147,
20-jul-13,TAB.,"TEAPA, TAB.",0,0,0,0,1,0,
21-jul-13,N.L.,"GRAL. ESCOBEDO, N.L.",0,0,0,0,0,50,
22-jul-13,TAB.,"TEAPA, TAB.",0,0,0,0,1,0,
22-jul-13,PUE.,"SAN ANDRES CHOLULA, PUE.",0,0,0,0,4,38,
23-jul-13,PUE.,"SAN ANDRES CHOLULA, PUE.",0,0,0,0,0,179,
23-jul-13,S.L.P.,"CIUDAD DEL MAIZ, S.L.P.",0,0,0,0,0,84,
26-jul-13,TAMPS.,"NUEVO LAREDO, TAMPS.",0,0,0,4,0,325,
29-jul-13,QRO.,"QUERETARO, QRO.",0,0,0,0,5,0,
30-jul-13,VER.,"COATZACOALCOS, VER.",0,0,0,0,0,0,
30-jul-13,N.L.,"GARCIA, N.L.",0,0,0,23,0,1350,
30-jul-13,OAX.,"MIAHUATLAN DE PORFIRIO DIAZ, OAX.",0,0,0,6,0,113,
30-jul-13,OAX.,"MIAHUATLAN DE PORFIRIO DIAZ, OAX.",0,0,0,6,0,113,
30-jul-13,JAL.,"TLAQUEPAQUE, JAL.",0,0,0,0,1,0,
31-jul-13,PUE.,"SAN ANDRES CHOLULA, PUE.",0,0,0,0,0,300,
01-ago-13,PUE.,"SAN ANDRES CHOLULA, PUE.",0,0,0,0,0,70,
02-ago-13,PUE.,"PUE., PUE.",0,0,0,0,0,14,
02-ago-13,PUE.,"SAN ANDRES CHOLULA, PUE.",0,0,0,0,1,10,
03-ago-13,N.L.,"GARCIA, N.L.",0,0,0,2,0,0,
03-ago-13,OAX.,"MIAHUATLAN DE PORFIRIO DIAZ, OAX.",0,0,0,0,2,0,
04-ago-13,N.L.,"GARCIA, N.L.",0,0,0,8,0,1050,
05-ago-13,PUE.,"PUE., PUE.",0,0,0,0,0,223,
06-ago-13,PUE.,"AMOZOC, PUE.",0,0,0,0,0,25,
06-ago-13,PUE.,"PUE., PUE.",0,0,0,0,0,300,
06-ago-13,N.L.,"GARCIA, N.L.",0,0,0,14,0,1121,
07-ago-13,PUE.,"PUE., PUE.",0,0,0,1,1,155,
07-ago-13,PUE.,"AMOZOC, PUE.",0,0,0,0,0,100,
07-ago-13,N.L.,"GARCIA, N.L.",0,0,0,2,0,0,
07-ago-13,SIN.,"ELOTA, SIN.",0,0,0,0,4,0,
08-ago-13,HGO.,"IXMIQUILPAN, HGO.",0,0,0,0,0,200,
08-ago-13,PUE.,"PUE., PUE.",0,0,0,0,0,62,
08-ago-13,PUE.,"AMOZOC, PUE.",0,0,0,0,0,767,
10-ago-13,PUE.,"ATLIXCO, PUE.",0,0,0,2,0,1082,
12-ago-13,PUE.,"TEPEACA, PUE.",0,0,0,0,0,346,
13-ago-13,N.L.,"SAN NICOLAS DE LOS GARZA, N.L.",0,0,0,2,0,910,
13-ago-13,YUC.,"PETO, YUC.",0,0,0,1,0,154,
13-ago-13,PUE.,"ZACATLAN, PUE.",0,0,0,1,0,0,
14-ago-13,PUE.,"ATLIXCO, PUE.",0,0,0,0,0,200,
16-ago-13,PUE.,"TEPEACA, PUE.",0,0,0,0,1,0,
16-ago-13,PUE.,"SAN ANDRES CHOLULA, PUE.",0,0,0,0,0,38,
17-ago-13,PUE.,"ATLIXCO, PUE.",0,0,0,0,0,257,
17-ago-13,PUE.,"TEPEACA, PUE.",0,0,0,0,0,530,
18-ago-13,N.L.,"SAN PEDRO GARZA GARCIA, N.L.",0,0,0,60,1,115,
20-ago-13,PUE.,"ZACATLAN, PUE.",0,0,0,0,0,500,
21-ago-13,PUE.,"ATLIXCO, PUE.",0,0,0,0,0,201,
22-ago-13,PUE.,"ATLIXCO, PUE.",0,0,0,0,0,218,
24-ago-13,Q. ROO,"OTHON P. BLANCO, Q. ROO",0,0,0,0,0,1008,
24-ago-13,N.L.,"SAN PEDRO GARZA GARCIA, N.L.",0,0,0,3,0,150,
25-ago-13,PUE.,"ATLIXCO, PUE.",0,0,0,0,0,630,
25-ago-13,PUE.,"ZACATLAN, PUE.",0,0,0,0,3,0,
27-ago-13,PUE.,"LIBRES, PUE.",0,0,0,0,0,100,
27-ago-13,GTO.,"CELAYA, GTO.",0,0,0,0,0,450,
29-ago-13,PUE.,"LIBRES, PUE.",0,0,0,0,0,270,
29-ago-13,CHIH.,"NUEVO CASAS GRANDES, CHIH.",0,0,0,0,0,10,
30-ago-13,Q. ROO,"OTHON P. BLANCO, Q. ROO",0,0,0,0,0,112,
30-ago-13,SON.,"CAJEME, SON.",0,0,0,0,0,40,
01-sep-13,N.L.,"CHINA, N.L.",0,0,0,14,0,0,
04-sep-13,Q. ROO,"BACALAR, Q. ROO",0,0,0,0,0,22,
04-sep-13,PUE.,"TEZIUTLAN, PUE.",0,0,0,0,0,831,
05-sep-13,PUE.,"ATLIXCO, PUE.",0,0,0,4,3,406,
05-sep-13,N.L.,"GRAL. BRAVO, N.L.",0,0,0,0,0,90,
05-sep-13,SON.,"CAJEME, SON.",0,0,0,0,0,160,
06-sep-13,PUE.,"TEZIUTLAN, PUE.",0,0,0,0,0,70,
07-sep-13,PUE.,"TEZIUTLAN, PUE.",0,0,0,0,0,150,
09-sep-13,PUE.,"TEZIUTLAN, PUE.",0,0,0,0,0,715,
10-sep-13,PUE.,"TEZIUTLAN, PUE.",0,0,0,0,0,150,
11-sep-13,SON.,"HERMOSILLO, SON.",0,0,0,0,0,750,
12-sep-13,SON.,"HERMOSILLO, SON.",0,0,0,0,0,10,
12-sep-13,TAMPS.,"VICTORIA, TAMPS.",0,0,0,1,0,255,
12-sep-13,PUE.,"CALPAN, PUE.",0,0,0,0,0,250,
14-sep-13,OAX.,"MIAHUATLAN DE PORFIRIO DIAZ, OAX.",0,0,0,0,0,667,
17-sep-13,CHIH.,"GALEANA, CHIH.",0,0,0,0,4,0,
17-sep-13,OAX.,"MIAHUATLAN DE PORFIRIO DIAZ, OAX.",0,0,0,3,0,174,
17-sep-13,PUE.,"TEZIUTLAN, PUE.",0,0,0,0,0,850,
20-sep-13,SON.,"HERMOSILLO, SON.",0,0,0,0,0,13,
20-sep-13,TAMPS.,"NUEVO LAREDO, TAMPS.",0,0,0,3,0,70,
21-sep-13,TAMPS.,"NUEVO LAREDO, TAMPS.",0,0,0,0,1,400,
26-sep-13,SON.,"SAN LUIS RIO COLORADO, SON.",0,0,0,0,1,0,
26-sep-13,PUE.,"TEZIUTLAN, PUE.",0,0,0,39,0,0,
26-sep-13,TAMPS.,"NUEVO LAREDO, TAMPS.",0,0,0,8,1,430,
28-sep-13,OAX.,"MIAHUATLAN DE PORFIRIO DIAZ, OAX.",0,0,0,1,0,0,
29-sep-13,MOR.,"XOCHITEPEC, MOR.",0,0,0,0,0,113,
30-sep-13,SON.,"CAJEME, SON.",0,0,0,0,0,20,
04-oct-13,CHIS.,"MAPASTEPEC, CHIS.",0,0,0,0,1,0,
04-oct-13,COAH.,"MONCLOVA, COAH.",0,0,0,1,0,40,
04-oct-13,N.L.,"CADEREYTA JIMENEZ, N.L.",0,0,0,2,0,900,
07-oct-13,ZAC.,"TLALTENANGO DE SANCHEZ ROMAN, ZAC.",0,0,0,6,0,10,
07-oct-13,ZAC.,"NOCHISTLAN DE MEJIA, ZAC.",0,0,0,0,0,100,
07-oct-13,SON.,"CAJEME, SON.",0,0,0,0,0,2170,
07-oct-13,COAH.,"NUEVA ROSITA, COAH.",0,0,0,0,0,19,
08-oct-13,CHIS.,"TAPACHULA, CHIS.",0,0,0,0,0,67,
08-oct-13,COAH.,"MONCLOVA, COAH.",0,0,0,0,0,90,
09-oct-13,ZAC.,"JEREZ, ZAC.",0,0,0,8,0,140,
09-oct-13,N.L.,"PESQUERIA, N.L.",0,0,0,1,0,50,
10-oct-13,CHIS.,"REFORMA, CHIS.",0,0,0,0,1,50,
11-oct-13,ZAC.,"ZAC., ZAC.",0,0,0,0,0,307,
11-oct-13,N.L.,"MIER Y NORIEGA, N.L.",0,0,0,21,0,150,
14-oct-13,ZAC.,"GUADALUPE, ZAC.",0,0,0,0,0,1430,
15-oct-13,ZAC.,"JALPA, ZAC.",0,0,0,0,0,53,
16-oct-13,TAMPS.,"VICTORIA, TAMPS.",0,0,0,0,1,0,
17-oct-13,COAH.,"ACUÑA, COAH.",0,0,0,0,0,103,
18-oct-13,ZAC.,"GUADALUPE, ZAC.",0,0,0,0,0,1030,
18-oct-13,COAH.,"ACUÑA, COAH.",0,0,0,0,0,139,
18-oct-13,N.L.,"GRAL. ZARAGOZA, N.L.",0,0,0,14,0,320,
19-oct-13,ZAC.,"ZAC., ZAC.",0,0,0,0,0,318,
21-oct-13,ZAC.,"TLALTENANGO DE SANCHEZ ROMAN, ZAC.",0,0,0,0,0,406,
22-oct-13,ZAC.,"TLALTENANGO DE SANCHEZ ROMAN, ZAC.",0,0,0,0,0,56,
22-oct-13,N.L.,"ABASOLO, N.L.",0,0,0,4,0,0,
23-oct-13,ZAC.,"GUADALUPE, ZAC.",0,0,0,0,0,20,
23-oct-13,ZAC.,"TLALTENANGO DE SANCHEZ ROMAN, ZAC.",0,0,0,0,0,24,
23-oct-13,ZAC.,"JEREZ, ZAC.",0,0,0,0,0,20,
23-oct-13,ZAC.,"FRESNILLO, ZAC.",0,0,0,0,0,450,
23-oct-13,TAMPS.,"VICTORIA, TAMPS.",0,0,0,0,0,480,
24-oct-13,ZAC.,"TLALTENANGO DE SANCHEZ ROMAN, ZAC.",0,0,0,0,0,58,
25-oct-13,ZAC.,"TLALTENANGO DE SANCHEZ ROMAN, ZAC.",0,0,0,0,0,85,
25-oct-13,ZAC.,"JEREZ, ZAC.",0,0,0,0,0,30,
25-oct-13,AGS.,"AGS., AGS.",0,0,0,0,0,125,
27-oct-13,N.L.,"CARMEN, N.L.",0,0,0,7,0,150,
28-oct-13,CHIS.,"EL PORVENIR, CHIS.",0,0,0,0,0,27,
28-oct-13,N.L.,"SALINAS VICTORIA, N.L.",0,0,0,16,0,200,
29-oct-13,ZAC.,"GUADALUPE, ZAC.",0,0,0,0,0,1220,
29-oct-13,N.L.,"SALINAS VICTORIA, N.L.",0,0,0,6,0,300,
29-oct-13,TAMPS.,"VICTORIA, TAMPS.",0,0,0,0,0,119,
30-oct-13,CHIS.,"HUIXTLA, CHIS.",0,0,0,1,0,33,
30-oct-13,N.L.,"SALINAS VICTORIA, N.L.",0,0,0,0,0,400,
31-oct-13,ZAC.,"GUADALUPE, ZAC.",0,0,0,0,2,0,
01-nov-13,ZAC.,"TLALTENANGO DE SANCHEZ ROMAN, ZAC.",0,0,0,1,0,487,
01-nov-13,COAH.,"MÚZQUIZ, COAH.",0,0,0,0,0,100,
01-nov-13,S.L.P.,"SAN LUIS POTOSI, S.L.P.",0,0,0,0,1,0,
02-nov-13,TAMPS.,"NUEVO LAREDO, TAMPS.",0,0,0,0,0,170,
02-nov-13,ZAC.,"GUADALUPE, ZAC.",0,0,0,0,0,400,
02-nov-13,SON.,"CAJEME, SON.",0,0,0,0,0,142,
07-nov-13,COAH.,"ACUÑA, COAH.",0,0,0,2,0,90,
07-nov-13,TAB.,"CENTRO, TAB.",0,0,0,0,1,0,
08-nov-13,N.L.,"HIGUERAS, N.L.",0,0,0,10,0,570,
09-nov-13,N.L.,"GRAL. TERAN, N.L.",0,0,0,1,0,0,
11-nov-13,N.L.,"GRAL. ZUAZUA, N.L.",0,0,0,2,0,100,
13-nov-13,N.L.,"ALLENDE, N.L.",0,0,0,1,0,0,
14-nov-13,N.L.,"CIENEGA DE FLORES, N.L.",0,0,0,3,0,0,
15-nov-13,TAMPS.,"VICTORIA, TAMPS.",0,0,0,11,1,200,
19-nov-13,N.L.,"SAN PEDRO GARZA GARCIA, N.L.",0,0,0,4,0,0,
19-nov-13,COAH.,"ACUÑA, COAH.",0,0,0,1,0,80,
19-nov-13,TAMPS.,"NUEVO LAREDO, TAMPS.",0,0,0,0,0,150,
21-nov-13,HGO.,"TEPEJI DEL RIO DE OCAMPO, HGO.",0,0,0,0,1,0,
23-nov-13,SON.,"HERMOSILLO, SON.",0,0,0,0,0,61,
23-nov-13,N.L.,"SAN PEDRO GARZA GARCIA, N.L.",0,0,0,5,0,24,
23-nov-13,N.L.,"APODACA, N.L.",0,0,0,0,0,150,
23-nov-13,TAB.,"JALAPA, TAB.",0,0,0,3,0,37,
23-nov-13,PUE.,"PUE., PUE.",0,0,0,0,0,66,
23-nov-13,HGO.,"ZIMAPAN, HGO.",0,0,0,0,0,200,
25-nov-13,TAB.,"JALAPA, TAB.",0,0,0,0,1,0,
25-nov-13,SON.,"EMPALME, SON.",0,0,0,1,0,14,
26-nov-13,SON.,"EMPALME, SON.",0,0,0,1,0,0,
27-nov-13,TAMPS.,"ALTAMIRA, TAMPS.",0,0,0,0,0,5,
27-nov-13,SON.,"PUERTO PEÑASCO, SON.",0,0,0,0,1,5,
27-nov-13,PUE.,"PUE., PUE.",0,0,0,1,0,233,
28-nov-13,SON.,"PUERTO PEÑASCO, SON.",0,0,0,0,0,4,
28-nov-13,SON.,"MAGDALENA, SON.",0,0,0,0,0,50,
29-nov-13,SON.,"NOGALES, SON.",0,0,0,37,0,8,
29-nov-13,PUE.,"PUE., PUE.",0,0,0,0,0,84,
29-nov-13,TAMPS.,"EL MANTE, TAMPS.",0,0,0,6,0,37,
30-nov-13,N.L.,"GRAL. ESCOBEDO, N.L.",0,0,0,4,0,0,
30-nov-13,SON.,"HERMOSILLO, SON.",0,0,0,3,0,183,
30-nov-13,SON.,"AGUA PRIETA, SON.",0,0,0,1,0,48,
02-dic-13,SON.,"GUAYMAS, SON.",0,0,0,1,0,0,
02-dic-13,SON.,"ETCHOJOA, SON.",0,0,0,1,0,40,
03-dic-13,SON.,"CANANEA, SON.",0,0,0,0,0,40,
03-dic-13,SON.,"MAGDALENA, SON.",0,0,0,3,0,0,
03-dic-13,TAMPS.,"VICTORIA, TAMPS.",0,0,0,0,4,0,
04-dic-13,SON.,"CABORCA, SON.",0,0,0,1,0,0,
04-dic-13,TAMPS.,"ALTAMIRA, TAMPS.",0,0,0,0,0,101,
04-dic-13,SON.,"GUAYMAS, SON.",0,0,0,2,0,626,
05-dic-13,SON.,"GUAYMAS, SON.",0,0,0,10,0,515,
05-dic-13,SON.,"NOGALES, SON.",0,0,0,0,0,8,
05-dic-13,SON.,"GENERAL PLUTARCO ELIAS CALLES, SON.",0,0,0,0,0,87,
06-dic-13,COAH.,"SALTILLO, COAH.",0,0,0,0,0,38,
06-dic-13,SON.,"HERMOSILLO, SON.",0,0,0,8,0,24,
06-dic-13,SON.,"EMPALME, SON.",0,0,0,3,0,0,
06-dic-13,SON.,"CABORCA, SON.",0,0,0,1,3,2,
07-dic-13,N.L.,"SANTA CATARINA, N.L.",0,0,0,0,0,50,
07-dic-13,CHIS.,"PALENQUE, CHIS.",0,0,0,0,0,76,
07-dic-13,SON.,"HERMOSILLO, SON.",0,0,0,85,0,442,
07-dic-13,SON.,"CAJEME, SON.",0,0,0,0,0,1,
07-dic-13,SON.,"ALAMOS, SON.",0,0,0,0,0,40,
07-dic-13,PUE.,"PUE., PUE.",0,0,0,0,0,73,
09-dic-13,SON.,"PUERTO PEÑASCO, SON.",0,0,0,0,0,193,
09-dic-13,TAMPS.,"VICTORIA, TAMPS.",0,0,0,2,0,37,
10-dic-13,SON.,"URES, SON.",0,0,0,0,0,11,
10-dic-13,SON.,"SANTA ANA, SON.",0,0,0,0,0,10,
10-dic-13,SON.,"GENERAL PLUTARCO ELIAS CALLES, SON.",0,0,0,0,0,60,
10-dic-13,SON.,"MAGDALENA, SON.",0,0,0,0,0,10,
11-dic-13,TAMPS.,"ALTAMIRA, TAMPS.",0,0,0,2,0,15,
11-dic-13,TAMPS.,"VICTORIA, TAMPS.",0,0,0,3,0,50,
11-dic-13,PUE.,"ATLIXCO, PUE.",0,0,0,0,0,326,
12-dic-13,N.L.,"SANTIAGO, N.L.",0,0,0,11,0,400,
12-dic-13,COAH.,"ACUÑA, COAH.",0,0,0,1,0,160,
13-dic-13,TAMPS.,"CIUDAD MADERO, TAMPS.",0,0,0,0,1,19,
14-dic-13,CHIH.,"CHIH., CHIH.",0,0,0,0,15,0,
15-dic-13,TAMPS.,"CIUDAD MADERO, TAMPS.",0,0,0,0,0,22,
15-dic-13,N.L.,"GARCIA, N.L.",0,0,0,28,0,0,
17-dic-13,TAMPS.,"VICTORIA, TAMPS.",0,0,0,0,0,500,
17-dic-13,N.L.,"CADEREYTA JIMENEZ, N.L.",0,0,0,3,0,250,
18-dic-13,PUE.,"NICOLAS BRAVO, PUE.",0,0,0,0,0,58,
19-dic-13,TAMPS.,"NUEVO LAREDO, TAMPS.",0,0,0,12,0,814,
20-dic-13,PUE.,"ATLIXCO, PUE.",0,0,0,0,0,20,
28-dic-13,TAMPS.,"NUEVO LAREDO, TAMPS.",0,0,0,4,0,580,
09-ene-14,Q. ROO,"OTHON P. BLANCO, Q. ROO",0,0,0,0,0,24,
12-ene-14,Q. ROO,"BENITO JUAREZ, Q. ROO",0,0,0,0,0,39,
13-ene-14,Q. ROO,"BENITO JUAREZ, Q. ROO",0,0,0,0,1,96,
13-ene-14,Q. ROO,"COZUMEL, Q. ROO",0,0,0,0,2,0,
15-ene-14,Q. ROO,"COZUMEL, Q. ROO",0,0,0,0,0,6,
15-ene-14,Q. ROO,"OTHON P. BLANCO, Q. ROO",0,0,0,0,0,25,
19-ene-14,Q. ROO,"OTHON P. BLANCO, Q. ROO",0,0,0,0,2,20,
20-ene-14,Q. ROO,"COZUMEL, Q. ROO",0,0,0,0,0,239,
20-ene-14,Q. ROO,"BENITO JUAREZ, Q. ROO",0,0,0,0,0,414,
21-ene-14,PUE.,"PUE., PUE.",0,0,0,0,2,0,
21-ene-14,COAH.,"SALTILLO, COAH.",0,0,0,1,0,207,
22-ene-14,Q. ROO,"COZUMEL, Q. ROO",0,0,0,0,0,100,
22-ene-14,Q. ROO,"BENITO JUAREZ, Q. ROO",0,0,0,0,0,343,
22-ene-14,Q. ROO,"OTHON P. BLANCO, Q. ROO",0,0,0,0,0,44,
22-ene-14,PUE.,"PUE., PUE.",0,0,0,0,0,0,
23-ene-14,Q. ROO,"OTHON P. BLANCO, Q. ROO",0,0,0,0,0,109,
23-ene-14,COAH.,"FRONTERA, COAH.",0,0,0,0,0,170,
30-ene-14,Q. ROO,"BENITO JUAREZ, Q. ROO",0,0,0,0,0,283,
31-ene-14,COAH.,"FRONTERA, COAH.",0,0,0,3,0,84,
01-feb-14,PUE.,"TEHUACAN, PUE.",0,0,0,0,0,35,
04-feb-14,COAH.,"SALTILLO, COAH.",0,0,0,0,1,0,
06-feb-14,COAH.,"MONCLOVA, COAH.",0,0,0,0,0,125,
12-feb-14,Q. ROO,"SOLIDARIDAD, Q. ROO",0,0,0,0,0,22,
12-feb-14,ZAC.,"TLALTENANGO DE SANCHEZ ROMAN, ZAC.",0,0,0,0,0,129,
13-feb-14,Q. ROO,"BACALAR, Q. ROO",0,0,0,0,0,0,
13-feb-14,Q. ROO,"SOLIDARIDAD, Q. ROO",0,0,0,0,0,22,
13-feb-14,COAH.,"FRONTERA, COAH.",0,0,0,0,0,44,
14-feb-14,Q. ROO,"BACALAR, Q. ROO",0,0,0,0,0,50,
14-feb-14,Q. ROO,"SOLIDARIDAD, Q. ROO",0,0,0,0,0,20,
17-feb-14,COAH.,"FRONTERA, COAH.",0,0,0,0,0,83,
18-feb-14,ZAC.,"JEREZ, ZAC.",0,0,0,1,0,27,
19-feb-14,VER.,"XALAPA, VER.",0,0,0,0,0,16,
19-feb-14,COAH.,"SALTILLO, COAH.",0,0,0,10,0,0,
20-feb-14,ZAC.,"TLALTENANGO DE SANCHEZ ROMAN, ZAC.",0,0,0,0,0,109,
21-feb-14,ZAC.,"TLALTENANGO DE SANCHEZ ROMAN, ZAC.",0,0,0,0,0,85,
21-feb-14,VER.,"TUXPAM, VER.",0,0,0,0,0,493,
21-feb-14,Q. ROO,"COZUMEL, Q. ROO",0,0,0,0,0,619,
21-feb-14,Q. ROO,"COZUMEL, Q. ROO",0,0,0,0,0,619,
25-feb-14,ZAC.,"JEREZ, ZAC.",0,0,0,0,0,11,
26-feb-14,ZAC.,"JEREZ, ZAC.",0,0,0,0,2,0,
26-feb-14,COAH.,"SALTILLO, COAH.",0,0,0,0,0,382,
27-feb-14,PUE.,"PUE., PUE.",0,0,0,0,1,73,
28-feb-14,ZAC.,"TLALTENANGO DE SANCHEZ ROMAN, ZAC.",0,0,0,0,0,136,
04-mar-14,N.L.,"SAN NICOLAS DE LOS GARZA, N.L.",0,0,0,0,0,900,
04-mar-14,TAMPS.,"EL MANTE, TAMPS.",0,0,0,0,0,0,
06-mar-14,S.L.P.,"CIUDAD VALLES, S.L.P.",0,0,0,0,1,0,
07-mar-14,Q. ROO,"ISLA MUJERES, Q. ROO",0,0,0,0,0,20,
09-mar-14,N.L.,"SAN NICOLAS DE LOS GARZA, N.L.",0,0,0,1,0,0,
09-mar-14,N.L.,"MONTERREY, N.L.",0,0,0,2,0,6370,
10-mar-14,ZAC.,"ZAC., ZAC.",0,0,0,0,0,416,
11-mar-14,TAB.,"CUNDUACAN, TAB.",0,0,0,0,0,44,
11-mar-14,ZAC.,"ZAC., ZAC.",0,0,0,0,0,250,
12-mar-14,ZAC.,"TLALTENANGO DE SANCHEZ ROMAN, ZAC.",0,0,0,0,0,241,
12-mar-14,CHIH.,"HGO. DEL PARRAL, CHIH.",0,0,0,1,0,0,
13-mar-14,VER.,"POZA RICA DE HGO., VER.",0,0,0,0,0,54,
13-mar-14,ZAC.,"ZAC., ZAC.",0,0,0,0,0,200,
13-mar-14,PUE.,"TEPEXI DE RODRIGUEZ, PUE.",0,0,0,0,3,0,
14-mar-14,ZAC.,"TLALTENANGO DE SANCHEZ ROMAN, ZAC.",0,0,0,0,0,101,
15-mar-14,TAMPS.,"EL MANTE, TAMPS.",0,0,0,1,0,30,
18-mar-14,TAB.,"CENTLA, TAB.",0,0,0,0,0,31,
18-mar-14,ZAC.,"TLALTENANGO DE SANCHEZ ROMAN, ZAC.",0,0,0,0,0,253,
20-mar-14,VER.,"IGNACIO DE LA LLAVE, VER.",0,0,0,0,0,55,
21-mar-14,N.L.,"MONTERREY, N.L.",0,0,0,14,1,677,
22-mar-14,TAB.,"CENTLA, TAB.",0,0,0,0,0,26,
22-mar-14,N.L.,"SAN NICOLAS DE LOS GARZA, N.L.",0,0,0,4,0,71,
22-mar-14,N.L.,"SAN NICOLAS DE LOS GARZA, N.L.",0,0,0,4,0,71,
23-mar-14,N.L.,"SAN NICOLAS DE LOS GARZA, N.L.",0,0,0,1,0,19,
23-mar-14,N.L.,"MONTERREY, N.L.",0,0,0,43,0,840,
24-mar-14,ZAC.,"JEREZ, ZAC.",0,0,0,0,0,8,
24-mar-14,VER.,"POZA RICA DE HGO., VER.",0,0,0,0,1,0,
25-mar-14,PUE.,"PUE., PUE.",0,0,0,0,0,0,
25-mar-14,N.L.,"SAN NICOLAS DE LOS GARZA, N.L.",0,0,0,0,0,86,
25-mar-14,N.L.,"SANTA CATARINA, N.L.",0,0,0,0,0,50,
25-mar-14,SON.,"HERMOSILLO, SON.",0,0,0,0,0,136,
27-mar-14,TAMPS.,"TAMPICO, TAMPS.",0,0,0,0,0,60,
28-mar-14,N.L.,"SAN NICOLAS DE LOS GARZA, N.L.",0,0,0,0,0,50,
29-mar-14,N.L.,"MONTERREY, N.L.",0,0,0,23,0,384,
30-mar-14,N.L.,"MONTERREY, N.L.",0,0,0,0,0,250,
31-mar-14,VER.,"PANUCO, VER.",0,0,0,0,0,161,
31-mar-14,OAX.,"OAX. DE JUAREZ, OAX.",0,0,0,0,2,0,
01-abr-14,N.L.,"SANTA CATARINA, N.L.",0,0,0,0,0,53,
03-abr-14,CHIS.,"TUXTLA GUTIÉRREZ, CHIS.",0,0,0,0,0,97,
05-abr-14,OAX.,"OAX. DE JUAREZ, OAX.",0,0,0,0,1,0,
06-abr-14,CHIS.,"TUZANTÁN, CHIS.",0,0,0,0,0,210,
07-abr-14,OAX.,"SANTA MARIA PETAPA, OAX.",0,0,0,4,1,0,
07-abr-14,ZAC.,"MONTE ESCOBEDO, ZAC.",0,0,0,0,0,76,
08-abr-14,MEX.,"CUAUTITLAN, MEX.",0,0,0,0,0,134,
08-abr-14,N.L.,"SANTA CATARINA, N.L.",0,0,0,3,0,2670,
08-abr-14,SON.,"CAJEME, SON.",0,0,0,0,1,0,
09-abr-14,SON.,"HERMOSILLO, SON.",0,0,0,40,0,0,
10-abr-14,S.L.P.,"CIUDAD VALLES, S.L.P.",0,0,0,1,1,22,
10-abr-14,SON.,"HERMOSILLO, SON.",0,0,0,25,0,0,
10-abr-14,N.L.,"GUADALUPE, N.L.",0,0,0,1,1,1000,
11-abr-14,N.L.,"SANTA CATARINA, N.L.",0,0,0,2,0,5645,
11-abr-14,ZAC.,"MONTE ESCOBEDO, ZAC.",0,0,0,5,0,0,
11-abr-14,S.L.P.,"CIUDAD VALLES, S.L.P.",0,0,0,4,2,84,
11-abr-14,PUE.,"IZUCAR DE MATAMOROS, PUE.",0,0,0,5,0,0,
13-abr-14,N.L.,"SANTA CATARINA, N.L.",0,0,0,15,0,3607,
14-abr-14,N.L.,"GUADALUPE, N.L.",0,0,0,0,0,1050,
16-abr-14,SON.,"HERMOSILLO, SON.",0,0,0,35,0,0,
16-abr-14,N.L.,"GRAL. ESCOBEDO, N.L.",0,0,0,3,0,322,
18-abr-14,N.L.,"APODACA, N.L.",0,0,0,78,0,0,
20-abr-14,N.L.,"APODACA, N.L.",0,0,0,0,0,100,
21-abr-14,SON.,"HERMOSILLO, SON.",0,0,0,0,0,53,
22-abr-14,PUE.,"IZUCAR DE MATAMOROS, PUE.",0,0,0,0,0,9,
26-abr-14,CHIS.,"MAPASTEPEC, CHIS.",0,0,0,0,0,24,
27-abr-14,N.L.,"GRAL. ESCOBEDO, N.L.",0,0,0,4,0,2100,
28-abr-14,CHIS.,"MAPASTEPEC, CHIS.",0,0,0,0,0,63,
30-abr-14,N.L.,"GRAL. ESCOBEDO, N.L.",0,0,0,183,0,3850,
30-abr-14,N.L.,"APODACA, N.L.",0,0,0,21,0,382,
30-abr-14,CHIS.,"MAPASTEPEC, CHIS.",0,0,0,0,0,70,
30-abr-14,N.L.,"CADEREYTA JIMENEZ, N.L.",0,0,0,85,0,0,
01-may-14,B.C.,"ENSENADA, B.C.",0,0,0,0,1,0,
02-may-14,VER.,"POZA RICA DE HGO., VER.",0,0,0,0,1,0,
02-may-14,VER.,"COATZINTLA, VER.",0,0,0,0,0,367,
07-may-14,N.L.,"CADEREYTA JIMENEZ, N.L.",0,0,0,5,0,400,
07-may-14,S.L.P.,"CIUDAD VALLES, S.L.P.",0,0,0,0,0,155,
07-may-14,SON.,"HERMOSILLO, SON.",0,0,0,15,0,292,
08-may-14,SON.,"HERMOSILLO, SON.",0,0,0,1,0,0,
08-may-14,CHIS.,"SAN CRISTOBAL DE LAS CASAS, CHIS.",0,0,0,0,1,0,
09-may-14,MEX.,"NAUCALPAN DE JUAREZ, MEX.",0,0,0,0,1,0,
13-may-14,MEX.,"CHALCO, MEX.",0,0,0,0,0,0,
13-may-14,CHIH.,"HGO. DEL PARRAL, CHIH.",0,0,0,0,2,0,
14-may-14,N.L.,"SAN PEDRO GARZA GARCIA, N.L.",0,0,0,1,0,280,
14-may-14,N.L.,"CADEREYTA JIMENEZ, N.L.",0,0,0,1,0,0,
14-may-14,SON.,"HERMOSILLO, SON.",0,0,0,8,0,0,
15-may-14,N.L.,"CADEREYTA JIMENEZ, N.L.",0,0,0,1,0,0,
16-may-14,MEX.,"CHALCO, MEX.",0,0,0,0,0,0,
17-may-14,N.L.,"SAN PEDRO GARZA GARCIA, N.L.",0,0,0,56,0,157,
17-may-14,MEX.,"ATLACOMULCO, MEX.",0,0,0,0,0,0,
17-may-14,MEX.,"NAUCALPAN DE JUAREZ, MEX.",0,0,0,0,0,0,
17-may-14,MEX.,"TENANGO DEL VALLE, MEX.",0,0,0,0,0,0,
20-may-14,N.L.,"SAN PEDRO GARZA GARCIA, N.L.",0,0,0,15,0,4100,
20-may-14,CHIH.,"GUADALUPE, CHIH.",0,0,0,0,0,100,
20-may-14,COAH.,"PARRAS, COAH.",0,0,0,0,0,13,
21-may-14,S.L.P.,"SAN LUIS POTOSI, S.L.P.",0,0,0,0,1,0,
22-may-14,PUE.,"PUE., PUE.",0,0,0,2,0,40,
22-may-14,N.L.,"GARCIA, N.L.",0,0,0,10,0,3775,
22-may-14,Q. ROO,"COZUMEL, Q. ROO",0,0,0,0,0,18,
24-may-14,SON.,"HERMOSILLO, SON.",0,0,0,1,0,779,
25-may-14,N.L.,"GARCIA, N.L.",0,0,0,22,0,2962,
26-may-14,HGO.,"PACHUCA DE SOTO, HGO.",0,0,0,0,0,200,
26-may-14,SON.,"HERMOSILLO, SON.",0,0,0,22,0,0,
26-may-14,N.L.,"GARCIA, N.L.",0,0,0,5,0,310,
27-may-14,N.L.,"JUAREZ, N.L.",0,0,0,2,0,0,
27-may-14,N.L.,"GARCIA, N.L.",0,0,0,15,0,4598,
28-may-14,S.L.P.,"CIUDAD VALLES, S.L.P.",0,0,0,0,1,0,
28-may-14,N.L.,"GARCIA, N.L.",0,0,0,14,0,4500,
29-may-14,CHIH.,"MADERA, CHIH.",0,0,0,0,0,11,
30-may-14,CHIH.,"MADERA, CHIH.",0,0,0,0,0,10,
30-may-14,CHIH.,"GUADALUPE, CHIH.",0,0,0,0,0,25,
30-may-14,N.L.,"GARCIA, N.L.",0,0,0,27,0,6833,
30-may-14,PUE.,"PUE., PUE.",0,0,0,0,1,20,
30-may-14,SON.,"HERMOSILLO, SON.",0,0,0,23,0,860,
31-may-14,N.L.,"GARCIA, N.L.",0,0,0,80,0,8257,
31-may-14,SON.,"HERMOSILLO, SON.",0,0,0,9,0,0,
02-jun-14,N.L.,"JUAREZ, N.L.",0,0,0,4,0,100,
03-jun-14,OAX.,"CIUDAD IXTEPEC, OAX.",0,0,0,6,0,40,
03-jun-14,COL.,"COL., COL.",0,0,0,0,0,14,
03-jun-14,N.L.,"SANTIAGO, N.L.",0,0,0,10,0,450,
04-jun-14,COL.,"TECOMÁN, COL.",0,0,0,0,0,14,
04-jun-14,N.L.,"SANTIAGO, N.L.",0,0,0,2,1,389,
05-jun-14,SON.,"HERMOSILLO, SON.",0,0,0,5,0,0,
05-jun-14,PUE.,"PUE., PUE.",0,0,0,2,0,10,
06-jun-14,SON.,"HERMOSILLO, SON.",0,0,0,23,0,91,
06-jun-14,PUE.,"PUE., PUE.",0,0,0,0,2,110,
09-jun-14,CHIH.,"CHIH., CHIH.",0,0,0,0,0,0,
10-jun-14,N.L.,"SANTIAGO, N.L.",0,0,0,1,0,2265,
11-jun-14,N.L.,"LOS ALDAMAS, N.L.",0,0,0,0,0,4,
11-jun-14,PUE.,"PUE., PUE.",0,0,0,0,1,0,
11-jun-14,SON.,"HERMOSILLO, SON.",0,0,0,25,0,832,
11-jun-14,SON.,"CAJEME, SON.",0,0,0,0,0,100,
12-jun-14,SON.,"HERMOSILLO, SON.",0,0,0,7,0,663,
13-jun-14,NAY.,"SANTA MARIA DEL ORO, NAY.",0,0,0,0,0,0,
14-jun-14,N.L.,"BUSTAMANTE, N.L.",0,0,0,9,0,1000,
18-jun-14,SON.,"HERMOSILLO, SON.",0,0,0,0,0,67,
20-jun-14,SON.,"HERMOSILLO, SON.",0,0,0,0,0,10,
21-jun-14,SON.,"HERMOSILLO, SON.",0,0,0,2,0,84,
23-jun-14,ZAC.,"VILLANUEVA, ZAC.",0,0,0,0,0,25,
23-jun-14,N.L.,"MONTEMOR., N.L.",0,0,0,0,0,1415,
24-jun-14,SON.,"HERMOSILLO, SON.",0,0,0,22,0,0,
24-jun-14,COAH.,"SALTILLO, COAH.",0,0,0,2,0,223,
24-jun-14,N.L.,"MONTEMOR., N.L.",0,0,0,1,0,850,
24-jun-14,HGO.,"TULANCINGO DE BRAVO, HGO.",0,0,0,0,1,0,
25-jun-14,HGO.,"TULANCINGO DE BRAVO, HGO.",0,0,0,0,1,0,
25-jun-14,CHIH.,"CHIH., CHIH.",0,0,0,30,0,0,
25-jun-14,COAH.,"ACUÑA, COAH.",0,0,0,0,0,67,
26-jun-14,N.L.,"MONTEMOR., N.L.",0,0,0,8,0,3602,
26-jun-14,ZAC.,"VILLANUEVA, ZAC.",0,0,0,0,0,129,
27-jun-14,N.L.,"MONTEMOR., N.L.",0,0,0,5,0,2660,
28-jun-14,N.L.,"MONTEMOR., N.L.",0,0,0,2,0,2950,
28-jun-14,N.L.,"SALINAS VICTORIA, N.L.",0,0,0,5,0,141,
28-jun-14,SON.,"HERMOSILLO, SON.",0,0,0,11,0,0,
30-jun-14,N.L.,"MONTEMOR., N.L.",0,0,0,0,0,50,
30-jun-14,N.L.,"SALINAS VICTORIA, N.L.",0,0,0,2,0,100,
30-jun-14,COAH.,"MÚZQUIZ, COAH.",0,0,0,2,2,188,
02-jul-14,N.L.,"HUALAHUISES, N.L.",0,0,0,11,0,100,
02-jul-14,ZAC.,"VILLANUEVA, ZAC.",0,0,0,2,0,0,
03-jul-14,CHIS.,"ARRIAGA, CHIS.",0,0,0,0,0,7,
03-jul-14,SON.,"HERMOSILLO, SON.",0,0,0,9,0,50,
04-jul-14,ZAC.,"VILLANUEVA, ZAC.",0,0,0,1,0,0,
04-jul-14,N.L.,"CARMEN, N.L.",0,0,0,56,0,252,
05-jul-14,N.L.,"HUALAHUISES, N.L.",0,0,0,7,0,100,
05-jul-14,SON.,"HERMOSILLO, SON.",0,0,0,22,0,0,
06-jul-14,CHIS.,"ARRIAGA, CHIS.",0,0,0,0,0,94,
06-jul-14,N.L.,"CARMEN, N.L.",0,0,0,8,0,613,
07-jul-14,N.L.,"HUALAHUISES, N.L.",0,0,0,12,0,0,
09-jul-14,N.L.,"CARMEN, N.L.",0,0,0,2,0,2400,
09-jul-14,N.L.,"HUALAHUISES, N.L.",0,0,0,8,0,100,
09-jul-14,PUE.,"PUE., PUE.",0,0,0,0,0,285,
09-jul-14,SON.,"HERMOSILLO, SON.",0,0,0,0,0,26,
10-jul-14,N.L.,"CARMEN, N.L.",0,0,0,2,0,2895,
10-jul-14,SON.,"HERMOSILLO, SON.",0,0,0,0,0,366,
12-jul-14,SON.,"HERMOSILLO, SON.",0,0,0,24,0,0,
17-jul-14,COL.,"COL., COL.",0,0,0,8,0,225,
17-jul-14,N.L.,"LOS HERRERAS, N.L.",0,0,0,2,0,535,
18-jul-14,COAH.,"SALTILLO, COAH.",0,0,0,177,0,0,
18-jul-14,COL.,"COL., COL.",0,0,0,0,0,13,
22-jul-14,COAH.,"SALTILLO, COAH.",0,0,0,0,0,120,
25-jul-14,CHIH.,"MEOQUI, CHIH.",0,0,0,0,0,19,
26-jul-14,N.L.,"ABASOLO, N.L.",0,0,0,4,0,1450,
27-jul-14,N.L.,"ABASOLO, N.L.",0,0,0,66,0,2870,
28-jul-14,N.L.,"ABASOLO, N.L.",0,0,0,53,0,2240,
29-jul-14,N.L.,"ABASOLO, N.L.",0,0,0,28,0,870,
30-jul-14,SON.,"HERMOSILLO, SON.",0,0,0,0,0,36,
30-jul-14,N.L.,"ABASOLO, N.L.",0,0,0,65,0,1474,
30-jul-14,N.L.,"MINA, N.L.",0,0,0,2,0,0,
01-ago-14,COAH.,"SALTILLO, COAH.",0,0,0,0,0,59,
01-ago-14,COAH.,"ACUÑA, COAH.",0,0,0,0,0,60,
02-ago-14,N.L.,"CERRALVO, N.L.",0,0,0,4,0,490,
02-ago-14,N.L.,"DR. ARROYO, N.L.",0,0,0,1,0,50,
02-ago-14,SON.,"HERMOSILLO, SON.",0,0,0,0,0,374,
03-ago-14,N.L.,"CERRALVO, N.L.",0,0,0,2,0,150,
04-ago-14,SON.,"HERMOSILLO, SON.",0,0,0,36,0,0,
05-ago-14,N.L.,"DR. ARROYO, N.L.",0,0,0,8,0,884,
06-ago-14,N.L.,"CERRALVO, N.L.",0,0,0,7,0,456,
08-ago-14,COAH.,"SALTILLO, COAH.",0,0,0,0,0,10,
08-ago-14,N.L.,"CERRALVO, N.L.",0,0,0,14,0,975,
12-ago-14,COAH.,"SALTILLO, COAH.",0,0,0,0,0,149,
14-ago-14,COAH.,"ACUÑA, COAH.",0,0,0,0,0,30,
14-ago-14,N.L.,"SAN NICOLAS DE LOS GARZA, N.L.",0,0,0,0,0,100,
16-ago-14,SON.,"HERMOSILLO, SON.",0,0,0,1,0,1120,
16-ago-14,SON.,"CAJEME, SON.",0,0,0,1,0,442,
16-ago-14,TAMPS.,"MATAMOROS, TAMPS.",0,0,0,4,0,88,
18-ago-14,COAH.,"SALTILLO, COAH.",0,0,0,5,0,228,
18-ago-14,N.L.,"SAN NICOLAS DE LOS GARZA, N.L.",0,0,0,1,0,250,
19-ago-14,PUE.,"ATLIXCO, PUE.",0,0,0,1,0,6,
19-ago-14,SON.,"HERMOSILLO, SON.",0,0,0,0,0,700,
20-ago-14,SON.,"HERMOSILLO, SON.",0,0,0,0,0,98,
21-ago-14,SON.,"HERMOSILLO, SON.",0,0,0,0,0,1700,
21-ago-14,COAH.,"SALTILLO, COAH.",0,0,0,0,0,78,
21-ago-14,N.L.,"SANTA CATARINA, N.L.",0,0,0,5,0,0,
22-ago-14,N.L.,"SANTA CATARINA, N.L.",0,0,0,50,0,0,
22-ago-14,COAH.,"SALTILLO, COAH.",0,0,0,1,1,9,
25-ago-14,SON.,"CAJEME, SON.",0,0,0,1,0,330,
25-ago-14,N.L.,"SANTA CATARINA, N.L.",0,0,0,1,0,91,
26-ago-14,N.L.,"GUADALUPE, N.L.",0,0,0,1,0,261,
27-ago-14,N.L.,"GUADALUPE, N.L.",0,0,0,2,0,221,
27-ago-14,SON.,"HERMOSILLO, SON.",0,0,0,0,0,800,
28-ago-14,N.L.,"GUADALUPE, N.L.",0,0,0,1,0,0,
29-ago-14,TAB.,"TENOSIQUE, TAB.",0,0,0,0,1,0,
29-ago-14,MICH.,"APATZINGAN, MICH.",0,0,0,0,2,0,
30-ago-14,N.L.,"SANTA CATARINA, N.L.",0,0,0,41,0,0,
01-sep-14,N.L.,"APODACA, N.L.",0,0,0,1,0,158,
01-sep-14,AGS.,"JESÚS MARÍA, AGS.",0,0,0,2,0,98,
02-sep-14,SON.,"CAJEME, SON.",0,0,0,1,0,100,
02-sep-14,N.L.,"GRAL. ESCOBEDO, N.L.",0,0,0,150,0,3500,
03-sep-14,COAH.,"SALTILLO, COAH.",0,0,0,2,1,83,
03-sep-14,PUE.,"PUE., PUE.",0,0,0,0,0,26,
04-sep-14,SON.,"HERMOSILLO, SON.",0,0,0,33,0,300,
05-sep-14,N.L.,"MONTERREY, N.L.",0,0,0,2,0,0,
05-sep-14,PUE.,"ATLIXCO, PUE.",0,0,0,0,0,12,
05-sep-14,N.L.,"GRAL. ESCOBEDO, N.L.",0,0,0,2,0,0,
06-sep-14,N.L.,"GRAL. ESCOBEDO, N.L.",0,0,0,107,0,1182,
06-sep-14,N.L.,"APODACA, N.L.",0,0,0,3,0,490,
08-sep-14,AGS.,"JESÚS MARÍA, AGS.",0,0,0,25,0,0,
10-sep-14,N.L.,"APODACA, N.L.",0,0,0,0,0,480,
10-sep-14,PUE.,"ATLIXCO, PUE.",0,0,0,0,0,94,
11-sep-14,COAH.,"SALTILLO, COAH.",0,0,0,2,1,257,
11-sep-14,SON.,"CAJEME, SON.",0,0,0,0,0,1001,
15-sep-14,N.L.,"SAN PEDRO GARZA GARCIA, N.L.",0,0,0,0,0,300,
15-sep-14,N.L.,"CADEREYTA JIMENEZ, N.L.",0,0,0,0,0,450,
16-sep-14,N.L.,"SAN PEDRO GARZA GARCIA, N.L.",0,0,0,0,0,6480,
16-sep-14,N.L.,"CADEREYTA JIMENEZ, N.L.",0,0,0,1,0,2000,
17-sep-14,N.L.,"CADEREYTA JIMENEZ, N.L.",0,0,0,"1,039",0,0,
18-sep-14,N.L.,"CADEREYTA JIMENEZ, N.L.",0,0,0,0,0,69,
19-sep-14,COAH.,"SALTILLO, COAH.",0,0,0,6,0,40,
19-sep-14,SON.,"HERMOSILLO, SON.",0,0,0,0,0,162,
19-sep-14,N.L.,"SAN PEDRO GARZA GARCIA, N.L.",0,0,0,0,0,7156,
20-sep-14,N.L.,"SAN PEDRO GARZA GARCIA, N.L.",0,0,0,0,0,64,
21-sep-14,MICH.,"COALCOMAN DE VAZQUEZ PALLARES, MICH.",0,0,0,0,0,575,
24-sep-14,N.L.,"GARCIA, N.L.",0,0,0,0,0,6750,
24-sep-14,MICH.,"COALCOMAN DE VAZQUEZ PALLARES, MICH.",0,0,0,0,0,723,
25-sep-14,COAH.,"SALTILLO, COAH.",0,0,0,0,0,45,
25-sep-14,N.L.,"GARCIA, N.L.",0,0,0,0,0,6725,
26-sep-14,AGS.,"SAN JOSÉ DE GRACIA, AGS.",0,0,0,0,0,76,
28-sep-14,N.L.,"JUAREZ, N.L.",0,0,0,0,0,30,
30-sep-14,N.L.,"GARCIA, N.L.",0,0,0,1,0,100,
01-oct-14,COAH.,"SALTILLO, COAH.",0,0,0,0,0,19,
02-oct-14,N.L.,"SAN NICOLAS DE LOS GARZA, N.L.",0,0,0,0,0,175,
03-oct-14,SIN.,"ELOTA, SIN.",0,0,0,0,2,0,
03-oct-14,AGS.,"AGS., AGS.",0,0,0,0,0,130,
03-oct-14,COAH.,"SALTILLO, COAH.",0,0,0,4,0,141,
07-oct-14,PUE.,"ATLIXCO, PUE.",0,0,0,0,0,61,
07-oct-14,COAH.,"SALTILLO, COAH.",0,0,0,0,0,32,
07-oct-14,SON.,"MAGDALENA, SON.",0,0,0,2,0,0,
08-oct-14,AGS.,"SAN JOSÉ DE GRACIA, AGS.",0,0,0,1,0,11,
08-oct-14,CHIS.,"UNIÓN JUÁREZ, CHIS.",0,0,0,0,1,0,
08-oct-14,SON.,"MAGDALENA, SON.",0,0,0,0,0,20,
08-oct-14,CHIH.,"NUEVO CASAS GRANDES, CHIH.",0,0,0,0,0,7,
08-oct-14,CHIH.,"CASAS GRANDES, CHIH.",0,0,0,0,0,7,
09-oct-14,SON.,"AGUA PRIETA, SON.",0,0,0,3,0,0,
09-oct-14,SON.,"PUERTO PEÑASCO, SON.",0,0,0,2,0,9,
10-oct-14,SON.,"ALAMOS, SON.",0,0,0,1,0,28,
10-oct-14,SON.,"CANANEA, SON.",0,0,0,0,1,4,
10-oct-14,N.L.,"SAN NICOLAS DE LOS GARZA, N.L.",0,0,0,68,0,0,
11-oct-14,N.L.,"GUADALUPE, N.L.",0,0,0,2,0,2000,
13-oct-14,SON.,"IMURIS, SON.",0,0,0,1,0,0,
13-oct-14,SON.,"SANTA ANA, SON.",0,0,0,12,0,0,
13-oct-14,COAH.,"SALTILLO, COAH.",0,0,0,0,0,151,
14-oct-14,COAH.,"SALTILLO, COAH.",0,0,0,2,0,254,
15-oct-14,SON.,"GUAYMAS, SON.",0,0,0,1,0,7,
15-oct-14,SON.,"EMPALME, SON.",0,0,0,0,0,9,
15-oct-14,SON.,"ETCHOJOA, SON.",0,0,0,0,0,16,
15-oct-14,PUE.,"ACATZINGO, PUE.",0,0,0,0,1,13,
16-oct-14,AGS.,"SAN JOSÉ DE GRACIA, AGS.",0,0,0,1,0,170,
16-oct-14,N.L.,"SANTA CATARINA, N.L.",0,0,0,33,0,0,
16-oct-14,N.L.,"GUADALUPE, N.L.",0,0,0,0,0,100,
16-oct-14,GRO.,"ACAPULCO DE JUAREZ, GRO.",0,0,0,0,0,26,
17-oct-14,COAH.,"SALTILLO, COAH.",0,0,0,0,0,109,
17-oct-14,SIN.,"CONCORDIA, SIN.",0,0,0,0,7,0,
17-oct-14,SON.,"MAGDALENA, SON.",0,0,0,1,0,0,
18-oct-14,N.L.,"GUADALUPE, N.L.",0,0,0,1,0,0,
18-oct-14,SON.,"MAGDALENA, SON.",0,0,0,1,0,0,
19-oct-14,S.L.P.,"SAN LUIS POTOSI, S.L.P.",0,0,0,0,1,0,
19-oct-14,N.L.,"GUADALUPE, N.L.",0,0,0,1,0,114,
20-oct-14,CHIS.,"PICHUCALCO, CHIS.",0,0,0,1,1,19,
21-oct-14,N.L.,"GRAL. ESCOBEDO, N.L.",0,0,0,0,0,1000,
21-oct-14,SON.,"SANTA ANA, SON.",0,0,0,12,0,0,
21-oct-14,SON.,"CANANEA, SON.",0,0,0,3,1,25,
21-oct-14,B.C.,"ENSENADA, B.C.",0,0,0,0,1,0,
22-oct-14,N.L.,"APODACA, N.L.",0,0,0,1,0,130,
23-oct-14,SON.,"SANTA ANA, SON.",0,0,0,7,0,0,
24-oct-14,MOR.,"CUERNAVACA, MOR.",0,0,0,0,1,300,
24-oct-14,CHIS.,"OCOSINGO, CHIS.",0,0,0,3,0,90,
24-oct-14,SON.,"HERMOSILLO, SON.",0,0,0,11,0,910,
24-oct-14,N.L.,"GRAL. ESCOBEDO, N.L.",0,0,0,0,0,250,
25-oct-14,SON.,"NOGALES, SON.",0,0,0,0,0,59,
25-oct-14,SON.,"AGUA PRIETA, SON.",0,0,0,0,0,60,
25-oct-14,MICH.,"LAZARO CARDENAS, MICH.",0,0,0,0,0,689,
25-oct-14,N.L.,"APODACA, N.L.",0,0,0,15,0,703,
25-oct-14,SON.,"GUAYMAS, SON.",0,0,0,1,0,38,
27-oct-14,COAH.,"SALTILLO, COAH.",0,0,0,0,0,77,
27-oct-14,MICH.,"APATZINGAN, MICH.",0,0,0,0,0,194,
27-oct-14,CHIS.,"PICHUCALCO, CHIS.",0,0,0,1,0,20,
27-oct-14,SON.,"CABORCA, SON.",0,0,0,1,0,50,
27-oct-14,CHIS.,"PICHUCALCO, CHIS.",0,0,0,1,0,20,
28-oct-14,COAH.,"SALTILLO, COAH.",0,0,0,0,0,66,
28-oct-14,MICH.,"APATZINGAN, MICH.",0,0,0,0,0,500,
28-oct-14,N.L.,"APODACA, N.L.",0,0,0,14,0,1053,
28-oct-14,PUE.,"ATLIXCO, PUE.",0,0,0,0,0,237,
28-oct-14,PUE.,"SAN PEDRO CHOLULA, PUE.",0,0,0,0,0,500,
29-oct-14,TAMPS.,"PADILLA, TAMPS.",0,0,0,0,0,340,
29-oct-14,MICH.,"ZAMORA, MICH.",0,0,0,0,0,44,
29-oct-14,MICH.,"TACAMBARO, MICH.",0,0,0,0,0,1155,
29-oct-14,CHIS.,"PICHUCALCO, CHIS.",0,0,0,2,0,221,
29-oct-14,MICH.,"LAZARO CARDENAS, MICH.",0,0,0,0,1,1480,
29-oct-14,SON.,"IMURIS, SON.",0,0,0,1,0,35,
30-oct-14,MOR.,"CUERNAVACA, MOR.",0,0,0,0,1,0,
30-oct-14,CHIS.,"OCOSINGO, CHIS.",0,0,0,9,0,556,
30-oct-14,SON.,"SANTA ANA, SON.",0,0,0,8,0,50,
30-oct-14,SON.,"CANANEA, SON.",0,0,0,0,0,71,
31-oct-14,COL.,"COL., COL.",0,0,0,0,1,9,
01-nov-14,SON.,"SANTA ANA, SON.",0,0,0,0,0,13,
03-nov-14,CHIS.,"PICHUCALCO, CHIS.",0,0,0,4,0,210,
03-nov-14,CHIS.,"TAPACHULA, CHIS.",0,0,0,15,0,1719,
04-nov-14,CHIS.,"PICHUCALCO, CHIS.",0,0,0,0,1,606,
04-nov-14,CHIS.,"PALENQUE, CHIS.",0,0,0,0,0,337,
04-nov-14,CHIS.,"PICHUCALCO, CHIS.",0,0,0,6,0,606,
05-nov-14,CHIS.,"PICHUCALCO, CHIS.",0,0,0,7,0,517,
05-nov-14,N.L.,"CADEREYTA JIMENEZ, N.L.",0,0,0,0,0,1950,
06-nov-14,COAH.,"SALTILLO, COAH.",0,0,0,0,0,44,
06-nov-14,PUE.,"ATLIXCO, PUE.",0,0,0,0,0,98,
07-nov-14,CHIH.,"JUÁREZ, CHIH.",0,0,0,0,1,0,
08-nov-14,CHIS.,"OCOZOCOAUTLA DE ESPINOSA, CHIS.",0,0,0,0,8,20,
08-nov-14,CHIS.,"PICHUCALCO, CHIS.",0,0,0,1,0,301,
09-nov-14,CHIS.,"OCOSINGO, CHIS.",0,0,0,3,0,307,
10-nov-14,CHIS.,"TONALÁ, CHIS.",0,0,0,0,1,1274,
10-nov-14,COAH.,"SALTILLO, COAH.",0,0,0,0,0,33,
11-nov-14,Q. ROO,"OTHON P. BLANCO, Q. ROO",0,0,0,0,1,0,
11-nov-14,PUE.,"ATLIXCO, PUE.",0,0,0,0,0,204,
11-nov-14,CHIS.,"PICHUCALCO, CHIS.",0,0,0,2,0,242,
12-nov-14,CHIS.,"PICHUCALCO, CHIS.",0,0,0,3,0,314,
13-nov-14,AGS.,"AGS., AGS.",0,0,0,0,0,1800,
13-nov-14,CHIS.,"PICHUCALCO, CHIS.",0,0,0,2,0,161,
13-nov-14,COAH.,"SALTILLO, COAH.",0,0,0,0,0,102,
13-nov-14,CHIS.,"OCOSINGO, CHIS.",0,0,0,1,0,471,
15-nov-14,GRO.,"FLORENCIO VILLARREAL, GRO.",0,0,0,0,2,0,
19-nov-14,N.L.,"GUADALUPE, N.L.",0,0,0,1,0,0,
19-nov-14,N.L.,"SANTA CATARINA, N.L.",0,0,0,0,0,1000,
20-nov-14,N.L.,"SANTA CATARINA, N.L.",0,0,0,0,1,0,
21-nov-14,Q. ROO,"OTHON P. BLANCO, Q. ROO",0,0,0,0,4,0,
21-nov-14,PUE.,"ATLIXCO, PUE.",0,0,0,0,0,465,
22-nov-14,N.L.,"GUADALUPE, N.L.",0,0,0,10,0,200,
26-nov-14,COAH.,"SALTILLO, COAH.",0,0,0,6,0,89,
28-nov-14,COAH.,"SALTILLO, COAH.",0,0,0,0,0,45,
28-nov-14,HGO.,"HUEJUTLA DE REYES, HGO.",0,0,0,0,4,16,
29-nov-14,HGO.,"HUEJUTLA DE REYES, HGO.",0,0,0,0,0,200,
03-dic-14,GRO.,"TELOLOAPAN, GRO.",0,0,0,0,1,0,
04-dic-14,COAH.,"ACUÑA, COAH.",0,0,0,0,0,25,
05-dic-14,COAH.,"SALTILLO, COAH.",0,0,0,0,0,15,
08-dic-14,COAH.,"SALTILLO, COAH.",0,0,0,0,0,20,
08-dic-14,Q. ROO,"COZUMEL, Q. ROO",0,0,0,0,0,130,
09-dic-14,Q. ROO,"COZUMEL, Q. ROO",0,0,0,0,0,33,
10-dic-14,PUE.,"ATLIXCO, PUE.",0,0,0,0,0,270,
16-dic-14,COAH.,"SALTILLO, COAH.",0,0,0,0,0,30,
18-dic-14,COAH.,"SALTILLO, COAH.",0,0,0,0,0,28,
18-dic-14,N.L.,"SAN NICOLAS DE LOS GARZA, N.L.",0,0,0,3,0,0,
03-ene-15,DGO.,"DGO., DGO.",0,0,0,0,1,0,
23-ene-15,COAH.,"SALTILLO, COAH.",0,0,0,0,0,140,
26-ene-15,COAH.,"SALTILLO, COAH.",0,0,0,0,0,4,
27-ene-15,PUE.,"ATLIXCO, PUE.",0,0,0,0,0,60,
06-feb-15,COAH.,"ACUÑA, COAH.",0,0,0,1,0,0,
06-feb-15,PUE.,"TEHUACAN, PUE.",0,0,0,0,0,18,
08-feb-15,COAH.,"ACUÑA, COAH.",0,0,0,0,0,35,
11-feb-15,COAH.,"FRONTERA, COAH.",0,0,0,0,1,0,
12-feb-15,GRO.,"ACAPULCO DE JUAREZ, GRO.",0,0,0,0,0,17,
12-feb-15,Q. ROO,"OTHON P. BLANCO, Q. ROO",0,0,0,0,5,0,
15-feb-15,Q. ROO,"OTHON P. BLANCO, Q. ROO",0,0,0,0,5,0,
20-feb-15,Q. ROO,"OTHON P. BLANCO, Q. ROO",0,0,0,1,0,59,
21-feb-15,PUE.,"ATLIXCO, PUE.",0,0,0,0,0,345,
22-feb-15,ZAC.,"TEUL DE GONZALEZ ORTEGA, ZAC.",0,0,0,0,0,250,
23-feb-15,ZAC.,"TEUL DE GONZALEZ ORTEGA, ZAC.",0,0,0,0,0,250,
24-feb-15,PUE.,"TEHUACAN, PUE.",0,0,0,0,0,86,
27-feb-15,PUE.,"ATLIXCO, PUE.",0,0,0,0,0,73,
28-feb-15,PUE.,"TEHUACAN, PUE.",0,0,0,0,0,39,
03-mar-15,HGO.,"PACHUCA DE SOTO, HGO.",0,0,0,0,0,17,
04-mar-15,HGO.,"PACHUCA DE SOTO, HGO.",0,0,0,0,0,67,
04-mar-15,TAB.,"JALAPA, TAB.",0,0,0,1,0,99,
06-mar-15,TAB.,"JALAPA, TAB.",0,0,0,0,0,56,
11-mar-15,CHIS.,"REFORMA, CHIS.",0,0,0,0,0,25,
18-mar-15,TAMPS.,"TAMPICO, TAMPS.",0,0,0,1,0,22,
19-mar-15,PUE.,"ATLIXCO, PUE.",0,0,0,1,0,18,
21-mar-15,TAMPS.,"NUEVO LAREDO, TAMPS.",0,0,0,3,0,44,
22-mar-15,CHIS.,"REFORMA, CHIS.",0,0,0,1,0,105,
26-mar-15,OAX.,"OAX. DE JUAREZ, OAX.",0,0,0,0,0,12,
26-mar-15,DGO.,"LERDO, DGO.",0,0,0,0,1,0,
01-ago-15,CHIS.,"TAPACHULA, CHIS.",0,0,0,0,0,80,
01-ago-15,CHIS.,"TONALÁ, CHIS.",0,0,0,0,0,89,
03-ago-15,OAX.,"MIAHUATLAN DE PORFIRIO DIAZ, OAX.",0,0,0,0,0,1,
03-ago-15,Q. ROO,"OTHON P. BLANCO, Q. ROO",0,0,0,0,0,83,
05-ago-15,TAB.,"NACAJUCA, TAB.",0,0,0,0,0,46,
05-ago-15,GRO.,"EDUARDO NERI, GRO.",0,0,0,0,1,0,
05-ago-15,CHIH.,"JANOS, CHIH.",0,0,0,0,0,21,
06-ago-15,GRO.,"EDUARDO NERI, GRO.",0,0,0,0,3,3,
06-ago-15,Q. ROO,"OTHON P. BLANCO, Q. ROO",0,0,0,0,0,298,
07-ago-15,CHIS.,"TONALÁ, CHIS.",0,0,0,0,0,99,
07-ago-15,Q. ROO,"OTHON P. BLANCO, Q. ROO",0,0,0,0,0,251,
07-ago-15,TAMPS.,"MIER, TAMPS.",0,0,0,8,0,228,
08-ago-15,Q. ROO,"OTHON P. BLANCO, Q. ROO",0,0,0,0,0,42,
08-ago-15,COAH.,"TORREÓN, COAH.",0,0,0,0,0,47,
08-ago-15,GRO.,"PETATLAN, GRO.",0,0,0,0,0,120,
10-ago-15,HGO.,"APAN, HGO.",0,0,0,0,0,103,
10-ago-15,Q. ROO,"OTHON P. BLANCO, Q. ROO",0,0,0,0,4,492,
10-ago-15,COAH.,"MONCLOVA, COAH.",0,0,0,1,0,42,
10-ago-15,COAH.,"MÚZQUIZ, COAH.",0,0,0,0,0,180,
10-ago-15,CHIH.,"CHIH., CHIH.",0,0,0,0,1,51,
11-ago-15,OAX.,"MIAHUATLAN DE PORFIRIO DIAZ, OAX.",0,0,0,0,0,33,
11-ago-15,DGO.,"LERDO, DGO.",0,0,0,0,4,0,
11-ago-15,AGS.,"CALVILLO, AGS.",0,0,0,49,0,228,
11-ago-15,QRO.,"AMEALCO DE BONFIL, QRO.",0,0,0,0,0,0,
11-ago-15,GRO.,"ACAPULCO DE JUAREZ, GRO.",0,0,0,0,0,0,
11-ago-15,GRO.,"PETATLAN, GRO.",0,0,0,2,0,15,
12-ago-15,HGO.,"APAN, HGO.",0,0,0,0,0,132,
12-ago-15,CHIS.,"TAPACHULA, CHIS.",0,0,0,0,1,0,
13-ago-15,TAMPS.,"EL MANTE, TAMPS.",0,0,0,0,0,40,
14-ago-15,CHIS.,"TONALÁ, CHIS.",0,0,0,0,0,59,
14-ago-15,TAMPS.,"NUEVO LAREDO, TAMPS.",0,0,0,0,0,0,
15-ago-15,SON.,"CAJEME, SON.",0,0,0,0,0,250,
15-ago-15,TAMPS.,"VICTORIA, TAMPS.",0,0,0,1,0,20,
17-ago-15,TAB.,"CENTRO, TAB.",0,0,0,1,0,173,
17-ago-15,AGS.,"CALVILLO, AGS.",0,0,0,2,0,223,
17-ago-15,TAMPS.,"EL MANTE, TAMPS.",0,0,0,1,0,57,
17-ago-15,OAX.,"MIAHUATLAN DE PORFIRIO DIAZ, OAX.",0,0,0,1,0,30,
17-ago-15,DGO.,"LERDO, DGO.",0,0,0,0,0,0,
18-ago-15,S.L.P.,"CIUDAD VALLES, S.L.P.",0,0,0,0,0,53,
18-ago-15,TAB.,"TENOSIQUE, TAB.",0,0,0,0,1,0,
18-ago-15,AGS.,"CALVILLO, AGS.",0,0,0,0,0,447,
18-ago-15,SON.,"CAJEME, SON.",0,0,0,0,1,9050,
20-ago-15,AGS.,"CALVILLO, AGS.",0,0,0,10,0,0,
20-ago-15,HGO.,"EMILIANO ZAPATA, HGO.",0,0,0,0,0,18,
20-ago-15,ZAC.,"JEREZ, ZAC.",0,0,0,6,0,300,
21-ago-15,AGS.,"CALVILLO, AGS.",0,0,0,0,0,447,
21-ago-15,TAMPS.,"EL MANTE, TAMPS.",0,0,0,0,0,50,
21-ago-15,Q. ROO,"COZUMEL, Q. ROO",0,0,0,0,0,392,
21-ago-15,GRO.,"CHILAPA DE ALVAREZ, GRO.",0,0,0,0,1,0,
21-ago-15,QRO.,"CORREGIDORA, QRO.",0,0,0,0,0,0,
22-ago-15,HGO.,"EMILIANO ZAPATA, HGO.",0,0,0,0,1,0,
22-ago-15,DGO.,"LERDO, DGO.",0,0,0,0,1,0,
24-ago-15,OAX.,"MIAHUATLAN DE PORFIRIO DIAZ, OAX.",0,0,0,1,0,25,
24-ago-15,TAB.,"CENTRO, TAB.",0,0,0,1,1,50,
24-ago-15,CHIH.,"CHIH., CHIH.",0,0,0,8,1,1855,
24-ago-15,CHIH.,"GUADALUPE, CHIH.",0,0,0,0,0,142,
24-ago-15,TAMPS.,"VICTORIA, TAMPS.",0,0,0,0,0,75,
25-ago-15,Q. ROO,"BACALAR, Q. ROO",0,0,0,0,0,106,
25-ago-15,B.C.S.,"COMONDÚ, B.C.S.",0,0,0,0,0,154,
25-ago-15,TAMPS.,"TAMPICO, TAMPS.",0,0,0,0,0,200,
25-ago-15,CHIH.,"NUEVO CASAS GRANDES, CHIH.",0,0,0,0,0,30,
26-ago-15,Q. ROO,"BACALAR, Q. ROO",0,0,0,0,5,167,
26-ago-15,OAX.,"MIAHUATLAN DE PORFIRIO DIAZ, OAX.",0,0,0,0,0,53,
26-ago-15,TAMPS.,"NUEVO LAREDO, TAMPS.",0,0,0,0,0,132,
26-ago-15,TAB.,"CENTRO, TAB.",0,0,0,0,0,20,
26-ago-15,CHIS.,"TAPACHULA, CHIS.",0,0,0,0,0,114,
27-ago-15,TAMPS.,"VICTORIA, TAMPS.",0,0,0,1,0,119,
27-ago-15,Q. ROO,"BACALAR, Q. ROO",0,0,0,0,0,139,
27-ago-15,N.L.,"MONTERREY, N.L.",0,0,0,16,0,4700,
28-ago-15,ZAC.,"JEREZ, ZAC.",0,0,0,9,0,100,
28-ago-15,COL.,"COL., COL.",0,0,0,0,0,20,
28-ago-15,N.L.,"GARCIA, N.L.",0,0,0,0,0,30,
28-ago-15,TAMPS.,"MATAMOROS, TAMPS.",0,0,0,1,0,103,
28-ago-15,COAH.,"TORREÓN, COAH.",0,0,0,0,0,42,
28-ago-15,OAX.,"MIAHUATLAN DE PORFIRIO DIAZ, OAX.",0,0,0,3,0,60,
28-ago-15,CHIS.,"TAPACHULA, CHIS.",0,0,0,0,0,57,
28-ago-15,CHIS.,"TONALÁ, CHIS.",0,0,0,2,0,0,
29-ago-15,Q. ROO,"BACALAR, Q. ROO",0,0,0,0,0,202,
29-ago-15,CHIS.,"TAPACHULA, CHIS.",0,0,0,0,0,30,
29-ago-15,PUE.,"PUE., PUE.",0,0,0,1,0,0,
29-ago-15,PUE.,"TEHUACAN, PUE.",0,0,0,0,0,99,
29-ago-15,SON.,"CAJEME, SON.",0,0,0,0,0,17,
30-ago-15,N.L.,"GARCIA, N.L.",0,0,0,8,0,287,
31-ago-15,N.L.,"MONTERREY, N.L.",0,0,0,50,0,1300,
31-ago-15,N.L.,"GARCIA, N.L.",0,0,0,27,0,1862,
31-ago-15,OAX.,"MIAHUATLAN DE PORFIRIO DIAZ, OAX.",0,0,0,3,0,90,
31-ago-15,Q. ROO,"BACALAR, Q. ROO",0,0,0,0,0,221,
31-ago-15,TAMPS.,"VICTORIA, TAMPS.",0,0,0,5,0,148,
01-sep-15,Q. ROO,"BACALAR, Q. ROO",0,0,0,0,0,141,
01-sep-15,TAB.,"CENTRO, TAB.",0,0,0,0,0,200,
01-sep-15,N.L.,"MONTERREY, N.L.",0,0,0,51,0,100,
01-sep-15,CHIS.,"HUIXTLA, CHIS.",0,0,0,0,0,95,
01-sep-15,CHIH.,"ASCENSIÓN, CHIH.",0,0,0,0,0,10,
02-sep-15,SIN.,"ANGOSTURA, SIN.",0,0,0,0,1,0,
02-sep-15,TAB.,"CENTRO, TAB.",0,0,0,1,0,64,
02-sep-15,TAMPS.,"NUEVO LAREDO, TAMPS.",0,0,0,3,0,15,
02-sep-15,N.L.,"GARCIA, N.L.",0,0,0,31,0,1950,
03-sep-15,OAX.,"MIAHUATLAN DE PORFIRIO DIAZ, OAX.",0,0,0,0,0,96,
03-sep-15,SON.,"CAJEME, SON.",0,0,0,0,0,1,
04-sep-15,Q. ROO,"BACALAR, Q. ROO",0,0,0,0,0,134,
04-sep-15,TAB.,"CENTRO, TAB.",0,0,0,1,0,279,
05-sep-15,CHIH.,"HGO. DEL PARRAL, CHIH.",0,0,0,0,0,30,
05-sep-15,N.L.,"SANTA CATARINA, N.L.",0,0,0,4,0,600,
05-sep-15,SON.,"CAJEME, SON.",0,0,0,0,0,5000,
05-sep-15,CHIS.,"TAPACHULA, CHIS.",0,0,0,0,0,113,
05-sep-15,PUE.,"TEHUACAN, PUE.",0,0,0,0,11,0,
07-sep-15,HGO.,"TOLCAYUCA, HGO.",0,0,0,0,0,2000,
08-sep-15,OAX.,"MIAHUATLAN DE PORFIRIO DIAZ, OAX.",0,0,0,6,0,0,
08-sep-15,CHIS.,"TAPACHULA, CHIS.",0,0,0,0,0,20,
08-sep-15,N.L.,"GRAL. ESCOBEDO, N.L.",0,0,0,71,0,0,
08-sep-15,SIN.,"ANGOSTURA, SIN.",0,0,0,0,0,0,
09-sep-15,GRO.,"ZIHUATANEJO DE AZUETA, GRO.",0,0,0,0,1,52,
09-sep-15,OAX.,"MIAHUATLAN DE PORFIRIO DIAZ, OAX.",0,0,0,4,0,162,
09-sep-15,N.L.,"SANTA CATARINA, N.L.",0,0,0,13,0,0,
09-sep-15,TAMPS.,"EL MANTE, TAMPS.",0,0,0,0,0,282,
09-sep-15,SIN.,"COSALA, SIN.",0,0,0,0,4,0,
09-sep-15,Q. ROO,"OTHON P. BLANCO, Q. ROO",0,0,0,0,1,419,
09-sep-15,COAH.,"SABINAS, COAH.",0,0,0,0,1,0,
09-sep-15,OAX.,"MIAHUATLAN DE PORFIRIO DIAZ, OAX.",0,0,0,4,0,162,
09-sep-15,PUE.,"SAN JERONIMO TECUANIPAN, PUE.",0,0,0,0,0,46,
10-sep-15,OAX.,"MIAHUATLAN DE PORFIRIO DIAZ, OAX.",0,0,0,1,0,78,
10-sep-15,ZAC.,"JEREZ, ZAC.",0,0,0,2,0,0,
10-sep-15,Q. ROO,"OTHON P. BLANCO, Q. ROO",0,0,0,0,0,811,
11-sep-15,Q. ROO,"OTHON P. BLANCO, Q. ROO",0,0,0,0,0,334,
11-sep-15,SON.,"CAJEME, SON.",0,0,0,0,0,82,
11-sep-15,TAMPS.,"TAMPICO, TAMPS.",0,0,0,0,0,168,
12-sep-15,COAH.,"PIEDRAS NEGRAS, COAH.",0,0,0,3,1,0,
14-sep-15,Q. ROO,"OTHON P. BLANCO, Q. ROO",0,0,0,0,0,364,
14-sep-15,TAB.,"CENTRO, TAB.",0,0,0,0,0,30,
15-sep-15,Q. ROO,"OTHON P. BLANCO, Q. ROO",0,0,0,0,1,199,
15-sep-15,SON.,"CAJEME, SON.",0,0,0,0,0,10,
15-sep-15,N.L.,"MONTERREY, N.L.",0,0,0,0,1,127,
17-sep-15,COAH.,"MÚZQUIZ, COAH.",0,0,0,0,1,0,
17-sep-15,Q. ROO,"OTHON P. BLANCO, Q. ROO",0,0,0,0,0,196,
17-sep-15,OAX.,"MIAHUATLAN DE PORFIRIO DIAZ, OAX.",0,0,0,1,0,18,
18-sep-15,Q. ROO,"OTHON P. BLANCO, Q. ROO",0,0,0,0,0,100,
18-sep-15,TAB.,"CENTRO, TAB.",0,0,0,0,0,25,
18-sep-15,CHIH.,"HGO. DEL PARRAL, CHIH.",0,0,0,0,0,48,
18-sep-15,PUE.,"PUE., PUE.",0,0,0,0,6,38,
18-sep-15,CHIH.,"CHIH., CHIH.",0,0,0,0,0,18,
19-sep-15,CHIS.,"TAPACHULA, CHIS.",0,0,0,0,0,100,
19-sep-15,N.L.,"SAN PEDRO GARZA GARCIA, N.L.",0,0,0,45,0,4750,
19-sep-15,CHIH.,"HGO. DEL PARRAL, CHIH.",0,0,0,0,0,48,
19-sep-15,TAB.,"CENTRO, TAB.",0,0,0,0,1,0,
19-sep-15,Q. ROO,"OTHON P. BLANCO, Q. ROO",0,0,0,0,0,140,
20-sep-15,N.L.,"SAN PEDRO GARZA GARCIA, N.L.",0,0,0,0,0,5850,
21-sep-15,PUE.,"PUE., PUE.",0,0,0,0,0,202,
21-sep-15,OAX.,"MIAHUATLAN DE PORFIRIO DIAZ, OAX.",0,0,0,1,0,15,
21-sep-15,N.L.,"SAN PEDRO GARZA GARCIA, N.L.",0,0,0,16,0,0,
22-sep-15,GRO.,"BENITO JUAREZ, GRO.",0,0,0,0,6,0,
22-sep-15,OAX.,"MIAHUATLAN DE PORFIRIO DIAZ, OAX.",0,0,0,2,0,25,
22-sep-15,CHIS.,"TAPACHULA, CHIS.",0,0,0,0,0,45,
22-sep-15,QRO.,"QUERETARO, QRO.",0,0,0,0,1,0,
23-sep-15,OAX.,"MIAHUATLAN DE PORFIRIO DIAZ, OAX.",0,0,0,0,0,35,
23-sep-15,QRO.,"QUERETARO, QRO.",0,0,0,0,0,0,
25-sep-15,AGS.,"JESÚS MARÍA, AGS.",0,0,0,2,0,8,
25-sep-15,COAH.,"MÚZQUIZ, COAH.",0,0,0,0,1,0,
25-sep-15,TAMPS.,"NUEVO LAREDO, TAMPS.",0,0,0,3,0,28,
25-sep-15,PUE.,"PUE., PUE.",0,0,0,1,2,105,
25-sep-15,TAB.,"HUIMANGUILLO, TAB.",0,0,0,0,1,0,
26-sep-15,TAMPS.,"MATAMOROS, TAMPS.",0,0,0,0,1,0,
26-sep-15,N.L.,"SAN PEDRO GARZA GARCIA, N.L.",0,0,0,40,0,1800,
28-sep-15,N.L.,"SAN PEDRO GARZA GARCIA, N.L.",0,0,0,4,0,350,
28-sep-15,CHIH.,"HGO. DEL PARRAL, CHIH.",0,0,0,0,0,24,
29-sep-15,N.L.,"SAN PEDRO GARZA GARCIA, N.L.",0,0,0,5,0,1100,
29-sep-15,N.L.,"ABASOLO, N.L.",0,0,0,7,0,0,
29-sep-15,PUE.,"PUE., PUE.",0,0,0,0,3,0,
29-sep-15,MEX.,"NICOLAS ROMERO, MEX.",0,0,0,0,9,0,
30-sep-15,PUE.,"PUE., PUE.",0,0,0,0,0,361,
02-oct-15,PUE.,"PUE., PUE.",0,0,0,2,0,480,
03-oct-15,TAB.,"HUIMANGUILLO, TAB.",0,0,0,0,0,50,
05-oct-15,S.L.P.,"SAN LUIS POTOSI, S.L.P.",0,0,0,0,0,16,
06-oct-15,N.L.,"ANAHUAC, N.L.",0,0,0,1,0,100,
07-oct-15,SIN.,"ESCUINAPA, SIN.",0,0,0,0,5,0,
07-oct-15,N.L.,"SAN NICOLAS DE LOS GARZA, N.L.",0,0,0,24,0,0,
08-oct-15,SON.,"CAJEME, SON.",0,0,0,0,0,2,
09-oct-15,TAB.,"CENTRO, TAB.",0,0,0,0,0,175,
09-oct-15,SIN.,"ESCUINAPA, SIN.",0,0,0,0,1,0,
09-oct-15,SIN.,"NAVOLATO, SIN.",0,0,0,0,10,0,
10-oct-15,TAB.,"CENTRO, TAB.",0,0,0,0,0,35,
12-oct-15,N.L.,"SAN NICOLAS DE LOS GARZA, N.L.",0,0,0,10,0,1050,
13-oct-15,SIN.,"ESCUINAPA, SIN.",0,0,0,0,1,0,
13-oct-15,SIN.,"NAVOLATO, SIN.",0,0,0,0,6,0,
13-oct-15,HGO.,"ZEMPOALA, HGO.",0,0,0,0,0,211,
13-oct-15,TAMPS.,"TAMPICO, TAMPS.",0,0,0,4,0,120,
14-oct-15,MEX.,"NEXTLALPAN, MEX., MEX.",0,0,0,0,2,50,
14-oct-15,N.L.,"SAN NICOLAS DE LOS GARZA, N.L.",0,0,0,80,0,0,
15-oct-15,MEX.,"NEXTLALPAN, MEX., MEX.",0,0,0,0,3,0,
16-oct-15,HGO.,"TULANCINGO DE BRAVO, HGO.",0,0,0,0,0,76,
16-oct-15,CHIH.,"AQUILES SERDÁN, CHIH.",0,0,0,4,0,209,
16-oct-15,TAMPS.,"TAMPICO, TAMPS.",0,0,0,0,0,137,
16-oct-15,TAMPS.,"EL MANTE, TAMPS.",0,0,0,0,0,1,
17-oct-15,YUC.,"TINUM, YUC.",0,0,0,0,1,168,
19-oct-15,CHIH.,"AQUILES SERDÁN, CHIH.",0,0,0,5,0,380,
20-oct-15,CHIH.,"CHIH., CHIH.",0,0,0,0,0,599,
20-oct-15,N.L.,"SAN NICOLAS DE LOS GARZA, N.L.",0,0,0,2,0,150,
20-oct-15,Q. ROO,"COZUMEL, Q. ROO",0,0,0,0,0,52,
21-oct-15,SIN.,"CONCORDIA, SIN.",0,0,0,0,13,0,
21-oct-15,SON.,"CAJEME, SON.",0,0,0,0,1,230,
21-oct-15,TAB.,"MACUSPANA, TAB.",0,0,0,2,0,15,
22-oct-15,Q. ROO,"COZUMEL, Q. ROO",0,0,0,0,0,625,
22-oct-15,SIN.,"CONCORDIA, SIN.",0,0,0,0,3,0,
24-oct-15,HGO.,"ZEMPOALA, HGO.",0,0,0,0,2,834,
24-oct-15,TAMPS.,"NUEVO LAREDO, TAMPS.",0,0,0,0,0,49,
27-oct-15,COL.,"COL., COL.",0,0,0,1,1,0,
28-oct-15,AGS.,"JESÚS MARÍA, AGS.",0,0,0,1,0,0,
29-oct-15,VER.,"YANGA, VER.",0,0,0,0,2,0,
29-oct-15,SIN.,"CONCORDIA, SIN.",0,0,0,0,3,0,
29-oct-15,AGS.,"JESÚS MARÍA, AGS.",0,0,0,17,0,0,
29-oct-15,COAH.,"RAMOS ARIZPE, COAH.",0,0,0,0,2,0,
31-oct-15,MEX.,"TEXCALYACAC, MEX.",0,0,0,0,1,0,
02-nov-15,COAH.,"TORREÓN, COAH.",0,0,0,8,0,0,
03-nov-15,MEX.,"TEJUPILCO, MEX.",0,0,0,0,0,0,
03-nov-15,SIN.,"CONCORDIA, SIN.",0,0,0,0,1,0,
04-nov-15,PUE.,"PUE., PUE.",0,0,0,2,0,130,
04-nov-15,HGO.,"PACHUCA DE SOTO, HGO.",0,0,0,0,2,0,
04-nov-15,SON.,"CAJEME, SON.",0,0,0,0,1,4000,
04-nov-15,COAH.,"RAMOS ARIZPE, COAH.",0,0,0,0,2,0,
05-nov-15,N.L.,"GRAL. ESCOBEDO, N.L.",0,0,0,200,0,700,
06-nov-15,COAH.,"RAMOS ARIZPE, COAH.",0,0,0,0,3,0,
08-nov-15,TAB.,"MACUSPANA, TAB.",0,0,0,0,0,181,
13-nov-15,SON.,"HERMOSILLO, SON.",0,0,0,2,0,0,
13-nov-15,SON.,"CAJEME, SON.",0,0,0,0,0,3000,
13-nov-15,VER.,"ALTOTONGA, VER.",0,0,0,0,0,110,
13-nov-15,MEX.,"MALINALCO, MEX.",0,0,0,1,0,0,
13-nov-15,MEX.,"ISIDRO FABELA, MEX.",0,0,0,0,3,0,
14-nov-15,MEX.,"MALINALCO, MEX.",0,0,0,0,5,0,
15-nov-15,N.L.,"GRAL. ESCOBEDO, N.L.",0,0,0,35,0,2900,
15-nov-15,YUC.,"PROGRESO, YUC.",0,0,0,0,0,162,
16-nov-15,N.L.,"GRAL. ESCOBEDO, N.L.",0,0,0,0,0,200,
17-nov-15,TAMPS.,"MATAMOROS, TAMPS.",0,0,0,3,0,0,
18-nov-15,PUE.,"PUE., PUE.",0,0,0,0,0,52,
24-nov-15,YUC.,"VALLADOLID, YUC.",0,0,0,0,0,26,
24-nov-15,MOR.,"CUERNAVACA, MOR.",0,0,0,0,1,0,
25-nov-15,SON.,"EMPALME, SON.",0,0,0,0,1,0,
25-nov-15,SON.,"BENITO JUAREZ, SON.",0,0,0,2,0,0,
25-nov-15,SON.,"SAN LUIS RIO COLORADO, SON.",0,0,0,0,3,240,
27-nov-15,SON.,"GUAYMAS, SON.",0,0,0,0,0,100,
27-nov-15,SON.,"HUATABAMPO, SON.",0,0,0,3,0,0,
27-nov-15,MOR.,"CUERNAVACA, MOR.",0,0,0,0,1,173,
29-nov-15,SON.,"EMPALME, SON.",0,0,0,1,0,0,
01-dic-15,SON.,"SAHUARIPA, SON.",0,0,0,0,0,107,
01-dic-15,GRO.,"IXCATEOPAN DE CUAUHTEMOC, GRO.",0,0,0,0,1,0,
01-dic-15,SON.,"AGUA PRIETA, SON.",0,0,0,0,1,0,
01-dic-15,SON.,"GENERAL PLUTARCO ELIAS CALLES, SON.",0,0,0,0,0,28,
02-dic-15,SON.,"SAN LUIS RIO COLORADO, SON.",0,0,0,6,0,116,
02-dic-15,SON.,"AGUA PRIETA, SON.",0,0,0,2,0,0,
02-dic-15,SON.,"CABORCA, SON.",0,0,0,0,0,1,
02-dic-15,GRO.,"ATOYAC DE ALVAREZ, GRO.",0,0,0,0,2,0,
02-dic-15,TAB.,"PARAISO, TAB.",0,0,0,2,0,47,
03-dic-15,N.L.,"MONTERREY, N.L.",0,0,0,0,1,0,
03-dic-15,SON.,"CABORCA, SON.",0,0,0,3,0,60,
04-dic-15,N.L.,"MONTERREY, N.L.",0,0,0,0,0,3300,
04-dic-15,SON.,"GUAYMAS, SON.",0,0,0,0,1,0,
04-dic-15,HGO.,"TEPETITLAN, HGO.",0,0,0,0,0,200,
04-dic-15,PUE.,"ATLIXCO, PUE.",0,0,0,0,0,31,
05-dic-15,COAH.,"MONCLOVA, COAH.",0,0,0,1,0,121,
07-dic-15,SON.,"MAGDALENA, SON.",0,0,0,0,0,45,
07-dic-15,Q. ROO,"COZUMEL, Q. ROO",0,0,0,0,0,20,
07-dic-15,SON.,"SAN MIGUEL DE HORCASITAS, SON.",0,0,0,19,0,0,
07-dic-15,SON.,"GUAYMAS, SON.",0,0,0,0,1,0,
08-dic-15,SON.,"CARBO, SON.",0,0,0,10,0,0,
08-dic-15,Q. ROO,"COZUMEL, Q. ROO",0,0,0,0,0,161,
08-dic-15,SON.,"NOGALES, SON.",0,0,0,0,44,0,
08-dic-15,SON.,"CABORCA, SON.",0,0,0,1,0,0,
09-dic-15,YUC.,"TELCHAC PUEBLO, YUC.",0,0,0,1,0,403,
09-dic-15,SON.,"SAN MIGUEL DE HORCASITAS, SON.",0,0,0,5,0,0,
09-dic-15,N.L.,"SAN NICOLAS DE LOS GARZA, N.L.",0,0,0,220,0,0,
09-dic-15,TAMPS.,"NUEVO LAREDO, TAMPS.",0,0,0,0,0,42,
09-dic-15,SON.,"NOGALES, SON.",0,0,0,0,0,55,
10-dic-15,Q. ROO,"COZUMEL, Q. ROO",0,0,0,0,0,130,
10-dic-15,PUE.,"ATLIXCO, PUE.",0,0,0,0,0,67,
10-dic-15,DGO.,"DGO., DGO.",0,0,0,3,0,0,
10-dic-15,SON.,"CARBO, SON.",0,0,0,10,0,0,
11-dic-15,SON.,"PUERTO PEÑASCO, SON.",0,0,0,0,0,181,
12-dic-15,SON.,"MAGDALENA, SON.",0,0,0,0,0,46,
12-dic-15,TAMPS.,"TAMPICO, TAMPS.",0,0,0,7,0,307,
13-dic-15,N.L.,"SAN NICOLAS DE LOS GARZA, N.L.",0,0,0,260,0,78,
16-dic-15,YUC.,"CELESTUN, YUC.",0,0,0,0,0,198,
16-dic-15,TAB.,"CARDENAS, TAB.",0,0,0,0,1,0,
16-dic-15,N.L.,"GRAL. ESCOBEDO, N.L.",0,0,0,250,0,100,
18-dic-15,N.L.,"SAN NICOLAS DE LOS GARZA, N.L.",0,0,0,350,0,1050,
19-dic-15,CHIS.,"COMITAN DE DOMÍNGUEZ, CHIS.",0,0,0,0,0,122,
21-dic-15,CHIS.,"JUÁREZ, CHIS.",0,0,0,2,0,34,
07-ene-16,YUC.,"DZILAM DE BRAVO, YUC.",0,0,0,0,0,33,
12-ene-16,DGO.,"DGO., DGO.",0,0,0,0,2,0,
14-ene-16,YUC.,"MAXCANU, YUC.",0,0,0,2,0,625,
15-ene-16,CHIS.,"REFORMA, CHIS.",0,0,0,0,0,47,
16-ene-16,COAH.,"SAN PEDRO, COAH.",0,0,0,9,0,498,
21-ene-16,YUC.,"SANAHCAT, YUC.",0,0,0,0,0,432,
22-ene-16,YUC.,"SANAHCAT, YUC.",0,0,0,0,0,491,
22-ene-16,CHIS.,"REFORMA, CHIS.",0,0,0,1,0,30,
25-ene-16,OAX.,"MIAHUATLAN DE PORFIRIO DIAZ, OAX.",0,0,0,31,0,0,
25-ene-16,COAH.,"MONCLOVA, COAH.",0,0,0,1,1,10,
25-ene-16,CHIH.,"NUEVO CASAS GRANDES, CHIH.",0,0,0,0,0,179,
27-ene-16,OAX.,"OAX. DE JUAREZ, OAX.",0,0,0,1,0,173,
27-ene-16,CHIH.,"NUEVO CASAS GRANDES, CHIH.",0,0,0,4,0,162,
27-ene-16,PUE.,"PUE., PUE.",0,0,0,0,0,94,
28-ene-16,COAH.,"TORREÓN, COAH.",0,0,0,1,0,0,
28-ene-16,PUE.,"PUE., PUE.",0,0,0,0,0,28,
29-ene-16,OAX.,"SAN JUAN BAUTISTA TUXTEPEC, OAX.",0,0,0,2,0,12,
29-ene-16,PUE.,"PUE., PUE.",0,0,0,0,0,60,
31-ene-16,OAX.,"OAX. DE JUAREZ, OAX.",0,0,0,0,0,32,
03-feb-16,COAH.,"TORREÓN, COAH.",0,0,0,1,0,0,
03-feb-16,COAH.,"MÚZQUIZ, COAH.",0,0,0,3,0,0,
03-feb-16,OAX.,"OAX. DE JUAREZ, OAX.",0,0,0,0,0,100,
04-feb-16,YUC.,"CHANKOM, YUC.",0,0,0,0,0,200,
04-feb-16,TAB.,"TACOTALPA, TAB.",0,0,0,1,0,36,
05-feb-16,YUC.,"TEKAL DE VENEGAS, YUC.",0,0,0,0,0,301,
06-feb-16,GRO.,"ARCELIA, GRO.",0,0,0,0,1,0,
08-feb-16,COAH.,"MÚZQUIZ, COAH.",0,0,0,2,0,0,
09-feb-16,OAX.,"SAN JUAN BAUTISTA TUXTEPEC, OAX.",0,0,0,0,0,8,
12-feb-16,YUC.,"TEKAX, YUC.",0,0,0,0,0,125,
15-feb-16,COAH.,"MONCLOVA, COAH.",0,0,0,1,0,0,
17-feb-16,YUC.,"TECOH, YUC.",0,0,0,0,0,100,
17-feb-16,TAMPS.,"SAN FERNANDO, TAMPS.",0,0,0,0,0,103,
17-feb-16,TAB.,"TENOSIQUE, TAB.",0,0,0,0,3,0,
17-feb-16,YUC.,"TECOH, YUC.",0,0,0,0,0,551,
17-feb-16,COAH.,"ACUÑA, COAH.",0,0,0,0,1,0,
17-feb-16,COAH.,"RAMOS ARIZPE, COAH.",0,0,0,0,1,0,
25-feb-16,HGO.,"TULANCINGO DE BRAVO, HGO.",0,0,0,0,0,55,
26-feb-16,TAB.,"TENOSIQUE, TAB.",0,0,0,1,0,28,
26-feb-16,YUC.,"TICUL, YUC.",0,0,0,2,0,15,
09-mar-16,TAB.,"TENOSIQUE, TAB.",0,0,0,0,0,5,
09-mar-16,TAB.,"EMILIANO ZAPATA, TAB.",0,0,0,0,0,5,
11-mar-16,YUC.,"AKIL, YUC.",0,0,0,2,0,58,
12-mar-16,COAH.,"MATAMOROS, COAH.",0,0,0,1,0,0,
13-mar-16,TAMPS.,"NUEVO LAREDO, TAMPS.",0,0,0,6,0,70,
14-mar-16,TAB.,"TENOSIQUE, TAB.",0,0,0,3,1,0,
14-mar-16,TAB.,"CUNDUACAN, TAB.",0,0,0,0,0,100,
14-mar-16,HGO.,"NOPALA DE VILLAGRAN, HGO.",0,0,0,0,0,1000,
14-mar-16,COAH.,"SALTILLO, COAH.",0,0,0,4,0,110,
15-mar-16,HGO.,"PACHUCA DE SOTO, HGO.",0,0,0,0,0,1200,
17-mar-16,YUC.,"TEKIT, YUC.",0,0,0,11,0,0,
17-mar-16,COAH.,"TORREÓN, COAH.",0,0,0,0,0,643,
18-mar-16,YUC.,"TEKIT, YUC.",0,0,0,1,0,6,
19-mar-16,YUC.,"TEKIT, YUC.",0,0,0,1,0,10,
19-mar-16,DGO.,"DGO., DGO.",0,0,0,0,4,0,
22-mar-16,HGO.,"TIZAYUCA, HGO.",0,0,0,0,0,38,
31-mar-16,OAX.,"MIAHUATLAN DE PORFIRIO DIAZ, OAX.",0,0,0,11,0,0,
19-abr-16,TAB.,"NACAJUCA, TAB.",0,0,0,0,0,10,
19-abr-16,COAH.,"SALTILLO, COAH.",0,0,0,7,1,43,
20-abr-16,TAB.,"TENOSIQUE, TAB.",0,0,0,0,0,60,
21-abr-16,COAH.,"SALTILLO, COAH.",0,0,0,0,0,22,
21-abr-16,COAH.,"RAMOS ARIZPE, COAH.",0,0,0,1,0,0,
22-abr-16,COAH.,"SALTILLO, COAH.",0,0,0,0,0,22,
22-abr-16,COAH.,"RAMOS ARIZPE, COAH.",0,0,0,1,1,0,
22-abr-16,TAB.,"NACAJUCA, TAB.",0,0,0,2,0,21,
25-abr-16,TAB.,"NACAJUCA, TAB.",0,0,0,1,0,50,
29-abr-16,TAB.,"NACAJUCA, TAB.",0,0,0,3,0,23,
05-may-16,COAH.,"ACUÑA, COAH.",0,0,0,0,1,0,
05-may-16,DGO.,"DGO., DGO.",0,0,0,0,1,0,
09-may-16,GRO.,"TELOLOAPAN, GRO.",0,0,0,0,0,354,
11-may-16,DGO.,"DGO., DGO.",0,0,0,0,2,0,
11-may-16,DGO.,"DGO., DGO.",0,0,0,0,0,5,
12-may-16,YUC.,"UMAN, YUC.",0,0,0,2,0,55,
13-may-16,YUC.,"UMAN, YUC.",0,0,0,0,0,150,
13-may-16,TAB.,"TENOSIQUE, TAB.",0,0,0,0,0,100,
13-may-16,YUC.,"UMAN, YUC.",0,0,0,0,0,150,
15-may-16,GTO.,"ROMITA, GTO.",0,0,0,0,0,5,
18-may-16,COAH.,"RAMOS ARIZPE, COAH.",0,0,0,0,0,200,
18-may-16,N.L.,"MONTERREY, N.L.",0,0,0,4,0,92,
20-may-16,N.L.,"GUADALUPE, N.L.",0,0,0,0,0,100,
21-may-16,N.L.,"MONTERREY, N.L.",0,0,0,0,0,500,
21-may-16,N.L.,"GUADALUPE, N.L.",0,0,0,0,0,500,
26-may-16,YUC.,"TEMAX, YUC.",0,0,0,3,0,0,
26-may-16,DGO.,"DGO., DGO.",0,0,0,0,5,0,
26-may-16,COAH.,"RAMOS ARIZPE, COAH.",0,0,0,2,0,0,
30-may-16,COAH.,"RAMOS ARIZPE, COAH.",0,0,0,0,1,0,
01-jun-16,COAH.,"MONCLOVA, COAH.",0,0,0,0,0,34,
02-jun-16,N.L.,"MONTERREY, N.L.",0,0,0,0,0,105,
04-jun-16,COAH.,"SALTILLO, COAH.",0,0,0,1,0,0,
04-jun-16,COAH.,"RAMOS ARIZPE, COAH.",0,0,0,0,1,0,
04-jun-16,CHIS.,"MAZATÁN, CHIS.",0,0,0,0,0,605,
06-jun-16,COAH.,"RAMOS ARIZPE, COAH.",0,0,0,25,0,0,
06-jun-16,COAH.,"SALTILLO, COAH.",0,0,0,2,0,45,
06-jun-16,COAH.,"RAMOS ARIZPE, COAH.",0,0,0,0,1,0,
06-jun-16,N.L.,"APODACA, N.L.",0,0,0,0,0,150,
09-jun-16,N.L.,"CADEREYTA JIMENEZ, N.L.",0,0,0,0,0,50,
10-jun-16,COAH.,"MONCLOVA, COAH.",0,0,0,0,0,65,
14-jun-16,COAH.,"FRANCISCO I. MADERO, COAH.",0,0,0,2,0,0,
16-jun-16,COAH.,"SALTILLO, COAH.",0,0,0,3,0,35,
16-jun-16,N.L.,"SAN PEDRO GARZA GARCIA, N.L.",0,0,0,0,0,200,
16-jun-16,N.L.,"SANTA CATARINA, N.L.",0,0,0,0,0,100,
17-jun-16,N.L.,"SANTA CATARINA, N.L.",0,0,0,0,1,0,
19-jun-16,N.L.,"SAN PEDRO GARZA GARCIA, N.L.",0,0,0,0,0,3510,
20-jun-16,COAH.,"SALTILLO, COAH.",0,0,0,0,1,0,
20-jun-16,COAH.,"ACUÑA, COAH.",0,0,0,1,0,17,
20-jun-16,N.L.,"SAN PEDRO GARZA GARCIA, N.L.",0,0,0,1,0,0,
21-jun-16,COAH.,"MÚZQUIZ, COAH.",0,0,0,17,0,0,
22-jun-16,VER.,"POZA RICA DE HGO., VER.",0,0,0,0,0,156,
24-jun-16,VER.,"POZA RICA DE HGO., VER.",0,0,0,0,0,120,
24-jun-16,N.L.,"SAN PEDRO GARZA GARCIA, N.L.",0,0,0,0,0,396,
26-jun-16,N.L.,"SABINAS HGO., N.L.",0,0,0,0,0,1000,
27-jun-16,COAH.,"SALTILLO, COAH.",0,0,0,1,0,8,
30-jun-16,COAH.,"MONCLOVA, COAH.",0,0,0,0,0,17,
02-jul-16,COAH.,"CUATROCIÉNEGAS, COAH.",0,0,0,0,0,36,
04-jul-16,COAH.,"ACUÑA, COAH.",0,0,0,1,0,23,
05-jul-16,COAH.,"MONCLOVA, COAH.",0,0,0,1,0,0,
07-jul-16,N.L.,"SALINAS VICTORIA, N.L.",0,0,0,0,0,31,
08-jul-16,N.L.,"VALLECILLO, N.L.",0,0,0,0,0,250,
09-jul-16,N.L.,"SALINAS VICTORIA, N.L.",0,0,0,0,0,610,
12-jul-16,SIN.,"COSALA, SIN.",0,0,0,0,1,0,
15-jul-16,N.L.,"SALINAS VICTORIA, N.L.",0,0,0,0,1,0,
18-jul-16,COAH.,"SALTILLO, COAH.",0,0,0,0,0,51,
19-jul-16,COAH.,"SALTILLO, COAH.",0,0,0,15,1,9,
19-jul-16,COAH.,"SABINAS, COAH.",0,0,0,1,0,0,
21-jul-16,N.L.,"GUADALUPE, N.L.",0,0,0,0,0,101,
21-jul-16,COAH.,"SALTILLO, COAH.",0,0,0,0,0,22,
26-jul-16,COAH.,"MONCLOVA, COAH.",0,0,0,0,0,129,
27-jul-16,N.L.,"MONTERREY, N.L.",0,0,0,0,0,80,
27-jul-16,COAH.,"TORREÓN, COAH.",0,0,0,0,0,54,
29-jul-16,ZAC.,"GUADALUPE, ZAC.",0,0,0,0,0,1002,
01-ago-16,COAH.,"FRANCISCO I. MADERO, COAH.",0,0,0,1,0,0,
01-ago-16,COAH.,"RAMOS ARIZPE, COAH.",0,0,0,4,0,213,
01-ago-16,N.L.,"GRAL. ESCOBEDO, N.L.",0,0,0,0,0,44,
05-ago-16,D.F.,"TLALPAN, D.F.",0,0,0,0,16,0,
05-ago-16,Q. ROO,"BENITO JUAREZ, Q. ROO",0,0,0,0,0,70,
06-ago-16,COAH.,"ARTEAGA, COAH.",0,0,0,2,0,100,
08-ago-16,Q. ROO,"BENITO JUAREZ, Q. ROO",0,0,0,0,0,160,
09-ago-16,Q. ROO,"BENITO JUAREZ, Q. ROO",0,0,0,0,0,204,
10-ago-16,Q. ROO,"BENITO JUAREZ, Q. ROO",0,0,0,0,0,200,
11-ago-16,Q. ROO,"BENITO JUAREZ, Q. ROO",0,0,0,0,0,489,
12-ago-16,Q. ROO,"BENITO JUAREZ, Q. ROO",0,0,0,0,0,1001,
14-ago-16,MEX.,"ACOLMAN, MEX.",0,0,0,0,0,48,
15-ago-16,Q. ROO,"COZUMEL, Q. ROO",0,0,0,0,0,236,
15-ago-16,Q. ROO,"BENITO JUAREZ, Q. ROO",0,0,0,0,0,729,
16-ago-16,Q. ROO,"COZUMEL, Q. ROO",0,0,0,0,0,384,
16-ago-16,Q. ROO,"BENITO JUAREZ, Q. ROO",0,0,0,0,0,411,
16-ago-16,Q. ROO,"ISLA MUJERES, Q. ROO",0,0,0,0,0,140,
17-ago-16,Q. ROO,"COZUMEL, Q. ROO",0,0,0,0,0,410,
17-ago-16,Q. ROO,"BENITO JUAREZ, Q. ROO",0,0,0,0,0,1143,
18-ago-16,SON.,"GUAYMAS, SON.",0,0,0,0,0,172,
18-ago-16,Q. ROO,"COZUMEL, Q. ROO",0,0,0,0,0,147,
19-ago-16,Q. ROO,"COZUMEL, Q. ROO",0,0,0,0,0,597,
20-ago-16,SON.,"HERMOSILLO, SON.",0,0,0,25,0,0,
24-ago-16,COAH.,"TORREÓN, COAH.",0,0,0,0,0,2,
27-ago-16,B.C.,"ENSENADA, B.C.",0,0,0,0,1,0,
27-ago-16,SON.,"HERMOSILLO, SON.",0,0,0,30,0,0,
29-ago-16,COAH.,"PIEDRAS NEGRAS, COAH.",0,0,0,35,0,0,
30-ago-16,MEX.,"CHICONCUAC, MEX.",0,0,0,0,6,0,
30-ago-16,N.L.,"SAN NICOLAS DE LOS GARZA, N.L.",0,0,0,0,7,0,
01-sep-16,SON.,"HERMOSILLO, SON.",0,0,0,7,0,720,
02-sep-16,COAH.,"SALTILLO, COAH.",0,0,0,1,0,20,
02-sep-16,COAH.,"MONCLOVA, COAH.",0,0,0,0,0,105,
09-sep-16,N.L.,"SAN PEDRO GARZA GARCIA, N.L.",0,0,0,16,0,0,
12-sep-16,CHIS.,"BENEMÉRITO DE LAS AMÉRICAS, CHIS.",0,0,0,2,0,30,
15-sep-16,CHIH.,"HGO. DEL PARRAL, CHIH.",0,0,0,0,0,90,
15-sep-16,PUE.,"PUE., PUE.",0,0,0,1,0,4,
20-sep-16,SON.,"HERMOSILLO, SON.",0,0,0,29,0,0,
23-sep-16,N.L.,"SABINAS HGO., N.L.",0,0,0,24,0,0,
24-sep-16,SON.,"HERMOSILLO, SON.",0,0,0,0,0,873,
26-sep-16,SON.,"HERMOSILLO, SON.",0,0,0,8,0,0,
27-sep-16,SON.,"CAJEME, SON.",0,0,0,2,0,0,
28-sep-16,SON.,"HERMOSILLO, SON.",0,0,0,4,0,300,
01-oct-16,SON.,"HERMOSILLO, SON.",0,0,0,15,0,0,
01-oct-16,MOR.,"XOCHITEPEC, MOR.",0,0,0,0,0,394,
02-oct-16,MOR.,"XOCHITEPEC, MOR.",0,0,0,74,0,0,
04-oct-16,SIN.,"ROSARIO, SIN.",0,0,0,0,7,0,
04-oct-16,MOR.,"XOCHITEPEC, MOR.",0,0,0,15,9,226,
06-oct-16,SIN.,"ROSARIO, SIN.",0,0,0,0,4,0,
06-oct-16,OAX.,"OAX. DE JUAREZ, OAX.",0,0,0,4,0,73,
06-oct-16,HGO.,"TULANCINGO DE BRAVO, HGO.",0,0,0,0,0,198,
08-oct-16,SON.,"HERMOSILLO, SON.",0,0,0,45,0,0,
10-oct-16,COAH.,"SALTILLO, COAH.",0,0,0,0,0,398,
11-oct-16,HGO.,"TEPEJI DEL RIO DE OCAMPO, HGO.",0,0,0,0,2,270,
12-oct-16,PUE.,"PUE., PUE.",0,0,0,1,0,50,
13-oct-16,SON.,"HERMOSILLO, SON.",0,0,0,1,0,370,
14-oct-16,N.L.,"GUADALUPE, N.L.",0,0,0,0,0,150,
15-oct-16,HGO.,"TEPEJI DEL RIO DE OCAMPO, HGO.",0,0,0,1,0,248,
17-oct-16,CHIS.,"PALENQUE, CHIS.",0,0,0,0,2,0,
17-oct-16,MOR.,"XOCHITEPEC, MOR.",0,0,0,30,0,272,
17-oct-16,SON.,"HERMOSILLO, SON.",0,0,0,0,0,637,
18-oct-16,MEX.,"AYAPANGO, MEX.",0,0,0,0,2,0,
19-oct-16,TAB.,"PARAISO, TAB.",0,0,0,0,2,0,
20-oct-16,COAH.,"TORREÓN, COAH.",0,0,0,1,0,0,
21-oct-16,COAH.,"TORREÓN, COAH.",0,0,0,0,1,0,
21-oct-16,PUE.,"PUE., PUE.",0,0,0,0,0,136,
24-oct-16,PUE.,"PUE., PUE.",0,0,0,1,0,53,
24-oct-16,SON.,"HERMOSILLO, SON.",0,0,0,0,0,576,
25-oct-16,SON.,"HERMOSILLO, SON.",0,0,0,11,0,0,
26-oct-16,COAH.,"SALTILLO, COAH.",0,0,0,0,0,200,
28-oct-16,COAH.,"SALTILLO, COAH.",0,0,0,0,2,500,
31-oct-16,VER.,"CORDOBA, VER.",0,0,0,0,0,34,
02-nov-16,MOR.,"XOCHITEPEC, MOR.",0,0,0,0,1,0,
02-nov-16,COAH.,"RAMOS ARIZPE, COAH.",0,0,0,3,0,0,
03-nov-16,GRO.,"CHILPANCINGO DE LOS BRAVO, GRO.",0,0,0,0,1,0,
03-nov-16,N.L.,"GARCIA, N.L.",0,0,0,37,0,2971,
03-nov-16,COAH.,"SALTILLO, COAH.",0,0,0,0,0,748,
04-nov-16,VER.,"CORDOBA, VER.",0,0,0,0,0,50,
04-nov-16,COAH.,"RAMOS ARIZPE, COAH.",0,0,0,0,0,32,
07-nov-16,MEX.,"TEMAMATLA, MEX.",0,0,0,0,0,0,
08-nov-16,COAH.,"SALTILLO, COAH.",0,0,0,0,0,200,
08-nov-16,COAH.,"RAMOS ARIZPE, COAH.",0,0,0,0,0,19,
09-nov-16,COAH.,"RAMOS ARIZPE, COAH.",0,0,0,0,0,32,
09-nov-16,SON.,"NOGALES, SON.",0,0,0,0,0,50,
10-nov-16,SON.,"BENITO JUAREZ, SON.",0,0,0,0,0,600,
14-nov-16,SON.,"ALAMOS, SON.",0,0,0,1,0,0,
14-nov-16,SON.,"NOGALES, SON.",0,0,0,4,0,51,
14-nov-16,MOR.,"YAUTEPEC, MOR.",0,0,0,0,42,0,
15-nov-16,SON.,"AGUA PRIETA, SON.",0,0,0,0,0,34,
16-nov-16,SON.,"AGUA PRIETA, SON.",0,0,0,1,0,0,
16-nov-16,SON.,"NAVOJOA, SON.",0,0,0,1,0,0,
16-nov-16,MEX.,"JALTENCO, MEX.",0,0,0,0,7,0,
18-nov-16,SON.,"NAVOJOA, SON.",0,0,0,0,0,40,
19-nov-16,MOR.,"YAUTEPEC, MOR.",0,0,0,0,0,0,
20-nov-16,B.C.,"TIJUANA, B.C.",0,0,0,0,1,0,
21-nov-16,SON.,"HERMOSILLO, SON.",0,0,0,0,0,100,
21-nov-16,SON.,"ETCHOJOA, SON.",0,0,0,1,0,120,
23-nov-16,CHIS.,"PALENQUE, CHIS.",0,0,0,0,0,250,
23-nov-16,SON.,"MAGDALENA, SON.",0,0,0,0,0,36,
24-nov-16,COAH.,"SALTILLO, COAH.",0,0,0,0,0,248,
25-nov-16,SON.,"NOGALES, SON.",0,0,0,0,0,0,
25-nov-16,SON.,"AGUA PRIETA, SON.",0,0,0,0,0,50,
25-nov-16,SON.,"PUERTO PEÑASCO, SON.",0,0,0,0,0,25,
25-nov-16,COAH.,"SALTILLO, COAH.",0,0,0,4,0,223,
26-nov-16,SON.,"HERMOSILLO, SON.",0,0,0,23,0,55,
27-nov-16,B.C.,"TIJUANA, B.C.",0,0,0,0,1,0,
29-nov-16,SON.,"ETCHOJOA, SON.",0,0,0,4,0,0,
29-nov-16,SON.,"CANANEA, SON.",0,0,0,5,0,543,
01-dic-16,MOR.,"YAUTEPEC, MOR.",0,0,0,0,12,0,
01-dic-16,MICH.,"LA PIEDAD, MICH.",0,0,0,0,0,525,
02-dic-16,MICH.,"LA PIEDAD, MICH.",0,0,0,0,0,500,
03-dic-16,MICH.,"LA PIEDAD, MICH.",0,0,0,0,0,1000,
05-dic-16,D.F.,"AZCAPOTZALCO, D.F.",0,0,0,0,5,50,
07-dic-16,COL.,"COL., COL.",0,0,0,6,0,335,
08-dic-16,N.L.,"SAN PEDRO GARZA GARCIA, N.L.",0,0,0,10,0,1000,
09-dic-16,D.F.,"VENUSTIANO CARRANZA, D.F.",0,0,0,0,1,0,
12-dic-16,N.L.,"APODACA, N.L.",0,0,0,0,0,100,
13-dic-16,N.L.,"APODACA, N.L.",0,0,0,0,0,225,
16-dic-16,HGO.,"PACULA, HGO.",0,0,0,0,0,1308,
17-dic-16,HGO.,"IXMIQUILPAN, HGO.",0,0,0,0,0,300,
20-dic-16,CHIH.,"HGO. DEL PARRAL, CHIH.",0,0,0,1,0,0,
10-ene-17,B.C.,"ENSENADA, B.C.",0,0,0,0,1,0,
17-ene-17,D.F.,"CUAUHTEMOC, D.F.",0,0,0,0,0,1002,
23-ene-17,D.F.,"COYOACAN, D.F.",0,0,0,0,1,0,
24-ene-17,COAH.,"MÚZQUIZ, COAH.",0,0,0,0,0,25,
24-ene-17,COAH.,"MÚZQUIZ, COAH.",0,0,0,0,0,25,
24-ene-17,MICH.,"ZAMORA, MICH.",0,0,0,0,0,2000,
29-ene-17,TAMPS.,"NUEVO LAREDO, TAMPS.",0,0,0,0,0,9,
30-ene-17,B.C.,"TIJUANA, B.C.",0,0,0,0,1,0,
30-ene-17,B.C.,"ENSENADA, B.C.",0,0,0,0,1,0,
05-feb-17,TAMPS.,"ALTAMIRA, TAMPS.",0,0,0,0,0,9,
07-feb-17,COAH.,"SALTILLO, COAH.",0,0,0,0,0,46,
08-feb-17,PUE.,"PUE., PUE.",0,0,0,0,0,8,
09-feb-17,COAH.,"SALTILLO, COAH.",0,0,0,7,0,71,
09-feb-17,COAH.,"RAMOS ARIZPE, COAH.",0,0,0,3,4,200,
10-feb-17,GRO.,"ATOYAC DE ALVAREZ, GRO.",0,0,0,0,2,0,
14-feb-17,TAMPS.,"TAMPICO, TAMPS.",0,0,0,0,0,23,
14-feb-17,SIN.,"MAZATLAN, SIN.",0,0,0,0,4,0,
15-feb-17,CHIH.,"NUEVO CASAS GRANDES, CHIH.",0,0,0,0,0,63,
15-feb-17,SIN.,"CULIACAN, SIN.",0,0,0,0,4,0,
15-feb-17,SIN.,"MAZATLAN, SIN.",0,0,0,0,2,0,
16-feb-17,TAMPS.,"NUEVO LAREDO, TAMPS.",0,0,0,1,0,440,
17-feb-17,CHIH.,"NAMIQUIPA, CHIH.",0,0,0,0,0,25,
17-feb-17,TAMPS.,"NUEVO LAREDO, TAMPS.",0,0,0,9,0,398,
17-feb-17,SIN.,"CULIACAN, SIN.",0,0,0,0,14,0,
18-feb-17,MICH.,"LAZARO CARDENAS, MICH.",0,0,0,0,0,79,
20-feb-17,Q. ROO,"COZUMEL, Q. ROO",0,0,0,0,0,118,
21-feb-17,Q. ROO,"COZUMEL, Q. ROO",0,0,0,0,0,2,
21-feb-17,TAMPS.,"TAMPICO, TAMPS.",0,0,0,1,0,296,
22-feb-17,Q. ROO,"COZUMEL, Q. ROO",0,0,0,0,0,72,
23-feb-17,COAH.,"TORREÓN, COAH.",0,0,0,9,0,0,
23-feb-17,VER.,"POZA RICA DE HGO., VER.",0,0,0,0,0,46,
23-feb-17,GRO.,"ACAPULCO DE JUAREZ, GRO.",0,0,0,0,5,0,
23-feb-17,Q. ROO,"COZUMEL, Q. ROO",0,0,0,0,0,7,
23-feb-17,Q. ROO,"COZUMEL, Q. ROO",0,0,0,0,0,148,
24-feb-17,COAH.,"TORREÓN, COAH.",0,0,0,9,0,0,
28-feb-17,CHIH.,"NUEVO CASAS GRANDES, CHIH.",0,0,0,0,0,33,
28-feb-17,OAX.,"MIAHUATLAN DE PORFIRIO DIAZ, OAX.",0,0,0,12,0,13,
02-mar-17,VER.,"COSOLEACAQUE, VER.",0,0,0,0,0,6,
02-mar-17,CHIH.,"NUEVO CASAS GRANDES, CHIH.",0,0,0,0,0,28,
02-mar-17,CHIH.,"NUEVO CASAS GRANDES, CHIH.",0,0,0,0,0,28,
03-mar-17,TAMPS.,"ALTAMIRA, TAMPS.",0,0,0,2,0,66,
03-mar-17,VER.,"FORTIN, VER.",0,0,0,0,0,12,
06-mar-17,OAX.,"MIAHUATLAN DE PORFIRIO DIAZ, OAX.",0,0,0,0,0,80,
07-mar-17,CHIH.,"NUEVO CASAS GRANDES, CHIH.",0,0,0,0,0,245,
07-mar-17,MEX.,"TOLUCA, MEX.",0,0,0,0,0,132,
07-mar-17,COAH.,"MATAMOROS, COAH.",0,0,0,5,0,52,
07-mar-17,TAMPS.,"NUEVO LAREDO, TAMPS.",0,0,0,0,0,120,
07-mar-17,TAMPS.,"TAMPICO, TAMPS.",0,0,0,0,0,44,
08-mar-17,COAH.,"MATAMOROS, COAH.",0,0,0,5,0,52,
09-mar-17,CHIH.,"NUEVO CASAS GRANDES, CHIH.",0,0,0,0,0,490,
09-mar-17,MICH.,"ZITACUARO, MICH.",0,0,0,0,0,2542,
10-mar-17,HGO.,"ZIMAPAN, HGO.",0,0,0,0,0,210,
10-mar-17,OAX.,"PINOTEPA DE DON LUIS, OAX.",0,0,0,4,0,17,
10-mar-17,COAH.,"ACUÑA, COAH.",0,0,0,4,0,62,
11-mar-17,VER.,"COSOLEACAQUE, VER.",0,0,0,0,0,349,
11-mar-17,OAX.,"PINOTEPA DE DON LUIS, OAX.",0,0,0,2,0,0,
11-mar-17,COAH.,"SAN PEDRO, COAH.",0,0,0,1,0,3491,
12-mar-17,N.L.,"MONTERREY, N.L.",0,0,0,0,0,360,
13-mar-17,HGO.,"ZIMAPAN, HGO.",0,0,0,0,0,600,
13-mar-17,TAMPS.,"SAN FERNANDO, TAMPS.",0,0,0,2,0,20,
13-mar-17,D.F.,"IZTACALCO, D.F.",0,0,0,0,1,0,
14-mar-17,D.F.,"IZTAPALAPA, D.F.",0,0,0,0,3,0,
14-mar-17,VER.,"CORDOBA, VER.",0,0,0,0,0,41,
14-mar-17,N.L.,"MONTERREY, N.L.",0,0,0,0,0,38,
14-mar-17,N.L.,"SALINAS VICTORIA, N.L.",0,0,0,1,0,67,
14-mar-17,MEX.,"IXTLAHUACA, MEX.",0,0,0,0,2,1407,
14-mar-17,MEX.,"TEMOAYA, MEX.",0,0,0,0,0,90,
14-mar-17,MEX.,"VALLE DE CHALCO SOLIDARIDAD, MEX.",0,0,0,0,0,83,
15-mar-17,MEX.,"ECATEPEC DE MOR., MEX.",0,0,0,0,0,161,
16-mar-17,TAMPS.,"NUEVO LAREDO, TAMPS.",0,0,0,0,0,12,
16-mar-17,OAX.,"MIAHUATLAN DE PORFIRIO DIAZ, OAX.",0,0,0,6,0,420,
16-mar-17,CHIH.,"GUADALUPE, CHIH.",0,0,0,2,0,0,
16-mar-17,COAH.,"SALTILLO, COAH.",0,0,0,1,0,16,
17-mar-17,HGO.,"ZIMAPAN, HGO.",0,0,0,0,0,406,
17-mar-17,TAMPS.,"SAN FERNANDO, TAMPS.",0,0,0,0,0,65,
17-mar-17,MEX.,"TEMOAYA, MEX.",0,0,0,0,0,6,
17-mar-17,N.L.,"MONTERREY, N.L.",0,0,0,2,0,0,
18-mar-17,TAMPS.,"SAN FERNANDO, TAMPS.",0,0,0,0,0,14,
20-mar-17,COAH.,"TORREÓN, COAH.",0,0,0,3,0,0,
20-mar-17,COAH.,"SAN PEDRO, COAH.",0,0,0,3,0,0,
21-mar-17,TAMPS.,"TAMPICO, TAMPS.",0,0,0,0,0,53,
22-mar-17,D.F.,"ALVARO OBREGON, D.F.",0,0,0,0,0,48,
22-mar-17,CHIH.,"GUADALUPE, CHIH.",0,0,0,2,0,56,
22-mar-17,VER.,"COSOLEACAQUE, VER.",0,0,0,0,0,111,
23-mar-17,COAH.,"SALTILLO, COAH.",0,0,0,0,1,0,
23-mar-17,CHIH.,"GUADALUPE, CHIH.",0,0,0,0,0,47,
24-mar-17,OAX.,"ASUNCION IXTALTEPEC, OAX.",0,0,0,0,10,0,
27-mar-17,COAH.,"PIEDRAS NEGRAS, COAH.",0,0,0,0,0,250,
28-mar-17,VER.,"SANTIAGO TUXTLA, VER.",0,0,0,0,0,221,
28-mar-17,TAMPS.,"NUEVO LAREDO, TAMPS.",0,0,0,0,0,10,
28-mar-17,Q. ROO,"SOLIDARIDAD, Q. ROO",0,0,0,0,0,20,
29-mar-17,VER.,"COSOLEACAQUE, VER.",0,0,0,0,0,107,
30-mar-17,MICH.,"APATZINGAN, MICH.",0,0,0,0,0,142,
31-mar-17,TAMPS.,"NUEVO LAREDO, TAMPS.",0,0,0,1,0,31,
31-mar-17,COAH.,"MATAMOROS, COAH.",0,0,0,5,0,0,
31-mar-17,Q. ROO,"SOLIDARIDAD, Q. ROO",0,0,0,0,0,40,
01-abr-17,COAH.,"SALTILLO, COAH.",0,0,0,0,3,0,
03-abr-17,COAH.,"SALTILLO, COAH.",0,0,0,0,2,189,
04-abr-17,N.L.,"MONTERREY, N.L.",0,0,0,5,0,0,
04-abr-17,N.L.,"CIENEGA DE FLORES, N.L.",0,0,0,8,0,0,
04-abr-17,CHIH.,"JANOS, CHIH.",0,0,0,0,0,622,
04-abr-17,TAMPS.,"MIGUEL ALEMAN, TAMPS.",0,0,0,1,0,78,
04-abr-17,TAMPS.,"NUEVO LAREDO, TAMPS.",0,0,0,0,0,20,
06-abr-17,CHIH.,"JANOS, CHIH.",0,0,0,0,0,198,
06-abr-17,MICH.,"SALVADOR ESCALANTE, MICH.",0,0,0,0,0,192,
10-abr-17,CHIS.,"PALENQUE, CHIS.",0,0,0,0,0,191,
10-abr-17,SIN.,"ELOTA, SIN.",0,0,0,0,13,0,
10-abr-17,OAX.,"PINOTEPA DE DON LUIS, OAX.",0,0,0,3,0,0,
11-abr-17,D.F.,"COYOACAN, D.F.",0,0,0,0,1,0,
11-abr-17,N.L.,"JUAREZ, N.L.",0,0,0,5,0,125,
11-abr-17,D.F.,"TLALPAN, D.F.",0,0,0,0,1,0,
17-abr-17,N.L.,"MONTERREY, N.L.",0,0,0,2,0,0,
17-abr-17,SIN.,"NAVOLATO, SIN.",0,0,0,0,9,0,
17-abr-17,TAMPS.,"NUEVO LAREDO, TAMPS.",0,0,0,5,0,125,
18-abr-17,SIN.,"ELOTA, SIN.",0,0,0,0,2,0,
21-abr-17,N.L.,"GRAL. ZUAZUA, N.L.",0,0,0,0,0,67,
21-abr-17,OAX.,"MIAHUATLAN DE PORFIRIO DIAZ, OAX.",0,0,0,2,0,6,
22-abr-17,N.L.,"GUADALUPE, N.L.",0,0,0,0,0,95,
24-abr-17,SIN.,"NAVOLATO, SIN.",0,0,0,0,6,0,
25-abr-17,N.L.,"GUADALUPE, N.L.",0,0,0,1,0,67,
26-abr-17,CHIS.,"OCOSINGO, CHIS.",0,0,0,0,0,25,
26-abr-17,MICH.,"LAZARO CARDENAS, MICH.",0,0,0,3,0,610,
27-abr-17,MICH.,"LAZARO CARDENAS, MICH.",0,0,0,0,0,360,
27-abr-17,CHIS.,"OCOSINGO, CHIS.",0,0,0,0,0,29,
28-abr-17,N.L.,"GUADALUPE, N.L.",0,0,0,1,0,86,
29-abr-17,MICH.,"LAZARO CARDENAS, MICH.",0,0,0,0,0,690,
30-abr-17,JAL.,"ZAPOPAN, JAL.",0,0,0,0,0,50,
02-may-17,JAL.,"TONALA, JAL.",0,0,0,0,0,250,
03-may-17,N.L.,"MONTERREY, N.L.",0,0,0,0,0,100,
03-may-17,SIN.,"BADIRAGUATO, SIN.",0,0,0,0,4,0,
04-may-17,TAMPS.,"NUEVO LAREDO, TAMPS.",0,0,0,0,0,29,
04-may-17,N.L.,"GUADALUPE, N.L.",0,0,0,1,0,40,
05-may-17,MICH.,"APATZINGAN, MICH.",0,0,0,0,0,150,
09-may-17,Q. ROO,"OTHON P. BLANCO, Q. ROO",0,0,0,0,3,38,
10-may-17,N.L.,"HGO., N.L.",0,0,0,5,1,0,
11-may-17,SIN.,"BADIRAGUATO, SIN.",0,0,0,0,6,0,
11-may-17,Q. ROO,"OTHON P. BLANCO, Q. ROO",0,0,0,0,3,138,
11-may-17,N.L.,"HGO., N.L.",0,0,0,5,0,67,
12-may-17,TAMPS.,"NUEVO LAREDO, TAMPS.",0,0,0,0,0,77,
12-may-17,SIN.,"BADIRAGUATO, SIN.",0,0,0,0,1,0,
12-may-17,N.L.,"GARCIA, N.L.",0,0,0,1,0,30,
12-may-17,Q. ROO,"OTHON P. BLANCO, Q. ROO",0,0,0,0,6,269,
13-may-17,JAL.,"ZAPOPAN, JAL.",0,0,0,0,1,0,
15-may-17,PUE.,"TEHUACAN, PUE.",0,0,0,0,0,126,
16-may-17,N.L.,"HGO., N.L.",0,0,0,1,1,0,
17-may-17,D.F.,"IZTACALCO, D.F.",0,0,0,0,0,60,
18-may-17,TAMPS.,"NUEVO LAREDO, TAMPS.",0,0,0,11,0,88,
18-may-17,MICH.,"LAZARO CARDENAS, MICH.",0,0,0,0,0,550,
18-may-17,N.L.,"GARCIA, N.L.",0,0,0,4,0,140,
19-may-17,N.L.,"HGO., N.L.",0,0,0,0,0,234,
19-may-17,MICH.,"LAZARO CARDENAS, MICH.",0,0,0,0,0,550,
20-may-17,N.L.,"GARCIA, N.L.",0,0,0,2,0,30,
20-may-17,MICH.,"LAZARO CARDENAS, MICH.",0,0,0,2,0,20,
20-may-17,JAL.,"TONALA, JAL.",0,0,0,2,0,52,
22-may-17,SON.,"HUATABAMPO, SON.",0,0,0,1,0,0,
23-may-17,PUE.,"TEHUACAN, PUE.",0,0,0,0,0,7,
23-may-17,TAMPS.,"NUEVO LAREDO, TAMPS.",0,0,0,1,0,16,
24-may-17,N.L.,"SAN NICOLAS DE LOS GARZA, N.L.",0,0,0,1,0,194,
27-may-17,N.L.,"SAN NICOLAS DE LOS GARZA, N.L.",0,0,0,10,0,16,
28-may-17,JAL.,"TLAQUEPAQUE, JAL.",0,0,0,0,0,424,
28-may-17,JAL.,"TONALA, JAL.",0,0,0,0,0,21,
29-may-17,JAL.,"TLAJOMULCO DE ZUÑIGA, JAL.",0,0,0,0,1,45,
29-may-17,N.L.,"SAN NICOLAS DE LOS GARZA, N.L.",0,0,0,0,0,90,
29-may-17,MICH.,"APATZINGAN, MICH.",0,0,0,0,1,572,
30-may-17,N.L.,"SAN NICOLAS DE LOS GARZA, N.L.",0,0,0,0,1,101,
30-may-17,JAL.,"TLAQUEPAQUE, JAL.",0,0,0,0,0,85,
31-may-17,CHIS.,"OCOSINGO, CHIS.",0,0,0,0,0,177,
31-may-17,SON.,"HERMOSILLO, SON.",0,0,0,2,0,100,
01-jun-17,SIN.,"CONCORDIA, SIN.",0,0,0,0,1,0,
01-jun-17,CHIH.,"NUEVO CASAS GRANDES, CHIH.",0,0,0,0,0,127,
02-jun-17,JAL.,"TLAJOMULCO DE ZUÑIGA, JAL.",0,0,0,0,0,92,
05-jun-17,TAMPS.,"NUEVO LAREDO, TAMPS.",0,0,0,6,0,0,
06-jun-17,MICH.,"TLALPUJAHUA, MICH.",0,0,0,0,2,0,
06-jun-17,AGS.,"AGS., AGS.",0,0,0,10,0,0,
06-jun-17,JAL.,"TLAQUEPAQUE, JAL.",0,0,0,0,0,100,
06-jun-17,JAL.,"TLAJOMULCO DE ZUÑIGA, JAL.",0,0,0,3,2,29,
06-jun-17,CHIH.,"NUEVO CASAS GRANDES, CHIH.",0,0,0,0,0,12,
07-jun-17,JAL.,"TONALA, JAL.",0,0,0,0,0,50,
07-jun-17,CHIS.,"TONALÁ, CHIS.",0,0,0,15,0,1103,
08-jun-17,CHIS.,"PALENQUE, CHIS.",0,0,0,0,0,100,
08-jun-17,JAL.,"TLAQUEPAQUE, JAL.",0,0,0,0,0,240,
08-jun-17,SON.,"HUATABAMPO, SON.",0,0,0,1,0,0,
09-jun-17,N.L.,"CARMEN, N.L.",0,0,0,4,0,0,
09-jun-17,MICH.,"LAZARO CARDENAS, MICH.",0,0,0,0,0,111,
09-jun-17,MICH.,"TLALPUJAHUA, MICH.",0,0,0,0,0,5073,
11-jun-17,N.L.,"CARMEN, N.L.",0,0,0,5,0,0,
11-jun-17,JAL.,"TLAQUEPAQUE, JAL.",0,0,0,0,0,140,
11-jun-17,JAL.,"TLAJOMULCO DE ZUÑIGA, JAL.",0,0,0,0,0,58,
12-jun-17,AGS.,"ASIENTOS, AGS.",0,0,0,1,0,0,
12-jun-17,MOR.,"CUERNAVACA, MOR.",0,0,0,2,1,21,
12-jun-17,GRO.,"ATOYAC DE ALVAREZ, GRO.",0,0,0,0,0,659,
13-jun-17,JAL.,"TLAQUEPAQUE, JAL.",0,0,0,0,0,200,
13-jun-17,JAL.,"ZAPOPAN, JAL.",0,0,0,0,0,652,
13-jun-17,TAMPS.,"TAMPICO, TAMPS.",0,0,0,3,0,19,
13-jun-17,N.L.,"CARMEN, N.L.",0,0,0,57,0,0,
14-jun-17,COAH.,"MATAMOROS, COAH.",0,0,0,1,0,0,
14-jun-17,COAH.,"MONCLOVA, COAH.",0,0,0,2,0,164,
14-jun-17,SON.,"CAJEME, SON.",0,0,0,3,0,0,
15-jun-17,MICH.,"LAZARO CARDENAS, MICH.",0,0,0,3,0,207,
15-jun-17,JAL.,"TLAQUEPAQUE, JAL.",0,0,0,0,0,631,
16-jun-17,COAH.,"SALTILLO, COAH.",0,0,0,0,0,250,
16-jun-17,GRO.,"PETATLAN, GRO.",0,0,0,0,1,0,
16-jun-17,SIN.,"SALVADOR ALVARADO, SIN.",0,0,0,0,3,0,
16-jun-17,PUE.,"AMOZOC, PUE.",0,0,0,0,0,120,
17-jun-17,COAH.,"FRONTERA, COAH.",0,0,0,0,0,49,
17-jun-17,N.L.,"CARMEN, N.L.",0,0,0,5,0,0,
18-jun-17,MEX.,"CUAUTITLAN IZCALLI, MEX.",0,0,0,0,1,0,
18-jun-17,N.L.,"CARMEN, N.L.",0,0,0,0,0,35,
19-jun-17,JAL.,"TLAJOMULCO DE ZUÑIGA, JAL.",0,0,0,3,0,58,
19-jun-17,SIN.,"ROSARIO, SIN.",0,0,0,0,2,0,
19-jun-17,B.C.,"TIJUANA, B.C.",0,0,0,0,1,0,
20-jun-17,MEX.,"JIQUIPILCO, MEX.",0,0,0,0,0,352,
20-jun-17,JAL.,"TLAJOMULCO DE ZUÑIGA, JAL.",0,0,0,1,0,61,
20-jun-17,N.L.,"MONTERREY, N.L.",0,0,0,1,0,85,
21-jun-17,JAL.,"TLAJOMULCO DE ZUÑIGA, JAL.",0,0,0,2,0,31,
21-jun-17,JAL.,"ZAPOPAN, JAL.",0,0,0,0,0,109,
21-jun-17,N.L.,"SANTA CATARINA, N.L.",0,0,0,2,0,100,
21-jun-17,D.F.,"GUSTAVO A. MADERO, D.F.",0,0,0,0,1,65,
21-jun-17,AGS.,"ASIENTOS, AGS.",0,0,0,10,0,0,
22-jun-17,B.C.,"ENSENADA, B.C.",0,0,0,0,1,0,
22-jun-17,JAL.,"TLAJOMULCO DE ZUÑIGA, JAL.",0,0,0,0,1,243,
22-jun-17,D.F.,"GUSTAVO A. MADERO, D.F.",0,0,0,0,0,1978,
22-jun-17,COAH.,"SALTILLO, COAH.",0,0,0,0,0,16,
23-jun-17,MOR.,"TEPOZTLAN, MOR.",0,0,0,2,6,103,
24-jun-17,MEX.,"JIQUIPILCO, MEX.",0,0,0,0,4,0,
24-jun-17,COAH.,"SALTILLO, COAH.",0,0,0,2,0,439,
24-jun-17,DGO.,"DGO., DGO.",0,0,0,6,0,0,
25-jun-17,TLAX.,"TLAXCO, TLAX.",0,0,0,0,1,0,
25-jun-17,MEX.,"JIQUIPILCO, MEX.",0,0,0,0,0,147,
26-jun-17,Q. ROO,"COZUMEL, Q. ROO",0,0,0,0,0,30,
27-jun-17,COAH.,"SALTILLO, COAH.",0,0,0,20,0,80,
27-jun-17,MEX.,"ATLAUTLA, MEX.",0,0,0,0,9,10,
27-jun-17,D.F.,"IZTAPALAPA, D.F.",0,0,0,0,1,0,
27-jun-17,N.L.,"MONTERREY, N.L.",0,0,0,2,0,131,
27-jun-17,AGS.,"COSÍO, AGS.",0,0,0,2,0,0,
28-jun-17,CHIH.,"GUADALUPE, CHIH.",0,0,0,2,0,71,
28-jun-17,JAL.,"IXTLAHUACAN DE LOS MEMBRILLOS, JAL.",0,0,0,0,0,120,
28-jun-17,DGO.,"DGO., DGO.",0,0,0,2,0,0,
28-jun-17,N.L.,"MONTERREY, N.L.",0,0,0,0,0,600,
29-jun-17,N.L.,"MARIN, N.L.",0,0,0,1,0,43,
29-jun-17,D.F.,"IZTAPALAPA, D.F.",0,0,0,0,0,198,
29-jun-17,Q. ROO,"COZUMEL, Q. ROO",0,0,0,0,0,248,
30-jun-17,N.L.,"MONTERREY, N.L.",0,0,0,0,0,59,
30-jun-17,MICH.,"LAZARO CARDENAS, MICH.",0,0,0,3,0,0,
30-jun-17,CHIS.,"PALENQUE, CHIS.",0,0,0,0,0,25,
03-jul-17,COAH.,"MATAMOROS, COAH.",0,0,0,4,0,0,
03-jul-17,MOR.,"TEPOZTLAN, MOR.",0,0,0,47,3,0,
04-jul-17,MOR.,"TEPOZTLAN, MOR.",0,0,0,15,3,32,
06-jul-17,B.C.,"TIJUANA, B.C.",0,0,0,0,3,0,
07-jul-17,MEX.,"ACULCO, MEX.",0,0,0,0,15,0,
07-jul-17,AGS.,"EL LLANO, AGS.",0,0,0,2,0,7,
08-jul-17,N.L.,"CADEREYTA JIMENEZ, N.L.",0,0,0,0,0,85,
08-jul-17,MEX.,"ACULCO, MEX.",0,0,0,0,1,835,
08-jul-17,MEX.,"NOPALTEPEC, MEX.",0,0,0,0,2,0,
10-jul-17,N.L.,"HIGUERAS, N.L.",0,0,0,2,0,100,
11-jul-17,COAH.,"SALTILLO, COAH.",0,0,0,0,0,13,
11-jul-17,COAH.,"RAMOS ARIZPE, COAH.",0,0,0,0,0,132,
11-jul-17,JAL.,"EL SALTO, JAL.",0,0,0,2,0,0,
12-jul-17,MOR.,"TEPOZTLAN, MOR.",0,0,0,28,4,0,
12-jul-17,COAH.,"SALTILLO, COAH.",0,0,0,0,0,833,
12-jul-17,SIN.,"EL FUERTE, SIN.",0,0,0,0,2,0,
12-jul-17,AGS.,"TEPEZALÁ, AGS.",0,0,0,0,0,29,
12-jul-17,OAX.,"JUCHITAN DE ZARAGOZA, OAX.",0,0,0,2,0,20,
13-jul-17,JAL.,"IXTLAHUACAN DE LOS MEMBRILLOS, JAL.",0,0,0,10,0,41,
13-jul-17,COAH.,"SALTILLO, COAH.",0,0,0,0,0,238,
13-jul-17,MEX.,"OZUMBA, MEX.",0,0,0,0,0,104,
13-jul-17,MEX.,"OTUMBA, MEX.",0,0,0,0,0,3,
13-jul-17,TAB.,"TEAPA, TAB.",0,0,0,2,0,65,
13-jul-17,HGO.,"TULA DE ALLENDE, HGO.",0,0,0,0,0,400,
14-jul-17,COAH.,"SALTILLO, COAH.",0,0,0,0,0,733,
14-jul-17,AGS.,"TEPEZALÁ, AGS.",0,0,0,0,0,539,
15-jul-17,MEX.,"MOR., MEX.",0,0,0,0,1,0,
16-jul-17,JAL.,"EL SALTO, JAL.",0,0,0,0,0,100,
17-jul-17,TAMPS.,"NUEVO LAREDO, TAMPS.",0,0,0,0,0,10,
17-jul-17,JAL.,"EL SALTO, JAL.",0,0,0,0,0,60,
18-jul-17,MOR.,"TEPOZTLAN, MOR.",0,0,0,0,2,636,
18-jul-17,MEX.,"ATENCO, MEX.",0,0,0,0,0,20,
18-jul-17,TAMPS.,"TAMPICO, TAMPS.",0,0,0,0,0,136,
19-jul-17,COAH.,"RAMOS ARIZPE, COAH.",0,0,0,0,0,630,
20-jul-17,COAH.,"TORREÓN, COAH.",0,0,0,0,0,19,
20-jul-17,OAX.,"OAX. DE JUAREZ, OAX.",0,0,0,0,1,0,
20-jul-17,TAB.,"TENOSIQUE, TAB.",0,0,0,0,1,0,
20-jul-17,OAX.,"PINOTEPA DE DON LUIS, OAX.",0,0,0,1,0,0,
21-jul-17,AGS.,"AGS., AGS.",0,0,0,7,0,0,
21-jul-17,OAX.,"OAX. DE JUAREZ, OAX.",0,0,0,0,1,0,
22-jul-17,MOR.,"TEPOZTLAN, MOR.",0,0,0,21,3,0,
22-jul-17,OAX.,"OAX. DE JUAREZ, OAX.",0,0,0,0,1,0,
22-jul-17,COAH.,"SALTILLO, COAH.",0,0,0,0,0,597,
22-jul-17,MEX.,"RAYON, MEX.",0,0,0,0,0,242,
24-jul-17,COAH.,"SALTILLO, COAH.",0,0,0,0,0,703,
24-jul-17,OAX.,"OAX. DE JUAREZ, OAX.",0,0,0,0,1,0,
24-jul-17,SON.,"HERMOSILLO, SON.",0,0,0,8,0,0,
24-jul-17,OAX.,"PINOTEPA DE DON LUIS, OAX.",0,0,0,1,0,0,
25-jul-17,DGO.,"DGO., DGO.",0,0,0,0,20,0,
25-jul-17,OAX.,"OAX. DE JUAREZ, OAX.",0,0,0,0,1,0,
25-jul-17,COAH.,"SALTILLO, COAH.",0,0,0,0,8,0,
26-jul-17,COAH.,"RAMOS ARIZPE, COAH.",0,0,0,1,0,450,
27-jul-17,COAH.,"RAMOS ARIZPE, COAH.",0,0,0,0,4,0,
27-jul-17,ZAC.,"SANTA MARIA DE LA PAZ, ZAC.",0,0,0,0,0,166,
27-jul-17,MEX.,"VILLA DEL CARBON, MEX.",0,0,0,0,0,51,
28-jul-17,COAH.,"SALTILLO, COAH.",0,0,0,1,0,940,
29-jul-17,COAH.,"ARTEAGA, COAH.",0,0,0,0,1,0,
30-jul-17,ZAC.,"JEREZ, ZAC.",0,0,0,0,0,496,
30-jul-17,ZAC.,"SANTA MARIA DE LA PAZ, ZAC.",0,0,0,0,0,58,
01-ago-17,COAH.,"MONCLOVA, COAH.",0,0,0,0,3,0,
01-ago-17,D.F.,"MIGUEL HGO., D.F.",0,0,0,0,5,86,
02-ago-17,CHIH.,"HGO. DEL PARRAL, CHIH.",0,0,0,0,0,20,
03-ago-17,COAH.,"SALTILLO, COAH.",0,0,0,0,0,1315,
03-ago-17,TAMPS.,"TAMPICO, TAMPS.",0,0,0,2,0,283,
07-ago-17,AGS.,"AGS., AGS.",0,0,0,7,0,0,
08-ago-17,AGS.,"AGS., AGS.",0,0,0,2,0,0,
08-ago-17,CHIS.,"TUXTLA GUTIÉRREZ, CHIS.",0,0,0,3,0,25,
08-ago-17,TAMPS.,"NUEVO LAREDO, TAMPS.",0,0,0,0,0,125,
08-ago-17,TAMPS.,"TAMPICO, TAMPS.",0,0,0,0,0,73,
09-ago-17,SIN.,"ESCUINAPA, SIN.",0,0,0,0,4,0,
09-ago-17,TAMPS.,"NUEVO LAREDO, TAMPS.",0,0,0,0,0,33,
09-ago-17,AGS.,"AGS., AGS.",0,0,0,41,0,0,
09-ago-17,CHIS.,"TAPACHULA, CHIS.",0,0,0,0,1,48,
09-ago-17,MEX.,"AMECAMECA, MEX.",0,0,0,0,0,54,
09-ago-17,COAH.,"MÚZQUIZ, COAH.",0,0,0,1,0,0,
10-ago-17,TAMPS.,"NUEVO LAREDO, TAMPS.",0,0,0,13,0,152,
10-ago-17,MEX.,"SANTO TOMAS, MEX.",0,0,0,0,1,0,
10-ago-17,AGS.,"AGS., AGS.",0,0,0,7,0,0,
10-ago-17,Q. ROO,"OTHON P. BLANCO, Q. ROO",0,0,0,0,1,21,
10-ago-17,N.L.,"ALLENDE, N.L.",0,0,0,0,1,0,
11-ago-17,MOR.,"EMILIANO ZAPATA, MOR.",0,0,0,56,5,300,
11-ago-17,COAH.,"RAMOS ARIZPE, COAH.",0,0,0,0,0,135,
11-ago-17,COAH.,"SAN PEDRO, COAH.",0,0,0,1,0,0,
13-ago-17,Q. ROO,"OTHON P. BLANCO, Q. ROO",0,0,0,0,0,22,
14-ago-17,TAMPS.,"NUEVO LAREDO, TAMPS.",0,0,0,0,0,26,
14-ago-17,COAH.,"RAMOS ARIZPE, COAH.",0,0,0,0,0,1048,
14-ago-17,AGS.,"AGS., AGS.",0,0,0,1,0,0,
15-ago-17,MOR.,"EMILIANO ZAPATA, MOR.",0,0,0,23,7,792,
15-ago-17,Q. ROO,"OTHON P. BLANCO, Q. ROO",0,0,0,0,0,71,
15-ago-17,CHIH.,"HGO. DEL PARRAL, CHIH.",0,0,0,1,0,3,
15-ago-17,S.L.P.,"SAN LUIS POTOSI, S.L.P.",0,0,0,28,0,0,
17-ago-17,SIN.,"ANGOSTURA, SIN.",0,0,0,0,2,0,
17-ago-17,COAH.,"SALTILLO, COAH.",0,0,0,1,2,0,
18-ago-17,MOR.,"EMILIANO ZAPATA, MOR.",0,0,0,0,4,0,
19-ago-17,COAH.,"SALTILLO, COAH.",0,0,0,2,0,0,
22-ago-17,MEX.,"NICOLAS ROMERO, MEX.",0,0,0,0,0,23,
22-ago-17,COAH.,"MÚZQUIZ, COAH.",0,0,0,0,0,700,
22-ago-17,MEX.,"TONATICO, MEX.",0,0,0,0,0,320,
23-ago-17,MOR.,"EMILIANO ZAPATA, MOR.",0,0,0,0,0,31,
23-ago-17,SIN.,"COSALA, SIN.",0,0,0,0,3,0,
24-ago-17,SIN.,"COSALA, SIN.",0,0,0,0,3,0,
24-ago-17,S.L.P.,"SAN LUIS POTOSI, S.L.P.",0,0,0,14,0,0,
25-ago-17,TAMPS.,"MATAMOROS, TAMPS.",0,0,0,9,0,26,
25-ago-17,VER.,"COATEPEC, VER.",0,0,0,0,0,28,
25-ago-17,VER.,"MISANTLA, VER.",0,0,0,1,0,8,
25-ago-17,COAH.,"RAMOS ARIZPE, COAH.",0,0,0,2,0,330,
26-ago-17,MEX.,"NICOLAS ROMERO, MEX.",0,0,0,0,0,88,
28-ago-17,MOR.,"EMILIANO ZAPATA, MOR.",0,0,0,0,1,138,
28-ago-17,COAH.,"RAMOS ARIZPE, COAH.",0,0,0,0,0,294,
29-ago-17,TAMPS.,"TAMPICO, TAMPS.",0,0,0,1,0,187,
29-ago-17,D.F.,"TLALPAN, D.F.",0,0,0,0,0,444,
01-sep-17,MOR.,"EMILIANO ZAPATA, MOR.",0,0,0,10,6,0,
02-sep-17,COAH.,"SALTILLO, COAH.",0,0,0,4,0,135,
03-sep-17,MEX.,"LA PAZ, MEX.",0,0,0,0,0,463,
04-sep-17,B.C.,"ENSENADA, B.C.",0,0,0,0,1,0,
04-sep-17,AGS.,"AGS., AGS.",0,0,0,30,0,0,
05-sep-17,MEX.,"HUIXQUILUCAN, MEX.",0,0,0,0,0,200,
05-sep-17,MEX.,"HUIXQUILUCAN, MEX.",0,0,0,0,0,200,
05-sep-17,CHIH.,"NUEVO CASAS GRANDES, CHIH.",0,0,0,0,0,155,
06-sep-17,COAH.,"RAMOS ARIZPE, COAH.",0,0,0,0,0,360,
06-sep-17,AGS.,"AGS., AGS.",0,0,0,51,0,0,
07-sep-17,D.F.,"TLALPAN, D.F.",0,0,0,0,0,1119,
07-sep-17,Q. ROO,"TULUM, Q. ROO",0,0,0,0,0,21,
07-sep-17,CHIH.,"NUEVO CASAS GRANDES, CHIH.",0,0,0,0,0,93,
07-sep-17,GRO.,"AJUCHITLAN DEL PROGRESO, GRO.",0,0,0,0,0,88,
08-sep-17,Q. ROO,"TULUM, Q. ROO",0,0,0,0,0,20,
08-sep-17,DGO.,"DGO., DGO.",0,0,0,0,10,0,
08-sep-17,MEX.,"APAXCO, MEX.",0,0,0,0,0,443,
09-sep-17,ZAC.,"GUADALUPE, ZAC.",0,0,0,0,0,384,
10-sep-17,MEX.,"APAXCO, MEX.",0,0,0,0,0,758,
11-sep-17,ZAC.,"GUADALUPE, ZAC.",0,0,0,0,0,76,
12-sep-17,CHIH.,"NUEVO CASAS GRANDES, CHIH.",0,0,0,0,0,345,
18-sep-17,COAH.,"SAN PEDRO, COAH.",0,0,0,8,0,265,
19-sep-17,ZAC.,"FRESNILLO, ZAC.",0,0,0,1,0,24,
19-sep-17,AGS.,"AGS., AGS.",0,0,0,1,0,0,
19-sep-17,GTO.,"GTO., GTO.",0,0,0,0,1,0,
20-sep-17,DGO.,"DGO., DGO.",0,0,0,0,3,0,
21-sep-17,N.L.,"CHINA, N.L.",0,0,0,0,1,0,
21-sep-17,SON.,"HERMOSILLO, SON.",0,0,0,7,0,0,
22-sep-17,N.L.,"MONTERREY, N.L.",0,0,0,4,0,40,
22-sep-17,SIN.,"MOCORITO, SIN.",0,0,0,0,1,0,
23-sep-17,TAMPS.,"NUEVO LAREDO, TAMPS.",0,0,0,2,0,50,
23-sep-17,TAB.,"CENTRO, TAB.",0,0,0,1,0,207,
25-sep-17,COAH.,"SAN PEDRO, COAH.",0,0,0,2,0,60,
26-sep-17,ZAC.,"JUCHIPILA, ZAC.",0,0,0,0,0,438,
27-sep-17,TAMPS.,"TAMPICO, TAMPS.",0,0,0,2,0,201,
27-sep-17,ZAC.,"JUCHIPILA, ZAC.",0,0,0,0,0,438,
27-sep-17,MEX.,"ATIZAPAN, MEX.",0,0,0,0,0,50,
28-sep-17,COAH.,"PIEDRAS NEGRAS, COAH.",0,0,0,2,0,363,
28-sep-17,AGS.,"AGS., AGS.",0,0,0,1,0,0,
03-oct-17,B.C.,"TIJUANA, B.C.",0,0,0,0,1,0,
04-oct-17,SON.,"GUAYMAS, SON.",0,0,0,0,0,78,
05-oct-17,SON.,"HERMOSILLO, SON.",0,0,0,1,0,25,
06-oct-17,SON.,"HERMOSILLO, SON.",0,0,0,0,0,24,
07-oct-17,TAMPS.,"MATAMOROS, TAMPS.",0,0,0,0,0,89,
07-oct-17,TAMPS.,"NUEVO LAREDO, TAMPS.",0,0,0,0,0,271,
09-oct-17,N.L.,"GALEANA, N.L.",0,0,0,1,0,0,
11-oct-17,COAH.,"SALTILLO, COAH.",0,0,0,0,0,115,
12-oct-17,COAH.,"SALTILLO, COAH.",0,0,0,0,0,480,
16-oct-17,MICH.,"APATZINGAN, MICH.",0,0,0,0,0,42,
18-oct-17,ZAC.,"MOMAX, ZAC.",0,0,0,0,0,105,
20-oct-17,D.F.,"LA MAGDALENA CONTRERAS, D.F.",0,0,0,0,0,124,
26-oct-17,SIN.,"CULIACAN, SIN.",0,0,0,0,15,0,
26-oct-17,SON.,"HERMOSILLO, SON.",0,0,0,0,0,382,
26-oct-17,B.C.,"ENSENADA, B.C.",0,0,0,0,1,0,
30-oct-17,SON.,"HERMOSILLO, SON.",0,0,0,0,0,70,
31-oct-17,TAMPS.,"TAMPICO, TAMPS.",0,0,0,0,1,0,
01-nov-17,D.F.,"ALVARO OBREGON, D.F.",0,0,0,0,0,105,
01-nov-17,SON.,"HERMOSILLO, SON.",0,0,0,0,0,100,
03-nov-17,SON.,"HERMOSILLO, SON.",0,0,0,0,0,200,
05-nov-17,D.F.,"ALVARO OBREGON, D.F.",0,0,0,0,4,102,
06-nov-17,S.L.P.,"CIUDAD VALLES, S.L.P.",0,0,0,0,1,0,
06-nov-17,N.L.,"MONTERREY, N.L.",0,0,0,2,0,0,
07-nov-17,N.L.,"MONTERREY, N.L.",0,0,0,0,0,100,
08-nov-17,D.F.,"ALVARO OBREGON, D.F.",0,0,0,0,14,197,
08-nov-17,DGO.,"DGO., DGO.",0,0,0,0,2,0,
08-nov-17,N.L.,"GRAL. ESCOBEDO, N.L.",0,0,0,1,1,37,
09-nov-17,ZAC.,"FRESNILLO, ZAC.",0,0,0,17,0,30,
09-nov-17,CHIH.,"NUEVO CASAS GRANDES, CHIH.",0,0,0,0,0,4,
10-nov-17,ZAC.,"ZAC., ZAC.",0,0,0,0,0,13,
10-nov-17,TAMPS.,"MATAMOROS, TAMPS.",0,0,0,0,0,631,
11-nov-17,TAMPS.,"MATAMOROS, TAMPS.",0,0,0,5,0,34,
19-nov-17,S.L.P.,"SAN LUIS POTOSI, S.L.P.",0,0,0,6,0,150,
24-nov-17,SIN.,"MAZATLAN, SIN.",0,0,0,0,1,0,
25-nov-17,COAH.,"ACUÑA, COAH.",0,0,0,0,0,83,
27-nov-17,Q. ROO,"COZUMEL, Q. ROO",0,0,0,0,0,354,
28-nov-17,Q. ROO,"COZUMEL, Q. ROO",0,0,0,0,0,208,
28-nov-17,DGO.,"DGO., DGO.",0,0,0,0,1,0,
28-nov-17,Q. ROO,"COZUMEL, Q. ROO",0,0,0,0,0,306,
30-nov-17,B.C.,"ENSENADA, B.C.",0,0,0,0,1,0,
01-dic-17,Q. ROO,"COZUMEL, Q. ROO",0,0,0,0,0,1189,
02-dic-17,TAMPS.,"MATAMOROS, TAMPS.",0,0,0,4,0,64,
05-dic-17,B.C.,"TIJUANA, B.C.",0,0,0,0,1,0,
06-dic-17,TAMPS.,"CAMARGO, TAMPS.",0,0,0,0,0,30,
06-dic-17,TAMPS.,"MATAMOROS, TAMPS.",0,0,0,15,0,100,
07-dic-17,B.C.,"ENSENADA, B.C.",0,0,0,0,1,0,
07-dic-17,ZAC.,"ZAC., ZAC.",0,0,0,3,0,300,
08-dic-17,D.F.,"IZTACALCO, D.F.",0,0,0,0,1,0,
08-dic-17,ZAC.,"FRESNILLO, ZAC.",0,0,0,3,0,0,
10-dic-17,ZAC.,"FRESNILLO, ZAC.",0,0,0,6,0,0,
12-dic-17,TAB.,"CENTRO, TAB.",0,0,0,0,0,100,
13-dic-17,N.L.,"AGUALEGUAS, N.L.",0,0,0,8,0,182,
13-dic-17,ZAC.,"ZAC., ZAC.",0,0,0,15,0,0,
14-dic-17,S.L.P.,"CIUDAD VALLES, S.L.P.",0,0,0,8,0,0,
14-dic-17,ZAC.,"ZAC., ZAC.",0,0,0,11,0,98,
14-dic-17,ZAC.,"FRESNILLO, ZAC.",0,0,0,63,0,0,
15-dic-17,PUE.,"SAN MARTIN TEXMELUCAN, PUE.",0,0,0,2,0,50,
16-dic-17,S.L.P.,"CIUDAD VALLES, S.L.P.",0,0,0,1,0,0,
16-dic-17,PUE.,"SAN MARTIN TEXMELUCAN, PUE.",0,0,0,2,0,50,
20-dic-17,N.L.,"MONTERREY, N.L.",0,0,0,1,1,6010,
21-dic-17,D.F.,"CUAUHTEMOC, D.F.",0,0,0,0,4,0,
08-ene-18,COAH.,"MÚZQUIZ, COAH.",0,0,0,0,0,290,
10-ene-18,COAH.,"TORREÓN, COAH.",0,0,0,1,0,7,
11-ene-18,COAH.,"TORREÓN, COAH.",0,0,0,1,0,7,
12-ene-18,COAH.,"SALTILLO, COAH.",0,0,0,1,0,191,
12-ene-18,COAH.,"PIEDRAS NEGRAS, COAH.",0,0,0,0,0,54,
12-ene-18,COAH.,"SABINAS, COAH.",0,0,0,8,0,0,
19-ene-18,COAH.,"MONCLOVA, COAH.",0,0,0,0,0,37,
20-ene-18,COAH.,"MONCLOVA, COAH.",0,0,0,0,1,0,
23-ene-18,COAH.,"MÚZQUIZ, COAH.",0,0,0,0,0,146,
23-ene-18,VER.,"PUEBLO VIEJO, VER.",0,0,0,0,1,0,
25-ene-18,COAH.,"PIEDRAS NEGRAS, COAH.",0,0,0,2,0,231,
26-ene-18,TAB.,"CENTRO, TAB.",0,0,0,2,0,49,
27-ene-18,COAH.,"PIEDRAS NEGRAS, COAH.",0,0,0,0,0,736,
30-ene-18,TAMPS.,"NUEVO LAREDO, TAMPS.",0,0,0,0,0,33,
02-feb-18,TAMPS.,"NUEVO LAREDO, TAMPS.",0,0,0,1,0,51,
03-feb-18,COAH.,"PIEDRAS NEGRAS, COAH.",0,0,0,11,0,387,
08-feb-18,VER.,"SAN RAFAEL, VER.",0,0,0,0,0,41,
10-feb-18,TAMPS.,"NUEVO LAREDO, TAMPS.",0,0,0,4,0,170,
10-feb-18,COAH.,"PIEDRAS NEGRAS, COAH.",0,0,0,10,0,465,
10-feb-18,DGO.,"DGO., DGO.",0,0,0,0,2,0,
10-feb-18,TAMPS.,"MATAMOROS, TAMPS.",0,0,0,0,0,10,
12-feb-18,COAH.,"RAMOS ARIZPE, COAH.",0,0,0,0,0,505,
12-feb-18,COAH.,"PIEDRAS NEGRAS, COAH.",0,0,0,7,0,691,
13-feb-18,TAB.,"CENTRO, TAB.",0,0,0,3,0,249,
13-feb-18,COAH.,"RAMOS ARIZPE, COAH.",0,0,0,0,0,50,
14-feb-18,TAMPS.,"NUEVO LAREDO, TAMPS.",0,0,0,0,0,125,
14-feb-18,COAH.,"PIEDRAS NEGRAS, COAH.",0,0,0,0,0,50,
19-feb-18,GRO.,"COYUCA DE BENITEZ, GRO.",0,0,0,0,0,15,
20-feb-18,Q. ROO,"COZUMEL, Q. ROO",0,0,0,0,0,20,
21-feb-18,GRO.,"ACAPULCO DE JUAREZ, GRO.",0,0,0,0,1,0,
21-feb-18,Q. ROO,"COZUMEL, Q. ROO",0,0,0,0,0,372,
22-feb-18,TAMPS.,"NUEVO LAREDO, TAMPS.",0,0,0,0,0,75,
22-feb-18,GRO.,"ACAPULCO DE JUAREZ, GRO.",0,0,0,0,0,309,
23-feb-18,COAH.,"TORREÓN, COAH.",0,0,0,0,0,429,
23-feb-18,GRO.,"ACAPULCO DE JUAREZ, GRO.",0,0,0,0,1,143,
24-feb-18,DGO.,"GOMEZ PALACIO, DGO.",0,0,0,0,3,0,
25-feb-18,TAMPS.,"REYNOSA, TAMPS.",0,0,0,0,0,90,
28-feb-18,COAH.,"SALTILLO, COAH.",0,0,0,0,1,0,
01-mar-18,D.F.,"IZTAPALAPA, D.F.",0,0,0,0,0,761,
01-mar-18,COAH.,"RAMOS ARIZPE, COAH.",0,0,0,1,0,55,
02-mar-18,TAMPS.,"MATAMOROS, TAMPS.",0,0,0,4,0,10,
05-mar-18,COAH.,"SALTILLO, COAH.",0,0,0,0,2,0,
06-mar-18,COAH.,"SALTILLO, COAH.",0,0,0,1,0,172,
06-mar-18,D.F.,"TLALPAN, D.F.",0,0,0,0,0,81,
09-mar-18,SIN.,"CULIACAN, SIN.",0,0,0,0,3,0,
12-mar-18,SIN.,"ELOTA, SIN.",0,0,0,0,2,0,
13-mar-18,COAH.,"SALTILLO, COAH.",0,0,0,0,0,254,
14-mar-18,SIN.,"ELOTA, SIN.",0,0,0,0,12,0,
14-mar-18,DGO.,"GOMEZ PALACIO, DGO.",0,0,0,0,1,0,
15-mar-18,S.L.P.,"CIUDAD VALLES, S.L.P.",0,0,0,0,0,1,
20-mar-18,VER.,"RIO BLANCO, VER.",0,0,0,0,0,34,
22-mar-18,ZAC.,"FRESNILLO, ZAC.",0,0,0,0,0,111,
23-mar-18,COAH.,"PIEDRAS NEGRAS, COAH.",0,0,0,0,0,20,
23-mar-18,VER.,"MARTINEZ DE LA TORRE, VER.",0,0,0,0,0,94,
24-mar-18,COAH.,"PIEDRAS NEGRAS, COAH.",0,0,0,1,0,0,
26-mar-18,COAH.,"MONCLOVA, COAH.",0,0,0,0,1,161,
26-mar-18,COAH.,"ACUÑA, COAH.",0,0,0,3,0,0,
27-mar-18,COAH.,"TORREÓN, COAH.",0,0,0,0,8,0,
27-mar-18,COAH.,"PIEDRAS NEGRAS, COAH.",0,0,0,0,0,42,
28-mar-18,COAH.,"FRANCISCO I. MADERO, COAH.",0,0,0,1,0,732,
28-mar-18,S.L.P.,"CIUDAD VALLES, S.L.P.",0,0,0,0,9,0,
28-mar-18,COAH.,"MÚZQUIZ, COAH.",0,0,0,0,0,305,
29-mar-18,COAH.,"NUEVA ROSITA, COAH.",0,0,0,0,0,76,
07-jul-18,N.L.,"APODACA, N.L.",0,0,0,16,0,500,
10-jul-18,N.L.,"APODACA, N.L.",0,0,0,11,0,0,
11-jul-18,N.L.,"SALINAS VICTORIA, N.L.",0,0,0,20,0,513,
11-jul-18,TAB.,"PARAISO, TAB.",0,0,0,0,1,101,
14-jul-18,TAB.,"PARAISO, TAB.",0,0,0,0,0,30,
19-jul-18,B.C.,"MEXICALI, B.C.",0,0,0,0,1,0,
21-jul-18,GTO.,"IRAPUATO, GTO.",0,0,0,0,2,20,
25-jul-18,B.C.,"ENSENADA, B.C.",0,0,0,0,1,0,
25-jul-18,TAB.,"PARAISO, TAB.",0,0,0,0,1,0,
25-jul-18,N.L.,"SALINAS VICTORIA, N.L.",0,0,0,0,0,43,
26-jul-18,GTO.,"CELAYA, GTO.",0,0,0,0,11,20,
27-jul-18,N.L.,"APODACA, N.L.",0,0,0,0,1,0,
01-ago-18,DGO.,"GOMEZ PALACIO, DGO.",0,0,0,1,0,0,
01-ago-18,TAMPS.,"NUEVO LAREDO, TAMPS.",0,0,0,0,0,24,
02-ago-18,D.F.,"GUSTAVO A. MADERO, D.F.",0,0,0,0,1,0,
02-ago-18,SIN.,"NAVOLATO, SIN.",0,0,0,0,3,0,
03-ago-18,GTO.,"IRAPUATO, GTO.",0,0,0,0,17,14,
04-ago-18,TAB.,"EMILIANO ZAPATA, TAB.",0,0,0,1,0,0,
06-ago-18,GTO.,"IRAPUATO, GTO.",0,0,0,0,1,7,
06-ago-18,GTO.,"CELAYA, GTO.",0,0,0,0,0,50,
08-ago-18,TAMPS.,"ALTAMIRA, TAMPS.",0,0,0,0,0,23,
09-ago-18,COAH.,"PIEDRAS NEGRAS, COAH.",0,0,0,0,0,269,
09-ago-18,TAMPS.,"ALTAMIRA, TAMPS.",0,0,0,0,0,23,
10-ago-18,COAH.,"MONCLOVA, COAH.",0,0,0,0,0,175,
10-ago-18,COAH.,"PIEDRAS NEGRAS, COAH.",0,0,0,0,0,90,
10-ago-18,TAMPS.,"ALTAMIRA, TAMPS.",0,0,0,0,2,0,
10-ago-18,TAMPS.,"CIUDAD MADERO, TAMPS.",0,0,0,0,0,113,
11-ago-18,TAMPS.,"ALTAMIRA, TAMPS.",0,0,0,0,0,196,
11-ago-18,TAMPS.,"NUEVO LAREDO, TAMPS.",0,0,0,0,0,39,
13-ago-18,COAH.,"TORREÓN, COAH.",0,0,0,1,0,0,
13-ago-18,COAH.,"TORREÓN, COAH.",0,0,0,1,0,223,
14-ago-18,TAMPS.,"ALTAMIRA, TAMPS.",0,0,0,0,0,40,
14-ago-18,TAMPS.,"NUEVO LAREDO, TAMPS.",0,0,0,0,0,129,
14-ago-18,MEX.,"SAN MATEO ATENCO, MEX.",0,0,0,0,0,49,
15-ago-18,COAH.,"RAMOS ARIZPE, COAH.",0,0,0,0,0,92,
15-ago-18,COAH.,"MONCLOVA, COAH.",0,0,0,0,0,68,
16-ago-18,B.C.,"ENSENADA, B.C.",0,0,0,0,1,0,
16-ago-18,B.C.,"MEXICALI, B.C.",0,0,0,0,1,0,
16-ago-18,COAH.,"SALTILLO, COAH.",0,0,0,2,0,13,
16-ago-18,COAH.,"PIEDRAS NEGRAS, COAH.",0,0,0,0,0,199,
16-ago-18,TAMPS.,"NUEVO LAREDO, TAMPS.",0,0,0,0,0,129,
18-ago-18,CHIS.,"TAPACHULA, CHIS.",0,0,0,2,1,278,
19-ago-18,CHIS.,"TAPACHULA, CHIS.",0,0,0,0,0,757,
20-ago-18,TAMPS.,"ALTAMIRA, TAMPS.",0,0,0,0,0,86,
20-ago-18,TAMPS.,"MIER, TAMPS.",0,0,0,0,0,61,
21-ago-18,TAMPS.,"CIUDAD MADERO, TAMPS.",0,0,0,0,0,669,
21-ago-18,TAMPS.,"MATAMOROS, TAMPS.",0,0,0,0,0,76,
21-ago-18,COAH.,"RAMOS ARIZPE, COAH.",0,0,0,0,2,0,
21-ago-18,COAH.,"NUEVA ROSITA, COAH.",0,0,0,7,0,530,
22-ago-18,GTO.,"CELAYA, GTO.",0,0,0,0,0,57,
23-ago-18,TAMPS.,"NUEVO LAREDO, TAMPS.",0,0,0,1,0,511,
23-ago-18,TAMPS.,"REYNOSA, TAMPS.",0,0,0,4,0,278,
23-ago-18,TAB.,"CENTRO, TAB.",0,0,0,0,0,25,
23-ago-18,B.C.,"ENSENADA, B.C.",0,0,0,0,1,0,
23-ago-18,MEX.,"APAXCO, MEX.",0,0,0,0,0,28,
24-ago-18,COAH.,"MONCLOVA, COAH.",0,0,0,0,1,17,
24-ago-18,N.L.,"MELCHOR OCAMPO, N.L.",0,0,0,3,0,0,
24-ago-18,TAMPS.,"REYNOSA, TAMPS.",0,0,0,4,0,68,
24-ago-18,TAMPS.,"VICTORIA, TAMPS.",0,0,0,1,0,17,
24-ago-18,COAH.,"MONCLOVA, COAH.",0,0,0,0,2,0,
28-ago-18,D.F.,"AZCAPOTZALCO, D.F.",0,0,0,0,0,5300,
28-ago-18,COAH.,"SAN PEDRO, COAH.",0,0,0,0,0,81,
28-ago-18,TAMPS.,"MATAMOROS, TAMPS.",0,0,0,0,1,0,
28-ago-18,TAMPS.,"REYNOSA, TAMPS.",0,0,0,12,0,32,
28-ago-18,ZAC.,"FRESNILLO, ZAC.",0,0,0,25,0,0,
29-ago-18,N.L.,"APODACA, N.L.",0,0,0,10,0,0,
29-ago-18,MOR.,"TEPOZTLAN, MOR.",0,0,0,56,0,585,
30-ago-18,MEX.,"IXTAPAN DE LA SAL, MEX.",0,0,0,1,0,160,
30-ago-18,MEX.,"TLALNEPANTLA DE BAZ, MEX.",0,0,0,0,0,634,
31-ago-18,TAMPS.,"NUEVO LAREDO, TAMPS.",0,0,0,0,0,33,
01-sep-18,MEX.,"TLALNEPANTLA DE BAZ, MEX.",0,0,0,0,0,8398,
03-sep-18,COAH.,"SAN PEDRO, COAH.",0,0,0,0,0,140,
04-sep-18,MEX.,"SOYANIQUILPAN DE JUAREZ, MEX.",0,0,0,0,0,37,
04-sep-18,VER.,"VER., VER.",0,0,0,0,0,45,
05-sep-18,ZAC.,"GUADALUPE, ZAC.",0,0,0,3,0,0,
05-sep-18,AGS.,"AGS., AGS.",0,0,0,0,0,41,
05-sep-18,VER.,"BOCA DEL RIO, VER.",0,0,0,1,0,233,
05-sep-18,TAMPS.,"EL MANTE, TAMPS.",0,0,0,0,0,103,
05-sep-18,TAMPS.,"MATAMOROS, TAMPS.",0,0,0,3,0,56,
05-sep-18,TAMPS.,"NUEVO LAREDO, TAMPS.",0,0,0,0,0,74,
06-sep-18,COAH.,"MATAMOROS, COAH.",0,0,0,3,0,195,
06-sep-18,COAH.,"SAN PEDRO, COAH.",0,0,0,0,0,222,
06-sep-18,COAH.,"SALTILLO, COAH.",0,0,0,1,0,53,
06-sep-18,VER.,"BOCA DEL RIO, VER.",0,0,0,0,0,95,
06-sep-18,MEX.,"AMECAMECA, MEX.",0,0,0,0,0,127,
07-sep-18,TAMPS.,"TAMPICO, TAMPS.",0,0,0,0,0,94,
07-sep-18,MEX.,"SOYANIQUILPAN DE JUAREZ, MEX.",0,0,0,0,1,6064,
07-sep-18,VER.,"XALAPA, VER.",0,0,0,3,0,266,
07-sep-18,Q. ROO,"COZUMEL, Q. ROO",0,0,0,0,0,17,
07-sep-18,N.L.,"GUADALUPE, N.L.",0,0,0,11,0,345,
08-sep-18,COAH.,"MONCLOVA, COAH.",0,0,0,3,3,170,
10-sep-18,COAH.,"MONCLOVA, COAH.",0,0,0,0,0,249,
10-sep-18,VER.,"XALAPA, VER.",0,0,0,0,0,26,
11-sep-18,N.L.,"GUADALUPE, N.L.",0,0,0,12,0,130,
11-sep-18,VER.,"XALAPA, VER.",0,0,0,6,0,23,
11-sep-18,VER.,"VER., VER.",0,0,0,0,0,72,
11-sep-18,VER.,"MARTINEZ DE LA TORRE, VER.",0,0,0,2,0,44,
12-sep-18,COAH.,"MONCLOVA, COAH.",0,0,0,0,2,119,
12-sep-18,TAMPS.,"CIUDAD MADERO, TAMPS.",0,0,0,0,1,0,
12-sep-18,VER.,"BOCA DEL RIO, VER.",0,0,0,0,1,0,
13-sep-18,ZAC.,"FRESNILLO, ZAC.",0,0,0,6,0,0,
13-sep-18,TAMPS.,"REYNOSA, TAMPS.",0,0,0,16,0,7,
14-sep-18,TAMPS.,"MATAMOROS, TAMPS.",0,0,0,1,0,26,
14-sep-18,ZAC.,"FRESNILLO, ZAC.",0,0,0,6,0,0,
14-sep-18,VER.,"VER., VER.",0,0,0,3,0,633,
17-sep-18,TAB.,"HUIMANGUILLO, TAB.",0,0,0,0,1,0,
18-sep-18,TAMPS.,"ALTAMIRA, TAMPS.",0,0,0,0,0,47,
18-sep-18,MOR.,"CUERNAVACA, MOR.",0,0,0,25,0,210,
20-sep-18,COAH.,"RAMOS ARIZPE, COAH.",0,0,0,2,0,0,
20-sep-18,MEX.,"TOLUCA, MEX.",0,0,0,0,0,4350,
22-sep-18,COAH.,"MONCLOVA, COAH.",0,0,0,0,0,111,
22-sep-18,MEX.,"TULTEPEC, MEX.",0,0,0,0,0,54,
22-sep-18,MOR.,"TETELA DEL VOLCAN, MOR.",0,0,0,25,0,0,
24-sep-18,COAH.,"TORREÓN, COAH.",0,0,0,0,0,65,
24-sep-18,COAH.,"MONCLOVA, COAH.",0,0,0,0,1,0,
26-sep-18,COAH.,"PIEDRAS NEGRAS, COAH.",0,0,0,0,0,450,
26-sep-18,AGS.,"AGS., AGS.",0,0,0,1,0,10,
26-sep-18,MEX.,"RAYON, MEX.",0,0,0,0,0,3112,
26-sep-18,MOR.,"TEPOZTLAN, MOR.",0,0,0,20,0,207,
28-sep-18,MEX.,"RAYON, MEX.",0,0,0,0,0,2658,
28-sep-18,AGS.,"AGS., AGS.",0,0,0,2,0,6,
28-sep-18,COAH.,"PIEDRAS NEGRAS, COAH.",0,0,0,5,0,797,
29-sep-18,MEX.,"RAYON, MEX.",0,0,0,0,0,2932,
29-sep-18,COAH.,"MÚZQUIZ, COAH.",0,0,0,1,0,0,
01-oct-18,COAH.,"SALTILLO, COAH.",0,0,0,2,0,112,
03-oct-18,COAH.,"PIEDRAS NEGRAS, COAH.",0,0,0,0,0,581,
03-oct-18,MOR.,"TEPOZTLAN, MOR.",0,0,0,39,0,0,
03-oct-18,MOR.,"CUERNAVACA, MOR.",0,0,0,0,0,511,
04-oct-18,COAH.,"RAMOS ARIZPE, COAH.",0,0,0,0,0,108,
04-oct-18,COAH.,"PIEDRAS NEGRAS, COAH.",0,0,0,4,0,503,
04-oct-18,ZAC.,"ZAC., ZAC.",0,0,0,21,0,0,
04-oct-18,MEX.,"IXTAPALUCA, MEX.",0,0,0,0,0,2495,
08-oct-18,B.C.,"MEXICALI, B.C.",0,0,0,0,1,0,
08-oct-18,COAH.,"MÚZQUIZ, COAH.",0,0,0,20,0,0,
08-oct-18,ZAC.,"GUADALUPE, ZAC.",0,0,0,2,0,93,
09-oct-18,B.C.,"MEXICALI, B.C.",0,0,0,0,1,0,
09-oct-18,COAH.,"MÚZQUIZ, COAH.",0,0,0,1,0,0,
10-oct-18,COAH.,"TORREÓN, COAH.",0,0,0,3,0,0,
10-oct-18,S.L.P.,"CIUDAD VALLES, S.L.P.",0,0,0,0,0,40,
10-oct-18,AGS.,"AGS., AGS.",0,0,0,1,0,0,
11-oct-18,MEX.,"COACALCO DE BERRIOZABAL, MEX.",0,0,0,0,0,268,
12-oct-18,B.C.,"TIJUANA, B.C.",0,0,0,0,1,0,
13-oct-18,COAH.,"PIEDRAS NEGRAS, COAH.",0,0,0,0,0,250,
13-oct-18,MEX.,"VILLA VICTORIA, MEX.",0,0,0,0,0,899,
14-oct-18,N.L.,"MELCHOR OCAMPO, N.L.",0,0,0,10,0,0,
15-oct-18,COAH.,"MÚZQUIZ, COAH.",0,0,0,5,0,350,
15-oct-18,S.L.P.,"CIUDAD VALLES, S.L.P.",0,0,0,0,1,0,
15-oct-18,MOR.,"TEPOZTLAN, MOR.",0,0,0,27,0,138,
15-oct-18,MEX.,"HUEHUETOCA, MEX.",0,0,0,0,0,63,
16-oct-18,S.L.P.,"CIUDAD VALLES, S.L.P.",0,0,0,2,0,110,
16-oct-18,AGS.,"AGS., AGS.",0,0,0,5,0,14,
17-oct-18,COAH.,"PIEDRAS NEGRAS, COAH.",0,0,0,3,0,0,
19-oct-18,MEX.,"HUEHUETOCA, MEX.",0,0,0,0,0,104,
19-oct-18,ZAC.,"GUADALUPE, ZAC.",0,0,0,0,0,200,
19-oct-18,ZAC.,"FRESNILLO, ZAC.",0,0,0,0,0,755,
23-oct-18,MOR.,"CUERNAVACA, MOR.",0,0,0,2,3,222,
23-oct-18,MEX.,"LA PAZ, MEX.",0,0,0,0,6,0,
24-oct-18,S.L.P.,"CIUDAD VALLES, S.L.P.",0,0,0,2,0,115,
26-oct-18,MEX.,"ALMOLOYA DE JUAREZ, MEX.",0,0,0,0,0,5,
26-oct-18,ZAC.,"FRESNILLO, ZAC.",0,0,0,7,0,0,
27-oct-18,MEX.,"ALMOLOYA DE JUAREZ, MEX.",0,0,0,0,1,322,
27-oct-18,COAH.,"PIEDRAS NEGRAS, COAH.",0,0,0,6,0,485,
29-oct-18,MEX.,"XONACATLAN, MEX.",0,0,0,0,0,63,
29-oct-18,COAH.,"RAMOS ARIZPE, COAH.",0,0,0,0,0,57,
29-oct-18,ZAC.,"GUADALUPE, ZAC.",0,0,0,4,0,0,
29-oct-18,ZAC.,"FRESNILLO, ZAC.",0,0,0,9,0,0,
30-oct-18,ZAC.,"GUADALUPE, ZAC.",0,0,0,6,0,0,
01-nov-18,MEX.,"OCOYOACAC, MEX.",0,0,0,0,6,0,
02-nov-18,MEX.,"CHICONCUAC, MEX.",0,0,0,0,0,1250,
03-nov-18,MEX.,"XONACATLAN, MEX.",0,0,0,0,8,0,
05-nov-18,ZAC.,"GUADALUPE, ZAC.",0,0,0,8,0,2288,
06-nov-18,COAH.,"RAMOS ARIZPE, COAH.",0,0,0,1,0,11,
07-nov-18,COAH.,"RAMOS ARIZPE, COAH.",0,0,0,0,0,200,
09-nov-18,COAH.,"RAMOS ARIZPE, COAH.",0,0,0,4,0,0,
09-nov-18,COAH.,"PIEDRAS NEGRAS, COAH.",0,0,0,15,0,0,
10-nov-18,MEX.,"METEPEC, MEX.",0,0,0,0,0,3234,
10-nov-18,CHIH.,"JUÁREZ, CHIH.",0,0,0,17,0,821,
11-nov-18,CHIH.,"JUÁREZ, CHIH.",0,0,0,1,0,242,
12-nov-18,MEX.,"ALMOLOYA DE ALQUISIRAS, MEX.",0,0,0,0,17,0,
12-nov-18,CHIH.,"JUÁREZ, CHIH.",0,0,0,8,0,551,
12-nov-18,Q. ROO,"COZUMEL, Q. ROO",0,0,0,0,0,848,
13-nov-18,Q. ROO,"COZUMEL, Q. ROO",0,0,0,0,1,464,
14-nov-18,Q. ROO,"COZUMEL, Q. ROO",0,0,0,0,0,490,
15-nov-18,N.L.,"LOS ALDAMAS, N.L.",0,0,0,20,0,0,
15-nov-18,MEX.,"TEPETLAOXTOC, MEX.",0,0,0,0,0,560,
15-nov-18,MEX.,"CUAUTITLAN IZCALLI, MEX.",0,0,0,0,0,2057,
15-nov-18,Q. ROO,"COZUMEL, Q. ROO",0,0,0,0,1,517,
16-nov-18,Q. ROO,"COZUMEL, Q. ROO",0,0,0,0,0,1750,
17-nov-18,TAB.,"TENOSIQUE, TAB.",0,0,0,0,0,10,
19-nov-18,S.L.P.,"SAN LUIS POTOSI, S.L.P.",0,0,0,9,0,0,
21-nov-18,B.C.,"TIJUANA, B.C.",0,0,0,0,1,0,
22-nov-18,ZAC.,"GUADALUPE, ZAC.",0,0,0,10,0,0,
22-nov-18,N.L.,"LOS ALDAMAS, N.L.",0,0,0,20,0,0,
27-nov-18,D.F.,"IZTACALCO, D.F.",0,0,0,0,0,10000,
27-nov-18,ZAC.,"GUADALUPE, ZAC.",0,0,0,9,0,64,
29-nov-18,COAH.,"TORREÓN, COAH.",0,0,0,0,0,80,
30-nov-18,COAH.,"SALTILLO, COAH.",0,0,0,0,2,0,
11-dic-18,S.L.P.,"SAN LUIS POTOSI, S.L.P.",0,0,0,5,1,0,
13-dic-18,SIN.,"GUASAVE, SIN.",0,0,0,0,1,0,
19-dic-18,SIN.,"NAVOLATO, SIN.",0,0,0,0,3,0,
19-dic-18,SIN.,"BADIRAGUATO, SIN.",0,0,0,0,2,0,
23-ene-19,COAH.,"PIEDRAS NEGRAS, COAH.",0,0,0,0,0,78,
27-ene-19,HGO.,"APAN, HGO.",0,0,0,0,1,220,
29-ene-19,COAH.,"PIEDRAS NEGRAS, COAH.",0,0,0,0,0,100,
08-feb-19,CHIH.,"DELICIAS, CHIH.",0,0,0,0,0,77,
15-feb-19,CHIH.,"CUAUHTÉMOC, CHIH.",0,0,0,0,0,33,
18-feb-19,ZAC.,"FRESNILLO, ZAC.",0,0,0,1,0,1886,
20-feb-19,ZAC.,"FRESNILLO, ZAC.",0,0,0,0,0,2632,
21-feb-19,ZAC.,"GUADALUPE, ZAC.",0,0,0,0,0,2500,
25-feb-19,CHIH.,"CUAUHTÉMOC, CHIH.",0,0,0,1,0,0,
25-feb-19,COAH.,"SALTILLO, COAH.",0,0,0,2,0,41,
27-feb-19,DGO.,"GOMEZ PALACIO, DGO.",0,0,0,4,0,0,
27-feb-19,COAH.,"RAMOS ARIZPE, COAH.",0,0,0,2,0,0,
02-mar-19,COAH.,"PIEDRAS NEGRAS, COAH.",0,0,0,0,0,525,
04-mar-19,CHIS.,"SAN CRISTOBAL DE LAS CASAS, CHIS.",0,0,0,0,0,117,
04-mar-19,CHIS.,"TAPACHULA, CHIS.",0,0,0,0,0,1063,
05-mar-19,COAH.,"SALTILLO, COAH.",0,0,0,1,0,10,
05-mar-19,CHIS.,"SAN CRISTOBAL DE LAS CASAS, CHIS.",0,0,0,0,0,146,
06-mar-19,COAH.,"RAMOS ARIZPE, COAH.",0,0,0,1,0,25,
06-mar-19,COAH.,"PIEDRAS NEGRAS, COAH.",0,0,0,6,0,153,
08-mar-19,COAH.,"MATAMOROS, COAH.",0,0,0,0,0,10,
08-mar-19,COAH.,"PIEDRAS NEGRAS, COAH.",0,0,0,1,0,0,
09-mar-19,COAH.,"PIEDRAS NEGRAS, COAH.",0,0,0,3,0,286,
11-mar-19,CHIS.,"TAPACHULA, CHIS.",0,0,0,0,1,803,
11-mar-19,VER.,"PEROTE, VER.",0,0,0,0,0,65,
11-mar-19,ZAC.,"ZAC., ZAC.",0,0,0,0,1,26,
11-mar-19,COAH.,"MATAMOROS, COAH.",0,0,0,0,3,0,
11-mar-19,COAH.,"PIEDRAS NEGRAS, COAH.",0,0,0,0,0,55,
11-mar-19,DGO.,"GOMEZ PALACIO, DGO.",0,0,0,2,0,0,
12-mar-19,COAH.,"SAN PEDRO, COAH.",0,0,0,0,0,26,
12-mar-19,COAH.,"SALTILLO, COAH.",0,0,0,1,0,314,
12-mar-19,COAH.,"PIEDRAS NEGRAS, COAH.",0,0,0,2,0,819,
14-mar-19,COAH.,"PIEDRAS NEGRAS, COAH.",0,0,0,0,0,215,
14-mar-19,ZAC.,"GUADALUPE, ZAC.",0,0,0,3,0,154,
14-mar-19,ZAC.,"ZAC., ZAC.",0,0,0,0,0,1200,
14-mar-19,ZAC.,"FRESNILLO, ZAC.",0,0,0,0,0,3700,
15-mar-19,COAH.,"SALTILLO, COAH.",0,0,0,0,0,1,
15-mar-19,ZAC.,"GUADALUPE, ZAC.",0,0,0,11,0,191,
15-mar-19,DGO.,"GOMEZ PALACIO, DGO.",0,0,0,3,0,0,
17-mar-19,COAH.,"PIEDRAS NEGRAS, COAH.",0,0,0,10,0,0,
18-mar-19,S.L.P.,"CIUDAD VALLES, S.L.P.",0,0,0,4,0,0,
20-mar-19,Q. ROO.,"COZUMEL, Q. ROO",0,0,0,0,0,198,
20-mar-19,COAH.,"SALTILLO, COAH.",0,0,0,0,0,19,
21-mar-19,Q. ROO.,"COZUMEL, Q. ROO",0,0,0,0,1,263,
22-mar-19,Q. ROO.,"COZUMEL, Q. ROO",0,0,0,0,0,100,
22-mar-19,COAH.,"SALTILLO, COAH.",0,0,0,1,1,328,
22-mar-19,COAH.,"PIEDRAS NEGRAS, COAH.",0,0,0,0,0,507,
24-mar-19,S.L.P.,"SOLEDAD DE GRACIANO SANCHEZ, S.L.P.",0,0,0,4,0,0,
24-mar-19,TAB.,"TENOSIQUE, TAB.",0,0,0,0,1,0,
25-mar-19,S.L.P.,"SOLEDAD DE GRACIANO SANCHEZ, S.L.P.",0,0,0,4,0,0,
25-mar-19,COAH.,"SALTILLO, COAH.",0,0,0,1,0,2,
27-mar-19,ZAC.,"GUADALUPE, ZAC.",0,0,0,7,0,165,
27-mar-19,ZAC.,"ZAC., ZAC.",0,0,0,3,0,30,
27-mar-19,ZAC.,"FRESNILLO, ZAC.",0,0,0,0,0,2113,
27-mar-19,VER.,"COATZINTLA, VER.",0,0,0,0,0,179,
28-mar-19,S.L.P.,"SAN LUIS POTOSI, S.L.P.",0,0,0,0,0,124,
28-mar-19,ZAC.,"FRESNILLO, ZAC.",0,0,0,0,0,3110,
28-mar-19,COAH.,"SAN PEDRO, COAH.",0,0,0,0,0,14,
30-mar-19,COAH.,"PIEDRAS NEGRAS, COAH.",0,0,0,7,0,598,
30-mar-19,COAH.,"MONCLOVA, COAH.",0,0,0,0,1,0,
30-mar-19,TAB.,"TENOSIQUE, TAB.",0,0,0,0,1,0,
30-mar-19,VER.,"COATZINTLA, VER.",0,0,0,0,0,39,
01-abr-19,ZAC.,"GUADALUPE, ZAC.",0,0,0,5,0,200,
02-abr-19,Q. ROO.,"BENITO JUAREZ, Q. ROO",0,0,0,0,0,58,
02-abr-19,ZAC.,"FRESNILLO, ZAC.",0,0,0,3,0,9493,
02-abr-19,ZAC.,"GUADALUPE, ZAC.",0,0,0,5,0,0,
03-abr-19,ZAC.,"GUADALUPE, ZAC.",0,0,0,18,0,244,
03-abr-19,ZAC.,"ZAC., ZAC.",0,0,0,8,0,0,
03-abr-19,ZAC.,"FRESNILLO, ZAC.",0,0,0,0,0,4227,
03-abr-19,COAH.,"PIEDRAS NEGRAS, COAH.",0,0,0,10,0,495,
04-abr-19,COAH.,"RAMOS ARIZPE, COAH.",0,0,0,6,0,173,
04-abr-19,ZAC.,"FRESNILLO, ZAC.",0,0,0,2,0,2002,
04-abr-19,ZAC.,"GUADALUPE, ZAC.",0,0,0,4,0,0,
04-abr-19,ZAC.,"ZAC., ZAC.",0,0,0,0,0,4090,
05-abr-19,ZAC.,"ZAC., ZAC.",0,0,0,0,0,90,
05-abr-19,ZAC.,"GUADALUPE, ZAC.",0,0,0,21,0,28,
08-abr-19,S.L.P.,"SOLEDAD DE GRACIANO SANCHEZ, S.L.P.",0,0,0,5,0,0,
08-abr-19,Q. ROO.,"SOLIDARIDAD, Q. ROO",0,0,0,0,0,24,
09-abr-19,COAH.,"MONCLOVA, COAH.",0,0,0,0,1,0,
09-abr-19,ZAC.,"GUADALUPE, ZAC.",0,0,0,4,0,0,
09-abr-19,ZAC.,"FRESNILLO, ZAC.",0,0,0,0,0,5,
09-abr-19,S.L.P.,"SAN LUIS POTOSI, S.L.P.",0,0,0,9,0,0,
10-abr-19,COAH.,"SALTILLO, COAH.",0,0,0,0,0,23,
10-abr-19,COAH.,"PIEDRAS NEGRAS, COAH.",0,0,0,0,0,113,
11-abr-19,ZAC.,"ZAC., ZAC.",0,0,0,4,0,0,
11-abr-19,Q. ROO.,"BENITO JUAREZ, Q. ROO",0,0,0,0,0,940,
11-abr-19,COAH.,"RAMOS ARIZPE, COAH.",0,0,0,0,0,120,
12-abr-19,ZAC.,"ZAC., ZAC.",0,0,0,6,0,0,
12-abr-19,S.L.P.,"SAN LUIS POTOSI, S.L.P.",0,0,0,2,1,0,
13-abr-19,Q. ROO.,"BENITO JUAREZ, Q. ROO",0,0,0,0,0,290,
16-abr-19,COAH.,"PIEDRAS NEGRAS, COAH.",0,0,0,0,0,9,
19-abr-19,VER.,"TLAPACOYAN, VER.",0,0,0,0,0,212,
22-abr-19,COAH.,"FRANCISCO I. MADERO, COAH.",0,0,0,0,0,438,
23-abr-19,CD. MÉX.,"IZTAPALAPA, CD. MÉX.",0,0,0,0,3,18,
23-abr-19,COAH.,"SALTILLO, COAH.",0,0,0,0,0,38,
23-abr-19,VER.,"TANTOYUCA, VER.",0,0,0,0,1,0,
25-abr-19,VER.,"LAS VIGAS DE RAMIREZ, VER.",0,0,0,1,0,0,
25-abr-19,COAH.,"RAMOS ARIZPE, COAH.",0,0,0,0,0,45,
25-abr-19,COAH.,"MONCLOVA, COAH.",0,0,0,3,0,0,
25-abr-19,COAH.,"PIEDRAS NEGRAS, COAH.",0,0,0,0,0,12,
29-abr-19,COAH.,"SALTILLO, COAH.",0,0,0,41,0,0,
30-abr-19,COAH.,"RAMOS ARIZPE, COAH.",0,0,0,0,0,210,
02-may-19,VER.,"LAS VIGAS DE RAMIREZ, VER.",0,0,0,1,0,1,
02-may-19,COAH.,"SALTILLO, COAH.",0,0,0,0,0,331,
02-may-19,CD. MÉX.,"TLALPAN, CD. MÉX.",0,0,0,0,0,174,
07-may-19,COAH.,"SALTILLO, COAH.",0,0,0,0,0,236,
07-may-19,COAH.,"RAMOS ARIZPE, COAH.",0,0,0,1,0,94,
08-may-19,COAH.,"PIEDRAS NEGRAS, COAH.",0,0,0,0,0,42,
09-may-19,COAH.,"SALTILLO, COAH.",0,0,0,0,0,278,
10-may-19,COAH.,"SALTILLO, COAH.",0,0,0,4,0,250,
13-may-19,COAH.,"TORREÓN, COAH.",0,0,0,3,0,0,
13-may-19,COAH.,"SALTILLO, COAH.",0,0,0,170,0,0,
14-may-19,COAH.,"SALTILLO, COAH.",0,0,0,1,0,0,
14-may-19,COAH.,"RAMOS ARIZPE, COAH.",0,0,0,0,0,102,
14-may-19,COAH.,"PIEDRAS NEGRAS, COAH.",0,0,0,0,0,41,
15-may-19,ZAC.,"GUADALUPE, ZAC.",0,0,0,3,0,350,
15-may-19,COAH.,"SALTILLO, COAH.",0,0,0,0,0,150,
15-may-19,COAH.,"PIEDRAS NEGRAS, COAH.",0,0,0,8,0,0,
16-may-19,CD. MÉX.,"IZTAPALAPA, CD. MÉX.",0,0,0,3,30,0,
16-may-19,ZAC.,"ZAC., ZAC.",0,0,0,16,0,80,
17-may-19,ZAC.,"GUADALUPE, ZAC.",0,0,0,0,0,200,
20-may-19,ZAC.,"GUADALUPE, ZAC.",0,0,0,4,0,250,
20-may-19,ZAC.,"FRESNILLO, ZAC.",0,0,0,0,0,18,
23-may-19,ZAC.,"GUADALUPE, ZAC.",0,0,0,6,0,313,
24-may-19,ZAC.,"ZAC., ZAC.",0,0,0,0,0,26,
27-may-19,ZAC.,"GUADALUPE, ZAC.",0,0,0,3,0,300,
28-may-19,ZAC.,"GUADALUPE, ZAC.",0,0,0,2,0,2154,
28-may-19,CD. MÉX.,"MILPA ALTA, CD. MÉX.",0,0,0,0,0,16,
29-may-19,COAH.,"PIEDRAS NEGRAS, COAH.",0,0,0,5,0,86,
29-may-19,ZAC.,"GUADALUPE, ZAC.",0,0,0,0,0,1500,
29-may-19,VER.,"NOGALES, VER.",0,0,0,0,1,0,
31-may-19,ZAC.,"GUADALUPE, ZAC.",0,0,0,4,2,107,
03-jun-19,ZAC.,"GUADALUPE, ZAC.",0,0,0,3,0,309,
05-jun-19,COAH.,"PIEDRAS NEGRAS, COAH.",0,0,0,0,0,91,
05-jun-19,COAH.,"ACUÑA, COAH.",0,0,0,0,0,45,
06-jun-19,ZAC.,"GUADALUPE, ZAC.",0,0,0,1,0,19,
06-jun-19,MÉX.,"SAN MARTIN DE LAS PIRAMIDES, MEX.",0,0,0,0,7,878,
07-jun-19,COAH.,"RAMOS ARIZPE, COAH.",0,0,0,30,0,17,
07-jun-19,COAH.,"ACUÑA, COAH.",0,0,0,1,0,570,
10-jun-19,ZAC.,"ZAC., ZAC.",0,0,0,4,0,0,
10-jun-19,Q. ROO.,"OTHON P. BLANCO, Q. ROO",0,0,0,0,5,105,
11-jun-19,ZAC.,"ZAC., ZAC.",0,0,0,5,0,38,
12-jun-19,ZAC.,"GUADALUPE, ZAC.",0,0,0,0,0,160,
12-jun-19,ZAC.,"ZAC., ZAC.",0,0,0,0,0,82,
13-jun-19,ZAC.,"ZAC., ZAC.",0,0,0,0,0,106,
13-jun-19,COAH.,"SALTILLO, COAH.",0,0,0,0,2,13,
18-jun-19,Q. ROO.,"BENITO JUAREZ, Q. ROO",0,0,0,0,0,38,
19-jun-19,COAH.,"PIEDRAS NEGRAS, COAH.",0,0,0,0,0,28,
19-jun-19,VER.,"NAUTLA, VER.",0,0,0,1,0,28,
20-jun-19,ZAC.,"GUADALUPE, ZAC.",0,0,0,4,0,0,
20-jun-19,ZAC.,"ZAC., ZAC.",0,0,0,1,0,0,
24-jun-19,COAH.,"SALTILLO, COAH.",0,0,0,3,0,133,
27-jun-19,Q. ROO.,"BENITO JUAREZ, Q. ROO",0,0,0,0,0,50,
30-jun-19,ZAC.,"GUADALUPE, ZAC.",0,0,0,5,0,100,
30-jun-19,ZAC.,"FRESNILLO, ZAC.",0,0,0,1,0,0,
02-jul-19,COAH.,"MATAMOROS, COAH.",0,0,0,0,4,0,
02-jul-19,ZAC.,"GUADALUPE, ZAC.",0,0,0,7,0,295,
04-jul-19,ZAC.,"GUADALUPE, ZAC.",0,0,0,4,0,236,
04-jul-19,ZAC.,"ZAC., ZAC.",0,0,0,0,0,16,
08-jul-19,CD. MÉX.,"MILPA ALTA, CD. MÉX.",0,0,0,0,0,50,
08-jul-19,ZAC.,"GUADALUPE, ZAC.",0,0,0,3,0,248,
09-jul-19,ZAC.,"GUADALUPE, ZAC.",0,0,0,2,0,200,
11-jul-19,AGS.,"AGS., AGS.",0,0,0,1,0,0,
11-jul-19,CD. MÉX.,"MILPA ALTA, CD. MÉX.",0,0,0,0,0,150,
12-jul-19,ZAC.,"GUADALUPE, ZAC.",0,0,0,0,0,565,
14-jul-19,ZAC.,"FRESNILLO, ZAC.",0,0,0,0,0,83,
16-jul-19,ZAC.,"GUADALUPE, ZAC.",0,0,0,3,0,337,
16-jul-19,ZAC.,"FRESNILLO, ZAC.",0,0,0,2,0,0,
17-jul-19,ZAC.,"ZAC., ZAC.",0,0,0,3,0,0,
17-jul-19,CD. MÉX.,"TLAHUAC, CD. MÉX.",0,0,0,0,0,8,
18-jul-19,ZAC.,"ZAC., ZAC.",0,0,0,0,0,354,
19-jul-19,ZAC.,"GUADALUPE, ZAC.",0,0,0,6,0,160,
19-jul-19,VER.,"COATZINTLA, VER.",0,0,0,0,0,228,
19-jul-19,AGS.,"AGS., AGS.",0,0,0,1,0,0,
22-jul-19,CHIH.,"IGNACIO ZARAGOZA, CHIH.",0,0,0,0,0,49,
22-jul-19,VER.,"COATZINTLA, VER.",0,0,0,0,1,0,
23-jul-19,COAH.,"SALTILLO, COAH.",0,0,0,0,1,0,
25-jul-19,CD. MÉX.,"CUAJIMALPA DE MOR., CD. MÉX.",0,0,0,0,0,546,
29-jul-19,VER.,"SAYULA DE ALEMAN, VER.",0,0,0,0,0,7,
30-jul-19,COAH.,"TORREÓN, COAH.",0,0,0,8,0,0,
01-ago-19,VER.,"MISANTLA, VER.",0,0,0,0,0,62,
02-ago-19,COAH.,"SALTILLO, COAH.",0,0,0,1,0,914,
05-ago-19,COAH.,"MATAMOROS, COAH.",0,0,0,0,0,5,
05-ago-19,COAH.,"FRANCISCO I. MADERO, COAH.",0,0,0,0,0,4,
05-ago-19,VER.,"IXTACZOQUITLAN, VER.",0,0,0,0,0,50,
06-ago-19,MOR.,"CUERNAVACA, MOR.",0,0,0,4,0,3730,
06-ago-19,MÉX.,"SAN MARTIN DE LAS PIRAMIDES, MEX.",0,0,0,0,7,878,
07-ago-19,CD. MÉX.,"IZTAPALAPA, CD. MÉX.",0,0,0,0,0,91,
09-ago-19,MÉX.,"SAN MARTIN DE LAS PIRAMIDES, MEX.",0,0,0,0,17,63,
09-ago-19,COAH.,"ACUÑA, COAH.",0,0,0,0,0,118,
12-ago-19,ZAC.,"GUADALUPE, ZAC.",0,0,0,4,0,110,
12-ago-19,CD. MÉX.,"GUSTAVO A. MADERO, CD. MÉX.",0,0,0,0,0,38,
14-ago-19,ZAC.,"GUADALUPE, ZAC.",0,0,0,3,0,107,
15-ago-19,ZAC.,"GUADALUPE, ZAC.",0,0,0,8,0,100,
16-ago-19,ZAC.,"ZAC., ZAC.",0,0,0,1,0,0,
19-ago-19,ZAC.,"GUADALUPE, ZAC.",0,0,0,0,0,83,
19-ago-19,CD. MÉX.,"GUSTAVO A. MADERO, CD. MÉX.",0,0,0,0,0,6,
20-ago-19,ZAC.,"GUADALUPE, ZAC.",0,0,0,7,0,244,
20-ago-19,ZAC.,"ZAC., ZAC.",0,0,0,3,0,410,
21-ago-19,ZAC.,"GUADALUPE, ZAC.",0,0,0,3,0,415,
21-ago-19,COAH.,"SALTILLO, COAH.",0,0,0,0,0,222,
21-ago-19,MOR.,"TEPOZTLAN, MOR.",0,0,0,7,0,327,
22-ago-19,ZAC.,"GUADALUPE, ZAC.",0,0,0,16,0,365,
22-ago-19,MOR.,"TEPOZTLAN, MOR.",0,0,0,21,1,443,
23-ago-19,ZAC.,"GUADALUPE, ZAC.",0,0,0,8,0,473,
23-ago-19,ZAC.,"FRESNILLO, ZAC.",0,0,0,0,0,4,
23-ago-19,S.L.P.,"CIUDAD VALLES, S.L.P.",0,0,0,5,0,0,
26-ago-19,CD. MÉX.,"TLALPAN, CD. MÉX.",0,0,0,0,0,25,
26-ago-19,ZAC.,"GUADALUPE, ZAC.",0,0,0,12,0,240,
27-ago-19,ZAC.,"GUADALUPE, ZAC.",0,0,0,9,0,50,
27-ago-19,AGS.,"CALVILLO, AGS.",0,0,0,3,0,238,
28-ago-19,TAMPS.,"REYNOSA, TAMPS.",0,0,0,13,0,793,
28-ago-19,ZAC.,"GUADALUPE, ZAC.",0,0,0,5,0,0,
28-ago-19,MÉX.,"JUCHITEPEC, MEX.",0,0,0,0,0,24,
28-ago-19,S.L.P.,"SAN LUIS POTOSI, S.L.P.",0,0,0,0,0,28,
29-ago-19,ZAC.,"GUADALUPE, ZAC.",0,0,0,5,0,100,
29-ago-19,ZAC.,"ZAC., ZAC.",0,0,0,2,0,0,
29-ago-19,AGS.,"CALVILLO, AGS.",0,0,0,10,0,0,
30-ago-19,CD. MÉX.,"TLALPAN, CD. MÉX.",0,0,0,0,0,11,
30-ago-19,MOR.,"CUERNAVACA, MOR.",0,0,0,6,1,24,
30-ago-19,ZAC.,"GUADALUPE, ZAC.",0,0,0,7,0,0,
30-ago-19,MÉX.,"TLALNEPANTLA DE BAZ, MEX.",0,0,0,0,0,33,
30-ago-19,ZAC.,"ZAC., ZAC.",0,0,0,0,0,5,
30-ago-19,MÉX.,"JUCHITEPEC, MEX.",0,0,0,0,10,0,
31-ago-19,MÉX.,"JUCHITEPEC, MEX.",0,0,0,0,10,0,
01-sep-19,S.L.P.,"SAN LUIS POTOSI, S.L.P.",0,0,0,0,0,19,
02-sep-19,MOR.,"CUERNAVACA, MOR.",0,0,0,3,0,791,
03-sep-19,ZAC.,"GUADALUPE, ZAC.",0,0,0,0,0,515,
03-sep-19,MOR.,"CUERNAVACA, MOR.",0,0,0,0,2,168,
04-sep-19,CD. MÉX.,"TLALPAN, CD. MÉX.",0,0,0,0,0,634,
05-sep-19,COAH.,"SALTILLO, COAH.",0,0,0,0,0,121,
05-sep-19,MOR.,"CUERNAVACA, MOR.",0,0,0,14,2,17,
05-sep-19,MÉX.,"TEMAMATLA, MEX.",0,0,0,0,0,50,
05-sep-19,S.L.P.,"CIUDAD VALLES, S.L.P.",0,0,0,0,3,0,
06-sep-19,TAMPS.,"VICTORIA, TAMPS.",0,0,0,0,7,0,
06-sep-19,TAMPS.,"REYNOSA, TAMPS.",0,0,0,4,0,85,
06-sep-19,MOR.,"CUERNAVACA, MOR.",0,0,0,10,3,168,
06-sep-19,MÉX.,"TEMAMATLA, MEX.",0,0,0,0,1,0,
10-sep-19,S.L.P.,"SOLEDAD DE GRACIANO SANCHEZ, S.L.P.",0,0,0,9,2,0,
10-sep-19,S.L.P.,"CIUDAD VALLES, S.L.P.",0,0,0,0,1,0,
12-sep-19,TAMPS.,"TAMPICO, TAMPS.",0,0,0,0,0,58,
17-sep-19,TAMPS.,"VICTORIA, TAMPS.",0,0,0,2,0,12,
17-sep-19,CD. MÉX.,"IZTAPALAPA, CD. MÉX.",0,0,0,0,0,17,
18-sep-19,TAMPS.,"VICTORIA, TAMPS.",0,0,0,0,0,500,
18-sep-19,TAMPS.,"MATAMOROS, TAMPS.",0,0,0,2,0,0,
19-sep-19,CD. MÉX.,"IZTAPALAPA, CD. MÉX.",0,0,0,0,0,2152,
19-sep-19,CD. MÉX.,"LA MAGDALENA CONTRERAS, CD. MÉX.",0,0,0,0,0,22,
19-sep-19,MOR.,"CUERNAVACA, MOR.",0,0,0,0,11,120,
19-sep-19,MÉX.,"CHICOLOAPAN, MEX.",0,0,0,0,1,20,
23-sep-19,CHIS.,"SAN CRISTOBAL DE LAS CASAS, CHIS.",0,0,0,0,1,0,
24-sep-19,MÉX.,"HUEHUETOCA, MEX.",0,0,0,0,0,603,
24-sep-19,CHIS.,"COMITAN DE DOMÍNGUEZ, CHIS.",0,0,0,3,0,40,
24-sep-19,MOR.,"EMILIANO ZAPATA, MOR.",0,0,0,0,0,26,
24-sep-19,CHIS.,"SAN CRISTOBAL DE LAS CASAS, CHIS.",0,0,0,0,0,382,
25-sep-19,CHIS.,"SAN CRISTOBAL DE LAS CASAS, CHIS.",0,0,0,0,0,160,
25-sep-19,MOR.,"EMILIANO ZAPATA, MOR.",0,0,0,2,1,254,
26-sep-19,MÉX.,"IXTAPAN DE LA SAL, MEX.",0,0,0,89,0,0,
26-sep-19,CHIS.,"COMITAN DE DOMÍNGUEZ, CHIS.",0,0,0,0,0,96,
26-sep-19,TAMPS.,"REYNOSA, TAMPS.",0,0,0,1,0,23,
26-sep-19,MOR.,"EMILIANO ZAPATA, MOR.",0,0,0,8,0,195,
27-sep-19,Q. ROO.,"BENITO JUAREZ, Q. ROO",0,0,0,0,0,200,
27-sep-19,MOR.,"EMILIANO ZAPATA, MOR.",0,0,0,0,0,90,
27-sep-19,CHIS.,"COMITAN DE DOMÍNGUEZ, CHIS.",0,0,0,0,1,100,
29-sep-19,CHIS.,"TAPACHULA, CHIS.",0,0,0,0,0,212,
30-sep-19,CHIS.,"TAPACHULA, CHIS.",0,0,0,0,0,199,
30-sep-19,CD. MÉX.,"TLALPAN, CD. MÉX.",0,0,0,0,0,19,
01-oct-19,TAMPS.,"MATAMOROS, TAMPS.",0,0,0,0,0,219,
03-oct-19,CHIS.,"LAS MARGARITAS, CHIS.",0,0,0,10,0,403,
04-oct-19,TAMPS.,"REYNOSA, TAMPS.",0,0,0,0,0,60,
05-oct-19,CHIS.,"LAS MARGARITAS, CHIS.",0,0,0,1,0,243,
07-oct-19,Q. ROO.,"COZUMEL, Q. ROO",0,0,0,0,0,117,
09-oct-19,COAH.,"MONCLOVA, COAH.",0,0,0,10,0,728,
09-oct-19,Q. ROO.,"COZUMEL, Q. ROO",0,0,0,0,1,527,
09-oct-19,MOR.,"EMILIANO ZAPATA, MOR.",0,0,0,24,0,611,
10-oct-19,Q. ROO.,"COZUMEL, Q. ROO",0,0,0,0,1,306,
10-oct-19,CD. MÉX.,"IZTACALCO, CD. MÉX.",0,0,0,0,0,48,
11-oct-19,ZAC.,"GUADALUPE, ZAC.",0,0,0,13,0,399,
11-oct-19,Q. ROO.,"COZUMEL, Q. ROO",0,0,0,0,9,289,
14-oct-19,CHIS.,"COMITAN DE DOMÍNGUEZ, CHIS.",0,0,0,0,0,100,
14-oct-19,ZAC.,"GUADALUPE, ZAC.",0,0,0,13,0,60,
15-oct-19,COAH.,"SALTILLO, COAH.",0,0,0,0,0,130,
15-oct-19,MÉX.,"TENANGO DEL AIRE, MEX.",0,0,0,0,0,10,
16-oct-19,COAH.,"SALTILLO, COAH.",0,0,0,111,2,2,
16-oct-19,COAH.,"RAMOS ARIZPE, COAH.",0,0,0,0,0,481,
17-oct-19,CHIH.,"CASAS GRANDES, CHIH.",0,0,0,0,0,175,
17-oct-19,ZAC.,"GUADALUPE, ZAC.",0,0,0,3,0,0,
17-oct-19,MOR.,"EMILIANO ZAPATA, MOR.",0,0,0,1,0,0,
18-oct-19,CHIS.,"EMILIANO ZAPATA, CHIS.",0,0,0,0,0,243,
21-oct-19,ZAC.,"GUADALUPE, ZAC.",0,0,0,4,0,394,
21-oct-19,ZAC.,"ZAC., ZAC.",0,0,0,2,0,36,
23-oct-19,CHIS.,"COMITAN DE DOMÍNGUEZ, CHIS.",0,0,0,0,0,115,
23-oct-19,MÉX.,"IXTAPALUCA, MEX.",0,0,0,0,1,146,
23-oct-19,CHIS.,"JIQUIPILAS, CHIS.",0,0,0,0,0,30,
23-oct-19,MOR.,"EMILIANO ZAPATA, MOR.",0,0,0,5,0,300,
24-oct-19,MÉX.,"CALIMAYA, MEX.",0,0,0,0,0,66,
24-oct-19,CD. MÉX.,"CUAJIMALPA DE MOR., CD. MÉX.",0,0,0,0,1,112,
24-oct-19,MOR.,"EMILIANO ZAPATA, MOR.",0,0,0,5,0,300,
25-oct-19,ZAC.,"GUADALUPE, ZAC.",0,0,0,4,0,0,
26-oct-19,CHIS.,"LA INDEPENDENCIA, CHIS.",0,0,0,0,0,169,
28-oct-19,CHIS.,"CINTALAPA, CHIS.",0,0,0,0,1,390,
28-oct-19,CHIS.,"LA INDEPENDENCIA, CHIS.",0,0,0,3,0,200,
29-oct-19,ZAC.,"GUADALUPE, ZAC.",0,0,0,2,0,0,
30-oct-19,CHIS.,"CHIAPILLA, CHIS.",0,0,0,2,0,0,
31-oct-19,CHIS.,"LA INDEPENDENCIA, CHIS.",0,0,0,1,0,50,
31-oct-19,CD. MÉX.,"IZTAPALAPA, CD. MÉX.",0,0,0,0,0,796,
04-nov-19,CD. MÉX.,"TLAHUAC, CD. MÉX.",0,0,0,0,0,25,
04-nov-19,ZAC.,"GUADALUPE, ZAC.",0,0,0,8,0,29,
05-nov-19,ZAC.,"GUADALUPE, ZAC.",0,0,0,0,0,155,
05-nov-19,ZAC.,"FRESNILLO, ZAC.",0,0,0,6,0,319,
06-nov-19,ZAC.,"FRESNILLO, ZAC.",0,0,0,4,0,0,
07-nov-19,ZAC.,"FRESNILLO, ZAC.",0,0,0,6,0,0,
08-nov-19,MÉX.,"SAN MATEO ATENCO, MEX.",0,0,0,0,0,338,
08-nov-19,ZAC.,"GUADALUPE, ZAC.",0,0,0,2,0,0,
11-nov-19,MÉX.,"JOCOTITLAN, MEX.",0,0,0,0,0,40,
13-nov-19,CHIS.,"CHILÓN, CHIS.",0,0,0,0,0,100,
14-nov-19,CHIS.,"COMITAN DE DOMÍNGUEZ, CHIS.",0,0,0,0,1,29,
15-nov-19,CHIS.,"COMITAN DE DOMÍNGUEZ, CHIS.",0,0,0,2,0,60,
16-nov-19,CHIS.,"CINTALAPA, CHIS.",0,0,0,0,0,79,
16-nov-19,CHIS.,"SUCHIATE, CHIS.",0,0,0,0,0,165,
17-nov-19,CHIS.,"CINTALAPA, CHIS.",0,0,0,1,0,82,
17-nov-19,CHIS.,"TUXTLA GUTIÉRREZ, CHIS.",0,0,0,0,1,8,
19-nov-19,CD. MÉX.,"COYOACAN, CD. MÉX.",0,0,0,0,0,58,
19-nov-19,MÉX.,"TEPETLAOXTOC, MEX.",0,0,0,0,7,0,
20-nov-19,MOR.,"JIUTEPEC, MOR.",0,0,0,92,1,151,
22-nov-19,COAH.,"SALTILLO, COAH.",0,0,0,3,0,3,
25-nov-19,MOR.,"JIUTEPEC, MOR.",0,0,0,0,10,261,
27-nov-19,VER.,"PEROTE, VER.",0,0,0,7,0,0,
28-nov-19,VER.,"PEROTE, VER.",0,0,0,7,0,0,
28-nov-19,ZAC.,"FRESNILLO, ZAC.",0,0,0,2,0,0,
29-nov-19,HGO.,"APAN, HGO.",0,0,0,1,1,0,
30-nov-19,S.L.P.,"CIUDAD VALLES, S.L.P.",0,0,0,4,0,0,
30-nov-19,HGO.,"APAN, HGO.",0,0,0,3,1,0,
02-dic-19,ZAC.,"ZAC., ZAC.",0,0,0,3,0,8,
04-dic-19,ZAC.,"FRESNILLO, ZAC.",0,0,0,0,0,76,
04-dic-19,S.L.P.,"TAMAZUNCHALE, S.L.P.",0,0,0,0,1,0,
04-dic-19,S.L.P.,"SAN LUIS POTOSI, S.L.P.",0,0,0,0,0,163,
04-dic-19,MOR.,"JIUTEPEC, MOR.",0,0,0,66,0,0,
05-dic-19,ZAC.,"ZAC., ZAC.",0,0,0,1,0,206,
06-dic-19,COAH.,"SALTILLO, COAH.",0,0,0,0,0,12,
06-dic-19,COAH.,"RAMOS ARIZPE, COAH.",0,0,0,0,0,225,
06-dic-19,S.L.P.,"SAN LUIS POTOSI, S.L.P.",0,0,0,20,0,0,
10-dic-19,ZAC.,"ZAC., ZAC.",0,0,0,5,0,0,
10-dic-19,ZAC.,"FRESNILLO, ZAC.",0,0,0,0,0,13,
10-dic-19,S.L.P.,"SAN LUIS POTOSI, S.L.P.",0,0,0,15,7,0,
11-dic-19,S.L.P.,"CIUDAD VALLES, S.L.P.",0,0,0,4,0,0,
11-dic-19,N.L.,"APODACA, N.L.",0,0,0,3,0,0,
11-dic-19,B.C.,"MEXICALI, B.C.",0,0,0,0,1,0,
17-dic-19,S.L.P.,"CIUDAD VALLES, S.L.P.",0,0,0,2,0,0,
24-dic-19,S.L.P.,"SAN LUIS POTOSI, S.L.P.",0,0,0,15,7,0,
16-ene-20,CHIS.,"TONALÁ, CHIS.",0,0,0,0,0,34,
16-ene-20,CHIS.,"TAPACHULA, CHIS.",0,0,0,0,0,100,
16-ene-20,TAB.,"CENTRO, TAB.",0,0,0,0,0,60,
17-ene-20,CHIS.,"TAPACHULA, CHIS.",0,0,0,0,0,100,
17-ene-20,ZAC.,"ZAC., ZAC.",0,0,0,1,0,18,
20-ene-20,ZAC.,"GUADALUPE, ZAC.",0,0,0,3,0,0,
20-ene-20,ZAC.,"FRESNILLO, ZAC.",0,0,0,2,0,1,
21-ene-20,CHIS.,"TAPACHULA, CHIS.",0,0,0,0,1,60,
23-ene-20,ZAC.,"ZAC., ZAC.",0,0,0,0,2,0,
27-ene-20,ZAC.,"GUADALUPE, ZAC.",0,0,0,10,0,700,
28-ene-20,CD. MÉX.,"MILPA ALTA, CD. MÉX.",0,0,0,0,0,32,
28-ene-20,TAB.,"CARDENAS, TAB.",0,0,0,0,0,133,
30-ene-20,ZAC.,"GUADALUPE, ZAC.",0,0,0,15,0,450,
04-feb-20,ZAC.,"ZAC., ZAC.",0,0,0,5,0,0,
04-feb-20,COAH.,"SABINAS, COAH.",0,0,0,40,0,0,
05-feb-20,ZAC.,"GUADALUPE, ZAC.",0,0,0,4,0,150,
05-feb-20,ZAC.,"GUADALUPE, ZAC.",0,0,0,3,0,13,
05-feb-20,ZAC.,"FRESNILLO, ZAC.",0,0,0,13,0,2,
06-feb-20,ZAC.,"GUADALUPE, ZAC.",0,0,0,2,0,100,
13-feb-20,CD. MÉX.,"TLALPAN, CD. MÉX.",0,0,0,0,0,49,
18-feb-20,ZAC.,"GUADALUPE, ZAC.",0,0,0,3,0,400,
19-feb-20,CD. MÉX.,"TLALPAN, CD. MÉX.",0,0,0,0,0,261,
20-feb-20,TAB.,"MACUSPANA, TAB.",0,0,0,0,0,20,
21-feb-20,ZAC.,"ZAC., ZAC.",0,0,0,7,0,88,
21-feb-20,NAY.,"TEPIC, NAY.",0,0,0,0,174,0,
24-feb-20,ZAC.,"GUADALUPE, ZAC.",0,0,0,1,0,103,
25-feb-20,COAH.,"MÚZQUIZ, COAH.",0,0,0,7,0,0,
25-feb-20,CHIS.,"SAN CRISTOBAL DE LAS CASAS, CHIS.",0,0,0,3,0,225,
26-feb-20,ZAC.,"FRESNILLO, ZAC.",0,0,0,1,0,0,
26-feb-20,SIN.,"BADIRAGUATO, SIN.",0,0,0,0,12,0,
27-feb-20,ZAC.,"FRESNILLO, ZAC.",0,0,0,1,0,0,
27-feb-20,CD. MÉX.,"XOCHIMILCO, CD. MÉX.",0,0,0,0,0,396,
28-feb-20,ZAC.,"ZAC., ZAC.",0,0,0,0,0,44,
28-feb-20,COAH.,"FRANCISCO I. MADERO, COAH.",0,0,0,0,1,0,
29-feb-20,CHIS.,"SAN CRISTOBAL DE LAS CASAS, CHIS.",0,0,0,0,0,981,
29-feb-20,SIN.,"CULIACAN, SIN.",0,0,0,0,0,1,
02-mar-20,CD. MÉX.,"XOCHIMILCO, CD. MÉX.",0,0,0,0,0,250,
03-mar-20,COAH.,"MATAMOROS, COAH.",0,0,0,4,0,0,
03-mar-20,COAH.,"PIEDRAS NEGRAS, COAH.",0,0,0,0,0,50,
03-mar-20,COAH.,"MÚZQUIZ, COAH.",0,0,0,16,0,0,
04-mar-20,COAH.,"PIEDRAS NEGRAS, COAH.",0,0,0,1,0,0,
06-mar-20,ZAC.,"ZAC., ZAC.",0,0,0,0,0,9,
08-mar-20,VER.,"COATZACOALCOS, VER.",0,0,0,4,0,34,
10-mar-20,CHIH.,"CASAS GRANDES, CHIH.",0,0,0,0,0,49,
11-mar-20,SIN.,"CULIACAN, SIN.",0,0,0,0,1,0,
11-mar-20,CD. MÉX.,"MIGUEL HGO., CD. MÉX.",0,0,0,0,0,6,
12-mar-20,COAH.,"PIEDRAS NEGRAS, COAH.",0,0,0,0,0,159,
13-mar-20,VER.,"XALAPA, VER.",0,0,0,0,0,184,
15-mar-20,VER.,"XALAPA, VER.",0,0,0,26,0,187,
15-mar-20,VER.,"VER., VER.",0,0,0,0,0,397,
16-mar-20,VER.,"COATZACOALCOS, VER.",0,0,0,2,0,301,
17-mar-20,CHIH.,"NUEVO CASAS GRANDES, CHIH.",0,0,0,0,0,428,
20-mar-20,VER.,"VER., VER.",0,0,0,22,0,18920,
20-mar-20,S.L.P.,"TAMAZUNCHALE, S.L.P.",0,0,0,0,0,72,
21-mar-20,S.L.P.,"MATEHUALA, S.L.P.",0,0,0,0,0,30,
24-mar-20,S.L.P.,"CIUDAD VALLES, S.L.P.",0,0,0,0,0,150,
09-jul-20,CD. MÉX.,"CUAUHTEMOC, CD. MÉX.",0,0,0,0,1,0,
20-jul-20,CD. MÉX.,"CUAUHTEMOC, CD. MÉX.",0,0,0,0,1,0,
24-jul-20,CD. MÉX.,"CUAUHTEMOC, CD. MÉX.",0,0,0,0,0,1376,
03-ago-20,CD. MÉX.,"CUAUHTEMOC, CD. MÉX.",0,0,0,0,0,2000,
05-ago-20,CD. MÉX.,"GUSTAVO A. MADERO, CD. MÉX.",0,0,0,0,0,35,
12-ago-20,CD. MÉX.,"GUSTAVO A. MADERO, CD. MÉX.",0,0,0,0,0,10,
25-ago-20,CD. MÉX.,"CUAUHTEMOC, CD. MÉX.",0,0,0,0,1,48,
02-sep-20,CD. MÉX.,"CUAUHTEMOC, CD. MÉX.",0,0,0,0,0,64,
03-sep-20,CD. MÉX.,"CUAUHTEMOC, CD. MÉX.",0,0,0,0,0,11,
07-sep-20,CD. MÉX.,"GUSTAVO A. MADERO, CD. MÉX.",0,0,0,0,0,32,
24-sep-20,VER.,"CORDOBA, VER.",0,0,0,0,1,1270,
09-oct-20,CD. MÉX.,"GUSTAVO A. MADERO, CD. MÉX.",0,0,0,0,0,198,
03-nov-20,VER.,"COATEPEC, VER.",0,0,0,7,0,75,
08-nov-20,VER.,"VEGA DE ALATORRE, VER.",0,0,0,0,0,5414,
08-nov-20,VER.,"COATEPEC, VER.",0,0,0,0,0,7257,
10-nov-20,VER.,"VEGA DE ALATORRE, VER.",0,0,0,0,0,101,
10-nov-20,VER.,"COATEPEC, VER.",0,0,0,19,0,9824,
11-nov-20,VER.,"VEGA DE ALATORRE, VER.",0,0,0,18,0,6206,
13-nov-20,VER.,"VEGA DE ALATORRE, VER.",0,0,0,0,0,584,
20-nov-20,CD. MÉX.,"GUSTAVO A. MADERO, CD. MÉX.",0,0,0,0,0,100,
20-nov-20,CD. MÉX.,"CUAUHTEMOC, CD. MÉX.",0,0,0,0,0,85,
25-nov-20,CD. MÉX.,"BENITO JUAREZ, CD. MÉX.",0,0,0,0,0,43,
25-nov-20,CD. MÉX.,"GUSTAVO A. MADERO, CD. MÉX.",0,0,0,0,0,603,
02-dic-20,CD. MÉX.,"BENITO JUAREZ, CD. MÉX.",0,0,0,0,0,101,
09-dic-20,CD. MÉX.,"VENUSTIANO CARRANZA, CD. MÉX.",0,0,0,0,0,6,
10-dic-20,CD. MÉX.,"CUAUHTEMOC, CD. MÉX.",0,0,0,0,0,88,
15-dic-20,CD. MÉX.,"CUAUHTEMOC, CD. MÉX.",0,0,0,0,0,600,
17-dic-20,CD. MÉX.,"VENUSTIANO CARRANZA, CD. MÉX.",0,0,0,0,0,161,
25-feb-21,CHIS.,"ALDAMA, CHIS.",0,0,0,0,2,0,
18-jun-21,CD. MÉX.,"IZTAPALAPA, CD. MÉX.",0,0,0,0,0,52,
09-jul-21,VER.,"POZA RICA DE HGO., VER.",0,0,0,2,1,5100,
11-jul-21,VER.,"MINATITLAN, VER.",0,0,0,1,0,70,
11-jul-21,VER.,"MARTINEZ DE LA TORRE, VER.",0,0,0,0,0,112,
12-jul-21,COAH.,"SABINAS, COAH.",0,0,0,0,1,8,
13-jul-21,VER.,"MINATITLAN, VER.",0,0,0,0,1,0,
13-jul-21,VER.,"MARTINEZ DE LA TORRE, VER.",0,0,0,4,0,58,
14-jul-21,VER.,"MINATITLAN, VER.",0,0,0,4,0,253,
15-jul-21,COAH.,"ACUÑA, COAH.",0,0,0,1,0,0,
15-jul-21,VER.,"MARTINEZ DE LA TORRE, VER.",0,0,0,0,0,150,
16-jul-21,COAH.,"ACUÑA, COAH.",0,0,0,0,0,24,
17-jul-21,VER.,"POZA RICA DE HGO., VER.",0,0,0,0,0,14520,
17-jul-21,VER.,"MARTINEZ DE LA TORRE, VER.",0,0,0,0,0,425,
18-jul-21,VER.,"MARTINEZ DE LA TORRE, VER.",0,0,0,1,0,664,
18-jul-21,VER.,"MINATITLAN, VER.",0,0,0,0,0,320,
19-jul-21,COAH.,"SALTILLO, COAH.",0,0,0,25,0,0,
19-jul-21,VER.,"MINATITLAN, VER.",0,0,0,0,0,368,
20-jul-21,COAH.,"ACUÑA, COAH.",0,0,0,0,0,94,
20-jul-21,COAH.,"MATAMOROS, COAH.",0,0,0,17,0,0,
21-jul-21,COAH.,"SALTILLO, COAH.",0,0,0,0,3,0,
21-jul-21,COAH.,"ACUÑA, COAH.",0,0,0,0,0,125,
22-jul-21,VER.,"MARTINEZ DE LA TORRE, VER.",0,0,0,0,0,382,
23-jul-21,VER.,"MARTINEZ DE LA TORRE, VER.",0,0,0,1,0,0,
15-sep-21,B.C.,"SAN QUINTÍN, B.C.",0,0,0,0,0,20,
27-sep-21,CHIH.,"CUAUHTÉMOC, CHIH.",0,0,0,1,1,427,
30-sep-21,CHIH.,"HGO. DEL PARRAL, CHIH.",0,0,0,0,0,422,
08-oct-21,B.C.,"SAN QUINTÍN, B.C.",0,0,0,2,0,150,
20-oct-21,CD. MÉX.,"BENITO JUAREZ, CD. MÉX.",0,0,0,0,0,127,
25-oct-21,CD. MÉX.,"BENITO JUAREZ, CD. MÉX.",0,0,0,0,0,37,
10-nov-21,CD. MÉX.,"COYOACAN, CD. MÉX.",0,0,0,0,0,8,
18-nov-21,VER.,"NOGALES, VER.",0,0,0,13,0,52,
19-nov-21,B.C.,"SAN FELIPE, B.C.",0,0,0,0,0,165,
20-nov-21,VER.,"SAYULA DE ALEMAN, VER.",0,0,0,0,0,9427,
22-nov-21,VER.,"ALAMO, VER.",0,0,0,0,0,9,
23-nov-21,VER.,"SAYULA DE ALEMAN, VER.",0,0,0,0,0,1536,
24-nov-21,VER.,"SAYULA DE ALEMAN, VER.",0,0,0,0,0,1260,
24-nov-21,VER.,"NOGALES, VER.",0,0,0,0,0,1066,
24-nov-21,CD. MÉX.,"ALVARO OBREGON, CD. MÉX.",0,0,0,0,0,174,
25-nov-21,VER.,"SAYULA DE ALEMAN, VER.",0,0,0,0,0,613,
26-nov-21,CD. MÉX.,"ALVARO OBREGON, CD. MÉX.",0,0,0,0,0,49,
26-nov-21,VER.,"SAYULA DE ALEMAN, VER.",0,0,0,0,0,5441,
27-nov-21,B.C.,"SAN FELIPE, B.C.",0,0,0,1,0,97,
27-nov-21,B.C.,"SAN FELIPE, B.C.",0,0,0,0,0,200,
29-nov-21,CD. MÉX.,"CUAJIMALPA DE MOR., CD. MÉX.",0,0,0,0,1,0,
29-nov-21,CHIS.,"BENEMÉRITO DE LAS AMÉRICAS, CHIS.",0,0,0,0,0,12,
30-nov-21,CHIS.,"SAN FERNANDO, CHIS.",0,0,0,0,1,545,
01-dic-21,CHIS.,"PALENQUE, CHIS.",0,0,0,0,0,40,
02-dic-21,SON.,"AGUA PRIETA, SON.",0,0,0,90,0,0,
05-dic-21,CHIS.,"TAPACHULA, CHIS.",0,0,0,0,0,73,
05-dic-21,CHIH.,"CHIH., CHIH.",0,0,0,0,0,210,
06-dic-21,CHIS.,"TUXTLA GUTIÉRREZ, CHIS.",0,0,0,0,0,109,
07-dic-21,CHIS.,"CHIAPA DE CORZO, CHIS.",0,0,0,0,0,111,
08-dic-21,CD. MÉX.,"AZCAPOTZALCO, CD. MÉX.",0,0,0,0,0,45,
08-dic-21,OAX.,"OAX. DE JUAREZ, OAX.",0,0,0,0,0,192,
09-dic-21,CD. MÉX.,"IZTAPALAPA, CD. MÉX.",0,0,0,0,0,291,
09-dic-21,CHIS.,"COMITAN DE DOMÍNGUEZ, CHIS.",0,0,0,0,0,305,
10-dic-21,CHIS.,"TUXTLA GUTIÉRREZ, CHIS.",0,0,0,0,0,50,
10-dic-21,SON.,"HERMOSILLO, SON.",0,0,0,0,1,32,
11-dic-21,CHIS.,"BENEMÉRITO DE LAS AMÉRICAS, CHIS.",0,0,0,0,0,10,
11-dic-21,CHIS.,"OCOSINGO, CHIS.",0,0,0,0,0,71,
12-dic-21,CHIS.,"TUXTLA GUTIÉRREZ, CHIS.",0,0,0,0,0,241,
12-dic-21,CHIH.,"CHIH., CHIH.",0,0,0,0,0,445,
12-dic-21,CHIS.,"OCOSINGO, CHIS.",0,0,0,0,0,105,
13-dic-21,CHIS.,"TUXTLA GUTIÉRREZ, CHIS.",0,0,0,0,0,20,
14-dic-21,CD. MÉX.,"IZTAPALAPA, CD. MÉX.",0,0,0,0,0,27,
15-dic-21,CHIS.,"TUXTLA GUTIÉRREZ, CHIS.",0,0,0,1,0,388,
15-dic-21,CHIH.,"CHIH., CHIH.",0,0,0,0,0,398,
15-dic-21,CD. MÉX.,"IZTAPALAPA, CD. MÉX.",0,0,0,0,0,44,
16-dic-21,CHIS.,"SAN CRISTOBAL DE LAS CASAS, CHIS.",0,0,0,0,0,139,
16-dic-21,CHIS.,"LA TRINITARIA, CHIS.",0,0,0,0,0,226,
17-dic-21,B.C.,"SAN FELIPE, B.C.",0,0,0,0,0,400,
18-dic-21,CHIH.,"CHIH., CHIH.",0,0,0,0,0,652,
18-dic-21,CHIS.,"OCOSINGO, CHIS.",0,0,0,0,0,47,
19-dic-21,CHIS.,"TUXTLA GUTIÉRREZ, CHIS.",0,0,0,1,0,236,
19-dic-21,CHIS.,"BENEMÉRITO DE LAS AMÉRICAS, CHIS.",0,0,0,0,0,10,
20-dic-21,CHIH.,"CHIH., CHIH.",0,0,0,0,0,731,
28-ene-22,CD. MÉX.,"VENUSTIANO CARRANZA, CD. MÉX.",0,0,0,0,0,49,
02-feb-22,CD. MÉX.,"VENUSTIANO CARRANZA, CD. MÉX.",0,0,0,0,2,0,
03-feb-22,CD. MÉX.,"VENUSTIANO CARRANZA, CD. MÉX.",0,0,0,0,0,99,
08-feb-22,CD. MÉX.,"BENITO JUAREZ, CD. MÉX.",0,0,0,0,0,24,
29-mar-22,CD. MÉX.,"TLAHUAC, CD. MÉX.",0,0,0,0,0,22,
30-mar-22,CD. MÉX.,"TLAHUAC, CD. MÉX.",0,0,0,0,0,11,
04-abr-22,CD. MÉX.,"TLAHUAC, CD. MÉX.",0,0,0,0,0,50,
05-abr-22,CD. MÉX.,"CUAUHTEMOC, CD. MÉX.",0,0,0,0,0,146,
12-abr-22,CD. MÉX.,"CUAUHTEMOC, CD. MÉX.",0,0,0,0,1,0,
25-abr-22,CD. MÉX.,"CUAUHTEMOC, CD. MÉX.",0,0,0,0,0,82,
09-may-22,CD. MÉX.,"CUAUHTEMOC, CD. MÉX.",0,0,0,0,2,634,
09-may-22,CD. MÉX.,"TLAHUAC, CD. MÉX.",0,0,0,0,19,20,
11-may-22,CD. MÉX.,"TLAHUAC, CD. MÉX.",0,0,0,0,19,0,
18-may-22,CD. MÉX.,"CUAUHTEMOC, CD. MÉX.",0,0,0,0,2,342,
21-may-22,S.L.P.,"SAN LUIS POTOSI, S.L.P.",0,0,0,0,4,0,
22-may-22,VER.,"XALAPA, VER.",0,0,0,42,0,481,
23-may-22,CD. MÉX.,"VENUSTIANO CARRANZA, CD. MÉX.",0,0,0,0,0,20,
24-may-22,CD. MÉX.,"IZTAPALAPA, CD. MÉX.",0,0,0,0,0,111,
25-may-22,CD. MÉX.,"VENUSTIANO CARRANZA, CD. MÉX.",0,0,0,0,0,20,
26-may-22,S.L.P.,"SAN LUIS POTOSI, S.L.P.",0,0,0,0,1,0,
01-jun-22,CD. MÉX.,"MIGUEL HGO., CD. MÉX.",0,0,0,0,0,104,
02-jun-22,CD. MÉX.,"IZTAPALAPA, CD. MÉX.",0,0,0,0,0,20,
03-jun-22,CD. MÉX.,"MIGUEL HGO., CD. MÉX.",0,0,0,0,0,45,
06-jun-22,CD. MÉX.,"MIGUEL HGO., CD. MÉX.",0,0,0,0,0,2137,
07-jun-22,CD. MÉX.,"VENUSTIANO CARRANZA, CD. MÉX.",0,0,0,0,0,48,
08-jun-22,CD. MÉX.,"MIGUEL HGO., CD. MÉX.",0,0,0,0,0,299,
09-jun-22,CD. MÉX.,"VENUSTIANO CARRANZA, CD. MÉX.",0,0,0,0,7,0,
09-jun-22,CD. MÉX.,"ALVARO OBREGON, CD. MÉX.",0,0,0,0,0,1,
09-jun-22,S.L.P.,"SAN LUIS POTOSI, S.L.P.",0,0,0,0,1,0,
10-jun-22,TLAX.,"APIZACO, TLAX.",0,0,0,0,0,30,
11-jun-22,SIN.,"ANGOSTURA, SIN.",0,0,0,0,0,305,
15-jun-22,JAL.,"TLAJOMULCO DE ZUÑIGA, JAL.",0,0,0,1,0,6,
16-jun-22,CD. MÉX.,"CUAUHTEMOC, CD. MÉX.",0,0,0,0,0,10,
20-jun-22,JAL.,"GUADALAJARA, JAL.",0,0,0,0,1,0,
23-jun-22,B.C.,"SAN QUINTÍN, B.C.",0,0,0,1,0,22,
23-jun-22,N.L.,"MONTERREY, N.L.",0,0,0,4,0,131,
24-jun-22,TLAX.,"SANTA CRUZ TLAX., TLAX.",0,0,0,0,0,3,
25-jun-22,JAL.,"GUADALAJARA, JAL.",0,0,0,0,1,71,
27-jun-22,CD. MÉX.,"ALVARO OBREGON, CD. MÉX.",0,0,0,0,0,132,
27-jun-22,CD. MÉX.,"BENITO JUAREZ, CD. MÉX.",0,0,0,0,0,49,
28-jun-22,JAL.,"SAYULA, JAL.",0,0,0,0,0,43,
29-jun-22,CD. MÉX.,"CUAJIMALPA DE MOR., CD. MÉX.",0,0,0,0,20,0,
30-jun-22,JAL.,"TECALITLAN, JAL.",0,0,0,1,0,13,
01-jul-22,TLAX.,"TEOLOCHOLCO, TLAX.",0,0,0,1,0,0,
03-jul-22,S.L.P.,"SAN LUIS POTOSI, S.L.P.",0,0,0,0,3,0,
04-jul-22,B.C.,"MEXICALI, B.C.",0,0,0,39,0,0,
05-jul-22,CHIH.,"JUÁREZ, CHIH.",0,0,0,0,0,77,
06-jul-22,B.C.,"SAN QUINTÍN, B.C.",0,0,0,0,0,140,
06-jul-22,TAMPS.,"CIUDAD MADERO, TAMPS.",0,0,0,0,1,0,
07-jul-22,CD. MÉX.,"BENITO JUAREZ, CD. MÉX.",0,0,0,0,0,313,
08-jul-22,SIN.,"BADIRAGUATO, SIN.",0,0,0,0,1,0,
10-jul-22,SIN.,"BADIRAGUATO, SIN.",0,0,0,0,1,0,
15-jul-22,TAMPS.,"CIUDAD MADERO, TAMPS.",0,0,0,10,0,73,
16-jul-22,VER.,"TUXPAM, VER.",0,0,0,0,0,430,
17-jul-22,VER.,"TUXPAM, VER.",0,0,0,0,0,449,
18-jul-22,JAL.,"TLAQUEPAQUE, JAL.",0,0,0,0,0,86,
19-jul-22,JAL.,"TLAQUEPAQUE, JAL.",0,0,0,0,0,14,
20-jul-22,VER.,"TUXPAM, VER.",0,0,0,3,0,293,
20-jul-22,MICH.,"MORELIA, MICH.",0,0,0,0,0,1085,
22-jul-22,VER.,"TUXPAM, VER.",0,0,0,6,0,569,
25-jul-22,VER.,"VER., VER.",0,0,0,0,0,269,
27-jul-22,PUE.,"ATLIXCO, PUE.",0,0,0,2,1,18,
30-jul-22,CHIS.,"LA TRINITARIA, CHIS.",0,0,0,17,0,0,
02-ago-22,CHIS.,"CHIAPA DE CORZO, CHIS.",0,0,0,0,0,150,
02-ago-22,CHIS.,"TAPACHULA, CHIS.",0,0,0,0,1,0,
03-ago-22,TAB.,"CARDENAS, TAB.",0,0,0,0,0,149,
03-ago-22,CHIS.,"TAPACHULA, CHIS.",0,0,0,0,1,290,
03-ago-22,CHIS.,"FRONTERA COMALAPA, CHIS.",0,0,0,30,0,0,
04-ago-22,JAL.,"ZAPOTLANEJO, JAL.",0,0,0,0,0,37,
04-ago-22,CHIS.,"TAPACHULA, CHIS.",0,0,0,0,0,485,
04-ago-22,COAH.,"FRONTERA, COAH.",0,0,0,0,0,22,
05-ago-22,CD. MÉX.,"ALVARO OBREGON, CD. MÉX.",0,0,0,0,2,1675,
05-ago-22,CD. MÉX.,"COYOACAN, CD. MÉX.",0,0,0,0,0,20,
05-ago-22,TAMPS.,"ALTAMIRA, TAMPS.",0,0,0,0,0,34,
05-ago-22,CHIS.,"FRONTERA COMALAPA, CHIS.",0,0,0,1,0,64,
08-ago-22,CD. MÉX.,"BENITO JUAREZ, CD. MÉX.",0,0,0,0,0,28,
08-ago-22,CHIS.,"TAPACHULA, CHIS.",0,0,0,0,0,110,
08-ago-22,CHIS.,"TONALÁ, CHIS.",0,0,0,0,0,20,
08-ago-22,TAB.,"TENOSIQUE, TAB.",0,0,0,0,0,52,
09-ago-22,COAH.,"FRONTERA, COAH.",0,0,0,0,0,27,
09-ago-22,CHIS.,"TONALÁ, CHIS.",0,0,0,0,0,30,
09-ago-22,CHIS.,"CINTALAPA, CHIS.",0,0,0,0,0,30,
10-ago-22,COAH.,"FRONTERA, COAH.",0,0,0,1,0,47,
10-ago-22,TAMPS.,"ALTAMIRA, TAMPS.",0,0,0,1,1,39,
10-ago-22,CHIS.,"TAPACHULA, CHIS.",0,0,0,0,0,378,
10-ago-22,CHIS.,"TONALÁ, CHIS.",0,0,0,0,0,22,
10-ago-22,CHIS.,"CINTALAPA, CHIS.",0,0,0,0,0,51,
11-ago-22,COAH.,"FRONTERA, COAH.",0,0,0,0,0,29,
11-ago-22,CHIS.,"CINTALAPA, CHIS.",0,0,0,0,0,56,
11-ago-22,CHIS.,"LA TRINITARIA, CHIS.",0,0,0,0,0,53,
12-ago-22,PUE.,"TEHUACAN, PUE.",0,0,0,0,1,140,
12-ago-22,CHIS.,"BERRIOZÁBAL, CHIS.",0,0,0,0,0,365,
12-ago-22,CHIS.,"OSUMACINTA, CHIS.",0,0,0,0,0,79,
12-ago-22,CHIS.,"TAPACHULA, CHIS.",0,0,0,0,0,121,
12-ago-22,TAB.,"TENOSIQUE, TAB.",0,0,0,0,0,52,
12-ago-22,CHIS.,"LA TRINITARIA, CHIS.",0,0,0,0,0,113,
12-ago-22,TAMPS.,"ALTAMIRA, TAMPS.",0,0,0,0,0,25,
13-ago-22,CHIS.,"OSUMACINTA, CHIS.",0,0,0,0,0,24,
13-ago-22,CHIS.,"TAPACHULA, CHIS.",0,0,0,0,0,264,
13-ago-22,CHIS.,"TONALÁ, CHIS.",0,0,0,0,0,10,
13-ago-22,CHIS.,"CINTALAPA, CHIS.",0,0,0,0,0,432,
13-ago-22,CHIS.,"LA TRINITARIA, CHIS.",0,0,0,0,0,484,
14-ago-22,CHIS.,"TONALÁ, CHIS.",0,0,0,0,0,10,
14-ago-22,CHIS.,"TONALÁ, CHIS.",0,0,0,2,0,55,
15-ago-22,CD. MÉX.,"ALVARO OBREGON, CD. MÉX.",0,0,0,0,12,0,
15-ago-22,QRO.,"QUERETARO, QRO.",0,0,0,0,1,0,
15-ago-22,CHIS.,"TONALÁ, CHIS.",0,0,0,0,0,14,
15-ago-22,CHIS.,"LAS MARGARITAS, CHIS.",0,0,0,0,4,0,
15-ago-22,PUE.,"ATLIXCO, PUE.",0,0,0,1,0,132,
16-ago-22,CHIS.,"TONALÁ, CHIS.",0,0,0,0,0,15,
16-ago-22,CHIS.,"JIQUIPILAS, CHIS.",0,0,0,1,0,4,
16-ago-22,CD. MÉX.,"IZTACALCO, CD. MÉX.",0,0,0,0,0,68,
16-ago-22,COAH.,"RAMOS ARIZPE, COAH.",0,0,0,9,0,0,
16-ago-22,COAH.,"TORREÓN, COAH.",0,0,0,0,0,44,
16-ago-22,CHIS.,"JIQUIPILAS, CHIS.",0,0,0,1,0,4,
16-ago-22,COAH.,"RAMOS ARIZPE, COAH.",0,0,0,9,0,0,
17-ago-22,CD. MÉX.,"ALVARO OBREGON, CD. MÉX.",0,0,0,0,0,110,
17-ago-22,COAH.,"RAMOS ARIZPE, COAH.",0,0,0,0,0,39,
17-ago-22,COAH.,"TORREÓN, COAH.",0,0,0,0,0,19,
17-ago-22,CHIS.,"TONALÁ, CHIS.",0,0,0,1,0,3,
17-ago-22,CHIS.,"LAS MARGARITAS, CHIS.",0,0,0,0,4,126,
18-ago-22,CHIS.,"SAN FERNANDO, CHIS.",0,0,0,2,0,277,
18-ago-22,CD. MÉX.,"IZTACALCO, CD. MÉX.",0,0,0,0,6,12,
18-ago-22,CHIS.,"SAN FERNANDO, CHIS.",0,0,0,0,0,277,
18-ago-22,CHIS.,"TAPACHULA, CHIS.",0,0,0,0,0,168,
18-ago-22,CHIS.,"TONALÁ, CHIS.",0,0,0,0,0,13,
18-ago-22,CHIS.,"JIQUIPILAS, CHIS.",0,0,0,0,0,54,
18-ago-22,CHIS.,"LAS MARGARITAS, CHIS.",0,0,0,1,1,19,
19-ago-22,COAH.,"FRONTERA, COAH.",0,0,0,3,0,66,
19-ago-22,VER.,"TUXPAM, VER.",0,0,0,1,0,377,
19-ago-22,CHIS.,"SAN FERNANDO, CHIS.",0,0,0,0,1,508,
19-ago-22,TAB.,"TENOSIQUE, TAB.",0,0,0,0,0,137,
19-ago-22,CHIS.,"TONALÁ, CHIS.",0,0,0,0,0,10,
19-ago-22,CHIS.,"LAS MARGARITAS, CHIS.",0,0,0,0,0,29,
20-ago-22,CHIS.,"SAN CRISTOBAL DE LAS CASAS, CHIS.",0,0,0,0,0,307,
20-ago-22,CHIS.,"TONALÁ, CHIS.",0,0,0,0,0,12,
22-ago-22,COAH.,"MONCLOVA, COAH.",0,0,0,1,0,16,
22-ago-22,CHIS.,"TONALÁ, CHIS.",0,0,0,0,0,13,
22-ago-22,CHIS.,"SUCHIATE, CHIS.",0,0,0,0,0,63,
22-ago-22,TAB.,"TENOSIQUE, TAB.",0,0,0,0,0,45,
22-ago-22,CHIS.,"FRONTERA COMALAPA, CHIS.",0,0,0,2,0,248,
23-ago-22,COAH.,"TORREÓN, COAH.",0,0,0,0,0,175,
23-ago-22,DGO.,"DGO., DGO.",0,0,0,7,0,0,
23-ago-22,PUE.,"TEHUACAN, PUE.",0,0,0,0,3,0,
23-ago-22,CHIS.,"SUCHIATE, CHIS.",0,0,0,0,0,392,
23-ago-22,CHIS.,"TONALÁ, CHIS.",0,0,0,0,0,11,
23-ago-22,CHIS.,"LA TRINITARIA, CHIS.",0,0,0,0,0,30,
23-ago-22,TAMPS.,"REYNOSA, TAMPS.",0,0,0,2,0,0,
24-ago-22,COAH.,"MONCLOVA, COAH.",0,0,0,0,0,14,
24-ago-22,CHIS.,"TONALÁ, CHIS.",0,0,0,1,0,22,
24-ago-22,CHIS.,"SUCHIATE, CHIS.",0,0,0,1,0,128,
24-ago-22,CHIS.,"LA TRINITARIA, CHIS.",0,0,0,0,0,23,
24-ago-22,CD. MÉX.,"IZTAPALAPA, CD. MÉX.",0,0,0,0,0,3,
24-ago-22,COAH.,"ACUÑA, COAH.",0,0,0,2,0,74,
25-ago-22,CD. MÉX.,"CUAUHTEMOC, CD. MÉX.",0,0,0,0,0,349,
25-ago-22,DGO.,"DGO., DGO.",0,0,0,11,0,0,
25-ago-22,CHIS.,"VILLAFLORES, CHIS.",0,0,0,0,0,575,
25-ago-22,CHIS.,"BERRIOZÁBAL, CHIS.",0,0,0,0,0,29,
25-ago-22,CHIS.,"TONALÁ, CHIS.",0,0,0,0,0,24,
25-ago-22,N.L.,"APODACA, N.L.",0,0,0,0,0,51,
25-ago-22,TAMPS.,"REYNOSA, TAMPS.",0,0,0,2,0,0,
26-ago-22,PUE.,"TEHUACAN, PUE.",0,0,0,0,1,0,
26-ago-22,CHIS.,"CHICOASÉN, CHIS.",0,0,0,3,0,270,
26-ago-22,TAB.,"TENOSIQUE, TAB.",0,0,0,0,0,118,
26-ago-22,CHIS.,"SUCHIATE, CHIS.",0,0,0,0,0,286,
26-ago-22,CHIS.,"TONALÁ, CHIS.",0,0,0,0,0,4,
26-ago-22,B.C.,"SAN QUINTÍN, B.C.",0,0,0,2,0,70,
26-ago-22,COAH.,"FRANCISCO I. MADERO, COAH.",0,0,0,0,0,276,
26-ago-22,CHIS.,"FRONTERA COMALAPA, CHIS.",0,0,0,0,0,37,
27-ago-22,QRO.,"AMEALCO DE BONFIL, QRO.",0,0,0,0,2,0,
27-ago-22,PUE.,"TEHUACAN, PUE.",0,0,0,0,1,0,
27-ago-22,CHIS.,"SUCHIATE, CHIS.",0,0,0,0,0,357,
27-ago-22,CHIS.,"TONALÁ, CHIS.",0,0,0,0,0,5,
27-ago-22,CHIS.,"FRONTERA COMALAPA, CHIS.",0,0,0,2,0,73,
28-ago-22,QRO.,"QUERETARO, QRO.",0,0,0,0,1,0,
29-ago-22,TAB.,"TENOSIQUE, TAB.",0,0,0,0,0,189,
29-ago-22,CHIS.,"TONALÁ, CHIS.",0,0,0,0,0,11,
29-ago-22,COAH.,"PIEDRAS NEGRAS, COAH.",0,0,0,4,0,280,
30-ago-22,CHIS.,"TONALÁ, CHIS.",0,0,0,1,0,15,
31-ago-22,CD. MÉX.,"XOCHIMILCO, CD. MÉX.",0,0,0,0,0,35,
31-ago-22,COAH.,"MONCLOVA, COAH.",0,0,0,0,0,8,
31-ago-22,MÉX.,"NEZAHUALCOYOTL, MEX.",0,0,0,8,0,917,
31-ago-22,TAMPS.,"VICTORIA, TAMPS.",0,0,0,0,0,50,
31-ago-22,CHIS.,"TONALÁ, CHIS.",0,0,0,2,0,54,
01-sep-22,COAH.,"PIEDRAS NEGRAS, COAH.",0,0,0,10,0,327,
01-sep-22,COAH.,"ACUÑA, COAH.",0,0,0,2,0,0,
02-sep-22,CD. MÉX.,"VENUSTIANO CARRANZA, CD. MÉX.",0,0,0,0,0,324,
02-sep-22,MOR.,"TEMIXCO, MOR.",0,0,0,1,3,0,
02-sep-22,COAH.,"MATAMOROS, COAH.",0,0,0,0,1,336,
02-sep-22,COAH.,"FRONTERA, COAH.",0,0,0,0,0,72,
04-sep-22,QRO.,"QUERETARO, QRO.",0,0,0,0,1,0,
06-sep-22,COAH.,"PIEDRAS NEGRAS, COAH.",0,0,0,0,0,247,
06-sep-22,COAH.,"ACUÑA, COAH.",0,0,0,3,0,5,
07-sep-22,COAH.,"MONCLOVA, COAH.",0,0,0,0,0,29,
07-sep-22,COAH.,"PIEDRAS NEGRAS, COAH.",0,0,0,0,0,29,
07-sep-22,MOR.,"CUERNAVACA, MOR.",0,0,0,0,1,0,
08-sep-22,COAH.,"PIEDRAS NEGRAS, COAH.",0,0,0,0,0,100,
09-sep-22,CD. MÉX.,"XOCHIMILCO, CD. MÉX.",0,0,0,0,0,190,
09-sep-22,COAH.,"FRONTERA, COAH.",0,0,0,0,0,47,
09-sep-22,COAH.,"MONCLOVA, COAH.",0,0,0,2,0,0,
12-sep-22,COAH.,"PIEDRAS NEGRAS, COAH.",0,0,0,0,0,51,
12-sep-22,COAH.,"NUEVA ROSITA, COAH.",0,0,0,0,0,86,
12-sep-22,ZAC.,"JEREZ, ZAC.",0,0,0,8,0,19,
13-sep-22,MÉX.,"TOLUCA, MEX.",0,0,0,0,0,385,
13-sep-22,CD. MÉX.,"AZCAPOTZALCO, CD. MÉX.",0,0,0,0,0,161,
13-sep-22,MÉX.,"ECATEPEC DE MOR., MEX.",0,0,0,0,0,204,
13-sep-22,ZAC.,"JEREZ, ZAC.",0,0,0,0,0,562,
13-sep-22,COAH.,"CUATROCIÉNEGAS, COAH.",0,0,0,0,1,0,
14-sep-22,S.L.P.,"SAN LUIS POTOSI, S.L.P.",0,0,0,0,3,0,
20-sep-22,COAH.,"PIEDRAS NEGRAS, COAH.",0,0,0,0,0,106,
22-sep-22,CD. MÉX.,"TLAHUAC, CD. MÉX.",0,0,0,0,0,63,
22-sep-22,MOR.,"CUERNAVACA, MOR.",0,0,0,0,0,400,
23-sep-22,CHIH.,"JUÁREZ, CHIH.",0,0,0,0,0,31,
23-sep-22,VER.,"POZA RICA DE HGO., VER.",0,0,0,0,0,230,
23-sep-22,TAMPS.,"MATAMOROS, TAMPS.",0,0,0,2,0,21,
27-sep-22,CHIH.,"JUÁREZ, CHIH.",0,0,0,0,0,7,
27-sep-22,COAH.,"MONCLOVA, COAH.",0,0,0,0,0,38,
27-sep-22,COAH.,"PIEDRAS NEGRAS, COAH.",0,0,0,0,0,325,
27-sep-22,CHIH.,"JUÁREZ, CHIH.",0,0,0,0,0,7,
28-sep-22,CD. MÉX.,"CUAUHTEMOC, CD. MÉX.",0,0,0,0,0,263,
28-sep-22,N.L.,"APODACA, N.L.",0,0,0,1,0,32,
29-sep-22,COAH.,"PIEDRAS NEGRAS, COAH.",0,0,0,0,0,184,
29-sep-22,CD. MÉX.,"CUAUHTEMOC, CD. MÉX.",0,0,0,0,0,58,
30-sep-22,MÉX.,"NEZAHUALCOYOTL, MEX.",0,0,0,0,0,6,
30-sep-22,COAH.,"PIEDRAS NEGRAS, COAH.",0,0,0,0,0,403,
03-oct-22,COAH.,"PIEDRAS NEGRAS, COAH.",0,0,0,0,0,92,
05-oct-22,CHIH.,"JUÁREZ, CHIH.",0,0,0,1,0,123,
05-oct-22,COAH.,"PIEDRAS NEGRAS, COAH.",0,0,0,0,0,300,
05-oct-22,CD. MÉX.,"CUAUHTEMOC, CD. MÉX.",0,0,0,0,0,434,
06-oct-22,CD. MÉX.,"CUAUHTEMOC, CD. MÉX.",0,0,0,0,0,36,
06-oct-22,CD. MÉX.,"TLALPAN, CD. MÉX.",0,0,0,0,0,154,
06-oct-22,COAH.,"CASTAÑOS, COAH.",0,0,0,0,0,26,
06-oct-22,MÉX.,"XALATLACO, MEX.",0,0,0,0,0,218,
06-oct-22,MÉX.,"ATLACOMULCO, MEX.",0,0,0,0,0,11,
06-oct-22,COAH.,"PIEDRAS NEGRAS, COAH.",0,0,0,0,0,424,
06-oct-22,QRO.,"CORREGIDORA, QRO.",0,0,0,0,3,53,
07-oct-22,COAH.,"FRONTERA, COAH.",0,0,0,2,0,0,
07-oct-22,COAH.,"CASTAÑOS, COAH.",0,0,0,0,0,31,
07-oct-22,CHIH.,"JUÁREZ, CHIH.",0,0,0,0,0,31,
07-oct-22,QRO.,"CORREGIDORA, QRO.",0,0,0,0,1,0,
10-oct-22,COAH.,"FRONTERA, COAH.",0,0,0,0,0,50,
10-oct-22,COAH.,"ACUÑA, COAH.",0,0,0,0,0,16,
11-oct-22,MÉX.,"OTZOLOTEPEC, MEX.",0,0,0,0,0,15,
11-oct-22,CD. MÉX.,"CUAUHTEMOC, CD. MÉX.",0,0,0,0,1,0,
12-oct-22,CD. MÉX.,"CUAUHTEMOC, CD. MÉX.",0,0,0,0,2,96,
12-oct-22,COAH.,"CASTAÑOS, COAH.",0,0,0,0,0,41,
13-oct-22,SIN.,"CONCORDIA, SIN.",0,0,0,0,0,71,
13-oct-22,S.L.P.,"SAN LUIS POTOSI, S.L.P.",0,0,0,6,0,0,
13-oct-22,CD. MÉX.,"GUSTAVO A. MADERO, CD. MÉX.",0,0,0,0,0,36,
14-oct-22,SIN.,"CONCORDIA, SIN.",0,0,0,0,0,30,
17-oct-22,SIN.,"CONCORDIA, SIN.",0,0,0,0,0,22,
17-oct-22,SIN.,"SAN IGNACIO, SIN.",0,0,0,0,0,175,
18-oct-22,COAH.,"PIEDRAS NEGRAS, COAH.",0,0,0,0,0,119,
18-oct-22,SIN.,"SAN IGNACIO, SIN.",0,0,0,0,0,5145,
19-oct-22,COAH.,"PIEDRAS NEGRAS, COAH.",0,0,0,0,0,119,
19-oct-22,SIN.,"SAN IGNACIO, SIN.",0,0,0,0,0,10650,
19-oct-22,TLAX.,"TLAX., TLAX.",0,0,0,0,0,108,
19-oct-22,MOR.,"YECAPIXTLA, MOR.",0,0,0,100,0,0,
20-oct-22,CD. MÉX.,"ALVARO OBREGON, CD. MÉX.",0,0,0,0,0,292,
21-oct-22,CD. MÉX.,"CUAUHTEMOC, CD. MÉX.",0,0,0,0,0,190,
21-oct-22,CD. MÉX.,"ALVARO OBREGON, CD. MÉX.",0,0,0,0,0,129,
24-oct-22,MÉX.,"NEXTLALPAN, MEX., MEX.",0,0,0,0,1,0,
24-oct-22,COAH.,"PIEDRAS NEGRAS, COAH.",0,0,0,1,0,175,
24-oct-22,N.L.,"MONTERREY, N.L.",0,0,0,0,0,10,
25-oct-22,COAH.,"PIEDRAS NEGRAS, COAH.",0,0,0,0,0,153,
26-oct-22,MÉX.,"MEXICALTZINGO, MEX.",0,0,0,0,0,11,
27-oct-22,CD. MÉX.,"VENUSTIANO CARRANZA, CD. MÉX.",0,0,0,0,0,598,
27-oct-22,CD. MÉX.,"TLALPAN, CD. MÉX.",0,0,0,0,0,492,
27-oct-22,TAMPS.,"NUEVO LAREDO, TAMPS.",0,0,0,0,0,32,
28-oct-22,N.L.,"GRAL. ESCOBEDO, N.L.",0,0,0,0,0,33,
31-oct-22,COAH.,"PIEDRAS NEGRAS, COAH.",0,0,0,0,0,650,
01-nov-22,SIN.,"COSALA, SIN.",0,0,0,0,0,670,
03-nov-22,SIN.,"ELOTA, SIN.",0,0,0,0,0,96,
04-nov-22,CHIS.,"JIQUIPILAS, CHIS.",0,0,0,3,0,0,
04-nov-22,TAMPS.,"NUEVO LAREDO, TAMPS.",0,0,0,0,0,932,
05-nov-22,MÉX.,"ZINACANTEPEC, MEX.",0,0,0,0,0,27,
05-nov-22,CHIS.,"TONALÁ, CHIS.",0,0,0,0,0,17,
05-nov-22,CHIS.,"JIQUIPILAS, CHIS.",0,0,0,3,0,0,
05-nov-22,COAH.,"SAN JUAN DE SABINAS, COAH.",0,0,0,1,0,50,
06-nov-22,VER.,"ACAYUCAN, VER.",0,0,0,0,0,65,
07-nov-22,VER.,"PAPANTLA, VER.",0,0,0,0,0,191,
07-nov-22,TAMPS.,"NUEVO LAREDO, TAMPS.",0,0,0,0,0,29,
08-nov-22,CD. MÉX.,"GUSTAVO A. MADERO, CD. MÉX.",0,0,0,0,3,180,
09-nov-22,CD. MÉX.,"CUAUHTEMOC, CD. MÉX.",0,0,0,0,0,66,
09-nov-22,CD. MÉX.,"IZTAPALAPA, CD. MÉX.",0,0,0,0,0,38,
09-nov-22,CD. MÉX.,"LA MAGDALENA CONTRERAS, CD. MÉX.",0,0,0,0,0,32,
09-nov-22,GRO.,"ACAPULCO DE JUAREZ, GRO.",0,0,0,0,4,67,
10-nov-22,SIN.,"COSALA, SIN.",0,0,0,0,0,88,
10-nov-22,CHIS.,"BERRIOZÁBAL, CHIS.",0,0,0,0,0,187,
11-nov-22,VER.,"ACAYUCAN, VER.",0,0,0,0,0,140,
14-nov-22,CD. MÉX.,"COYOACAN, CD. MÉX.",0,0,0,0,0,82,
15-nov-22,CHIS.,"BERRIOZÁBAL, CHIS.",0,0,0,0,0,793,
15-nov-22,CD. MÉX.,"COYOACAN, CD. MÉX.",0,0,0,0,0,150,
15-nov-22,VER.,"ACAYUCAN, VER.",0,0,0,5,0,314,
15-nov-22,JAL.,"AUTLAN DE NAVARRO, JAL.",0,0,0,0,20,0,
15-nov-22,CHIS.,"TUXTLA CHICO, CHIS.",0,0,0,0,0,95,
16-nov-22,CD. MÉX.,"COYOACAN, CD. MÉX.",0,0,0,0,0,17,
16-nov-22,CD. MÉX.,"IZTAPALAPA, CD. MÉX.",0,0,0,0,0,5,
16-nov-22,CHIS.,"BERRIOZÁBAL, CHIS.",0,0,0,0,0,323,
17-nov-22,CHIS.,"OSUMACINTA, CHIS.",0,0,0,0,0,222,
17-nov-22,CHIS.,"BERRIOZÁBAL, CHIS.",0,0,0,0,0,223,
18-nov-22,CHIS.,"OSUMACINTA, CHIS.",0,0,0,0,0,515,
18-nov-22,CHIS.,"JIQUIPILAS, CHIS.",0,0,0,0,0,58,
18-nov-22,CHIS.,"TUXTLA CHICO, CHIS.",0,0,0,0,0,15,
19-nov-22,HGO.,"ATOTONILCO DE TULA, HGO.",0,0,0,0,0,82,
19-nov-22,CHIS.,"OSUMACINTA, CHIS.",0,0,0,0,0,240,
20-nov-22,CHIS.,"ARRIAGA, CHIS.",0,0,0,0,0,20,
21-nov-22,CHIS.,"COAPILLA, CHIS.",0,0,0,0,0,40,
21-nov-22,CHIS.,"COAPILLA, CHIS.",0,0,0,0,0,40,
21-nov-22,CHIS.,"ARRIAGA, CHIS.",0,0,0,0,0,34,
22-nov-22,CHIS.,"TONALÁ, CHIS.",0,0,0,0,0,24,
22-nov-22,CD. MÉX.,"MILPA ALTA, CD. MÉX.",0,0,0,0,0,3,
23-nov-22,Q. ROO.,"BENITO JUAREZ, Q. ROO",0,0,0,0,0,2,
24-nov-22,CD. MÉX.,"TLAHUAC, CD. MÉX.",0,0,0,0,0,10,
24-nov-22,CHIS.,"COAPILLA, CHIS.",0,0,0,0,0,130,
24-nov-22,CHIS.,"OCOSINGO, CHIS.",0,0,0,4,0,150,
25-nov-22,CD. MÉX.,"MILPA ALTA, CD. MÉX.",0,0,0,0,0,11,
25-nov-22,CD. MÉX.,"CUAUHTEMOC, CD. MÉX.",0,0,0,0,0,233,
25-nov-22,CHIS.,"COPAINALÁ, CHIS.",0,0,0,0,0,66,
26-nov-22,CHIS.,"COPAINALÁ, CHIS.",0,0,0,0,0,86,
26-nov-22,Q. ROO.,"BENITO JUAREZ, Q. ROO",0,0,0,5,0,123,
29-nov-22,CHIS.,"CHIAPA DE CORZO, CHIS.",0,0,0,0,0,58,
30-nov-22,CD. MÉX.,"ALVARO OBREGON, CD. MÉX.",0,0,0,0,0,1,
30-nov-22,CHIS.,"OCOSINGO, CHIS.",0,0,0,0,0,130,
05-dic-22,CHIH.,"JUÁREZ, CHIH.",0,0,0,10,1,40,
08-dic-22,CD. MÉX.,"ALVARO OBREGON, CD. MÉX.",0,0,0,0,0,3,
09-dic-22,CHIS.,"JIQUIPILAS, CHIS.",0,0,0,0,0,14,
09-dic-22,JAL.,"TOMATLAN, JAL.",0,0,0,0,1,0,
13-dic-22,CHIS.,"CINTALAPA, CHIS.",0,0,0,1,0,46,
14-dic-22,CD. MÉX.,"VENUSTIANO CARRANZA, CD. MÉX.",0,0,0,0,0,143,
15-dic-22,CD. MÉX.,"VENUSTIANO CARRANZA, CD. MÉX.",0,0,0,0,0,196,
16-dic-22,CHIS.,"CINTALAPA, CHIS.",0,0,0,0,3,0,
16-dic-22,CD. MÉX.,"GUSTAVO A. MADERO, CD. MÉX.",0,0,0,0,0,36,
16-dic-22,N.L.,"ALLENDE, N.L.",0,0,0,0,0,320,
28-dic-22,CHIS.,"ARRIAGA, CHIS.",0,0,0,0,0,7,
30-dic-22,CHIS.,"ARRIAGA, CHIS.",0,0,0,0,0,46,
13-feb-23,Tamaulipas,"NUEVO LAREDO, TAMPS.",0,0,0,2,0,96,
15-feb-23,Tamaulipas,"NUEVO LAREDO, TAMPS.",0,0,0,1,0,95,
16-feb-23,Cd. de México,"TLAHUAC, CD. MÉX.",0,0,0,0,0,22,
20-feb-23,Tamaulipas,"NUEVO LAREDO, TAMPS.",0,0,0,2,0,123,
21-feb-23,Tamaulipas,"NUEVO LAREDO, TAMPS.",0,0,0,10,0,450,
22-feb-23,Cd. de México,"BENITO JUAREZ, CD. MÉX.",0,0,0,0,3,0,
22-feb-23,Cd. de México,"CUAUHTEMOC, CD. MÉX.",0,0,0,0,0,106,
23-feb-23,Tamaulipas,"NUEVO LAREDO, TAMPS.",0,0,0,11,0,564,
24-feb-23,Cd. de México,"CUAUHTEMOC, CD. MÉX.",0,0,0,0,0,77,
24-feb-23,Cd. de México,"AZCAPOTZALCO, CD. MÉX.",0,0,0,0,0,11,
28-feb-23,Cd. de México,"IZTAPALAPA, CD. MÉX.",0,0,0,0,0,612,
28-feb-23,Tamaulipas,"NUEVO LAREDO, TAMPS.",0,0,0,3,0,56,
02-mar-23,Coahuila,"ACUÑA, COAH.",0,0,0,4,0,0,
06-mar-23,Veracruz,"JALTIPAN, VER.",0,0,0,2,0,"8,900",
06-mar-23,Chiapas,"COMITAN DE DOMÍNGUEZ, CHIS.",0,0,0,0,0,78,
06-mar-23,Cd. de México,"IZTAPALAPA, CD. MÉX.",0,0,0,0,0,110,
06-mar-23,Coahuila,"ACUÑA, COAH.",0,0,0,1,0,12,
07-mar-23,Coahuila,"ACUÑA, COAH.",0,0,0,1,0,12,
08-mar-23,Chiapas,"COMITAN DE DOMÍNGUEZ, CHIS.",0,0,0,0,0,80,
08-mar-23,Veracruz,"JALTIPAN, VER.",0,0,0,10,0,"17,000",
09-mar-23,Chiapas,"COMITAN DE DOMÍNGUEZ, CHIS.",0,0,0,5,0,344,
10-mar-23,Tamaulipas,"NUEVO LAREDO, TAMPS.",0,0,0,3,0,417,
10-mar-23,Veracruz,"LA PERLA, VER.",0,0,0,7,0,18,
10-mar-23,Cd. de México,"MIGUEL HIDALGO, CD. MÉX.",0,0,0,0,0,11,
11-mar-23,Veracruz,"LA PERLA, VER.",0,0,0,0,0,56,
12-mar-23,Veracruz,"JALTIPAN, VER.",0,0,0,41,0,301,
13-mar-23,Cd. de México,"IZTACALCO, CD. MÉX.",0,0,0,0,0,11,
13-mar-23,Veracruz,"JALTIPAN, VER.",0,0,0,30,0,"1,398",
13-mar-23,México,"IXTAPALUCA, MEX.",0,0,0,0,0,186,
14-mar-23,Tamaulipas,"NUEVO LAREDO, TAMPS.",0,0,0,2,0,300,
14-mar-23,México,"ATIZAPAN, MEX.",0,0,0,0,0,855,
15-mar-23,Tamaulipas,"NUEVO LAREDO, TAMPS.",0,0,0,9,0,148,
15-mar-23,Tamaulipas,"NUEVO LAREDO, TAMPS.",0,0,0,7,0,300,
15-mar-23,Chiapas,"COMITAN DE DOMÍNGUEZ, CHIS.",0,0,0,0,1,188,
16-mar-23,Cd. de México,"MIGUEL HIDALGO, CD. MÉX.",0,0,0,0,0,290,
17-mar-23,México,"IXTAPALUCA, MEX.",0,0,0,0,0,"2,000",
17-mar-23,Coahuila,"ACUÑA, COAH.",0,0,0,0,3,90,
23-mar-23,Veracruz,"MARTINEZ DE LA TORRE, VER.",0,0,0,20,0,"1,989",
23-mar-23,Chihuahua,"CHIHUAHUA, CHIH.",0,0,0,18,0,50,
24-mar-23,México,"SAN MATEO ATENCO, MEX.",0,0,0,0,0,8,
25-mar-23,Guanajuato,"SAN LUIS DE LA PAZ, GTO.",0,0,0,0,2,0,
27-mar-23,Guanajuato,"SAN LUIS DE LA PAZ, GTO.",0,0,0,0,2,0,
28-mar-23,Cd. de México,"CUAUHTEMOC, CD. MÉX.",0,0,0,0,0,6,
29-mar-23,Cd. de México,"LA MAGDALENA CONTRERAS, CD. MÉX.",0,0,0,0,0,77,
31-mar-23,Cd. de México,"TLAHUAC, CD. MÉX.",0,0,0,0,0,179,
31-mar-23,Coahuila,"ACUÑA, COAH.",0,0,0,0,0,269,
31-mar-23,Coahuila,"PIEDRAS NEGRAS, COAH.",0,0,0,0,0,49,
01-abr-23,México,"TOLUCA, MEX.",0,0,0,0,0,2,
12-abr-23,Cd. de México,"TLALPAN, CD. MÉX.",0,0,0,0,0,17,
17-abr-23,Cd. de México,"CUAUHTEMOC, CD. MÉX.",0,0,0,0,0,143,
28-abr-23,Michoacán,"MORELIA, MICH.",0,0,0,4,0,0,
28-abr-23,Cd. de México,"COYOACAN, CD. MÉX.",0,0,0,0,0,396,
02-may-23,Cd. de México,"IZTACALCO, CD. MÉX.",0,0,0,0,0,27,
04-may-23,Cd. de México,"XOCHIMILCO, CD. MÉX.",0,0,0,0,0,888,
11-may-23,Cd. de México,"VENUSTIANO CARRANZA, CD. MÉX.",0,0,0,0,0,39,
14-may-23,Michoacán,"TARIMBARO, MICH.",0,0,0,62,0,0,
16-may-23,Querétaro,"QUERETARO, QRO.",0,0,0,0,0,314,
17-may-23,Cd. de México,"VENUSTIANO CARRANZA, CD. MÉX.",0,0,0,0,7,0,
19-may-23,Querétaro,"SAN JUAN DEL RIO, QRO.",0,0,0,0,0,8,
29-may-23,Michoacán,"HIDALGO, MICH.",0,0,0,1,0,0,
09-jun-23,Cd. de México,"COYOACAN, CD. MÉX.",0,0,0,0,0,256,
12-jun-23,Cd. de México,"VENUSTIANO CARRANZA, CD. MÉX.",0,0,0,0,0,18,
14-jun-23,Cd. de México,"MIGUEL HIDALGO, CD. MÉX.",0,0,0,0,2,0,
14-jun-23,Morelos,"CUERNAVACA, MOR.",0,0,0,6,1,92,
14-jun-23,Chiapas,"LA TRINITARIA, CHIS.",0,0,0,0,0,389,
15-jun-23,Chiapas,"LA TRINITARIA, CHIS.",0,0,0,2,0,246,
16-jun-23,Morelos,"CUERNAVACA, MOR.",0,0,0,2,3,0,
16-jun-23,Querétaro,"QUERETARO, QRO.",0,0,0,0,0,20,
17-jun-23,Puebla,"ATLIXCO, PUE.",0,0,0,0,0,206,
17-jun-23,Aguascalientes,"SAN JOSÉ DE GRACIA, AGS.",0,0,0,1,0,130,
20-jun-23,México,"ZINACANTEPEC, MEX.",0,0,0,0,0,79,
20-jun-23,Chiapas,"COMITAN DE DOMÍNGUEZ, CHIS.",0,0,0,0,0,237,
20-jun-23,Veracruz,"MARTINEZ DE LA TORRE, VER.",0,0,0,5,0,400,
20-jun-23,México,"NICOLAS ROMERO, MEX.",0,0,0,0,0,16,
21-jun-23,Puebla,"ATLIXCO, PUE.",0,0,0,0,0,418,
22-jun-23,Puebla,"ATLIXCO, PUE.",0,0,0,0,2,2,
22-jun-23,México,"ZINACANTEPEC, MEX.",0,0,0,0,0,15,
22-jun-23,Veracruz,"MARTINEZ DE LA TORRE, VER.",0,0,0,0,0,180,
22-jun-23,Chiapas,"COMITAN DE DOMÍNGUEZ, CHIS.",0,0,0,0,0,381,
23-jun-23,Veracruz,"MARTINEZ DE LA TORRE, VER.",0,0,0,20,0,"1,989",
23-jun-23,Chiapas,"COMITAN DE DOMÍNGUEZ, CHIS.",0,0,0,0,0,331,
24-jun-23,Puebla,"ATLIXCO, PUE.",0,0,0,4,0,67,
24-jun-23,Tlaxcala,"TLAXCALA, TLAX.",0,0,0,0,0,18,
26-jun-23,Puebla,"ATLIXCO, PUE.",0,0,0,0,0,464,
27-jun-23,México,"HUEHUETOCA, MEX.",0,0,0,0,0,68,
27-jun-23,Veracruz,"MISANTLA, VER.",0,0,0,2,1,891,
29-jun-23,Veracruz,"MISANTLA, VER.",0,0,0,35,0,453,
30-jun-23,Puebla,"ATLIXCO, PUE.",0,0,0,0,1,0,
30-jun-23,Guanajuato,"APASEO EL GRANDE, GTO.",0,0,0,7,0,8,
04-jul-23,Veracruz,"VEGA DE ALATORRE, VER.",0,0,0,1,0,47,
05-jul-23,México,"OTZOLOTEPEC, MEX.",0,0,0,0,0,11,
06-jul-23,México,"OTZOLOTEPEC, MEX.",0,0,0,0,0,98,
06-jul-23,Tlaxcala,"TLAXCALA, TLAX.",0,0,0,0,0,40,
06-jul-23,Chiapas,"SAN CRISTOBAL DE LAS CASAS, CHIS.",0,0,0,0,0,83,
08-jul-23,Chiapas,"CHIAPA DE CORZO, CHIS.",0,0,0,0,0,199,
09-jul-23,Veracruz,"VEGA DE ALATORRE, VER.",0,0,0,1,0,0,
10-jul-23,Chiapas,"TUXTLA GUTIÉRREZ, CHIS.",0,0,0,0,1,231,
10-jul-23,Chiapas,"SAN CRISTOBAL DE LAS CASAS, CHIS.",0,0,0,0,0,53,
12-jul-23,Chiapas,"SAN CRISTOBAL DE LAS CASAS, CHIS.",0,0,0,0,0,203,
13-jul-23,Chiapas,"OCOSINGO, CHIS.",0,0,0,0,0,25,
13-jul-23,Cd. de México,"IZTAPALAPA, CD. MÉX.",0,0,0,0,0,523,
14-jul-23,Chiapas,"OCOZOCOAUTLA DE ESPINOSA, CHIS.",0,0,0,4,0,911,
14-jul-23,México,"COYOTEPEC, MEX.",0,0,0,0,64,0,
14-jul-23,Chiapas,"TAPACHULA, CHIS.",0,0,0,0,0,156,
14-jul-23,Chiapas,"SAN CRISTOBAL DE LAS CASAS, CHIS.",0,0,0,0,0,150,
14-jul-23,Chiapas,"OCOSINGO, CHIS.",0,0,0,0,0,149,
17-jul-23,Chiapas,"TAPACHULA, CHIS.",0,0,0,4,0,159,
18-jul-23,Durango,"SANTIAGO PAPASQUIARO, DGO.",0,0,0,14,1,0,
18-jul-23,Chiapas,"OCOZOCOAUTLA DE ESPINOSA, CHIS.",0,0,0,810,0,0,
19-jul-23,México,"TULTITLAN, MEX.",0,0,0,0,2,0,
19-jul-23,Durango,"SANTIAGO PAPASQUIARO, DGO.",0,0,0,10,3,160,
22-jul-23,Durango,"SANTIAGO PAPASQUIARO, DGO.",0,0,0,0,0,60,
24-jul-23,Chiapas,"OCOSINGO, CHIS.",0,0,0,0,0,250,
25-jul-23,Chiapas,"BERRIOZÁBAL, CHIS.",0,0,0,0,0,"1,509",
25-jul-23,Chiapas,"OCOSINGO, CHIS.",0,0,0,0,0,289,
26-jul-23,Chiapas,"TAPACHULA, CHIS.",0,0,0,1,0,292,
26-jul-23,Chiapas,"OCOSINGO, CHIS.",0,0,0,0,0,375,
27-jul-23,Chiapas,"OCOSINGO, CHIS.",0,0,0,3,0,931,
27-jul-23,Cd. de México,"CUAUHTEMOC, CD. MÉX.",0,0,0,0,1,49,
28-jul-23,Chiapas,"OCOSINGO, CHIS.",0,0,0,2,0,668,
29-jul-23,Chiapas,"VILLAFLORES, CHIS.",0,0,0,0,0,"1,727",
31-jul-23,Chiapas,"SUCHIATE, CHIS.",0,0,0,0,0,167,
04-ago-23,Cd. de México,"IZTACALCO, CD. MÉX.",0,0,0,0,0,468,
08-ago-23,Cd. de México,"IZTACALCO, CD. MÉX.",0,0,0,0,1,0,
09-ago-23,Chiapas,"TUXTLA CHICO, CHIS.",0,0,0,0,0,32,
09-ago-23,Cd. de México,"TLAHUAC, CD. MÉX.",0,0,0,0,0,175,
11-ago-23,Michoacán,"ALVARO OBREGON, MICH.",0,0,0,5,0,0,
11-ago-23,México,"SAN MARTIN DE LAS PIRAMIDES, MEX.",0,0,0,0,0,"1,750",
15-ago-23,Cd. de México,"IZTACALCO, CD. MÉX.",0,0,0,0,0,767,
16-ago-23,Cd. de México,"GUSTAVO A. MADERO, CD. MÉX.",0,0,0,0,0,50,
18-ago-23,Cd. de México,"TLAHUAC, CD. MÉX.",0,0,0,0,0,361,
22-ago-23,Chiapas,"OSUMACINTA, CHIS.",0,0,0,0,0,101,
22-ago-23,Chiapas,"CACAHOATÁN, CHIS.",0,0,0,4,0,116,
22-ago-23,Sinaloa,"SALVADOR ALVARADO, SIN.",0,0,0,0,0,58,
23-ago-23,Chihuahua,"JUÁREZ, CHIH.",0,0,0,0,0,162,
23-ago-23,Guerrero,"TIXTLA DE GUERRERO, GRO.",0,0,0,1,0,58,
25-ago-23,Tabasco,"CARDENAS, TAB.",0,0,0,0,0,135,
25-ago-23,Chiapas,"TUXTLA GUTIÉRREZ, CHIS.",0,0,0,0,0,203,
25-ago-23,Chihuahua,"JUÁREZ, CHIH.",0,0,0,35,0,207,
28-ago-23,Tamaulipas,"REYNOSA, TAMPS.",0,0,0,3,0,83,
31-ago-23,Querétaro,"EL MARQUES, QRO.",0,0,0,0,0,7,
01-sep-23,Chiapas,"COPAINALÁ, CHIS.",0,0,0,0,1,350,
01-sep-23,Querétaro,"EL MARQUES, QRO.",0,0,0,0,0,60,
03-sep-23,Chiapas,"CACAHOATÁN, CHIS.",0,0,0,0,0,212,
04-sep-23,Tamaulipas,"NUEVO LAREDO, TAMPS.",0,0,0,5,0,198,
04-sep-23,Tamaulipas,"REYNOSA, TAMPS.",0,0,0,6,0,167,
05-sep-23,Tamaulipas,"NUEVO LAREDO, TAMPS.",0,0,0,18,0,220,
06-sep-23,Guerrero,"EDUARDO NERI, GRO.",0,0,0,4,0,120,
07-sep-23,Guerrero,"EDUARDO NERI, GRO.",0,0,0,7,0,162,
08-sep-23,Tamaulipas,"NUEVO LAREDO, TAMPS.",0,0,0,28,0,50,
08-sep-23,Cd. de México,"XOCHIMILCO, CD. MÉX.",0,0,0,0,1,32,
08-sep-23,Cd. de México,"CUAUHTEMOC, CD. MÉX.",0,0,0,0,2,0,
11-sep-23,Puebla,"TEHUACAN, PUE.",0,0,0,7,1,0,
12-sep-23,Chihuahua,"JUÁREZ, CHIH.",0,0,0,2,0,30,
12-sep-23,Cd. de México,"XOCHIMILCO, CD. MÉX.",0,0,0,0,0,210,
19-sep-23,Cd. de México,"CUAUHTEMOC, CD. MÉX.",0,0,0,0,0,70,
20-sep-23,Cd. de México,"ALVARO OBREGON, CD. MÉX.",0,0,0,0,0,27,
21-sep-23,Chihuahua,"JUÁREZ, CHIH.",0,0,0,0,0,259,
22-sep-23,Guerrero,"ZITLALA, GRO.",0,0,0,2,0,37,
25-sep-23,Cd. de México,"ALVARO OBREGON, CD. MÉX.",0,0,0,0,0,22,
01-oct-23,Sinaloa,"COSALA, SIN.",0,0,0,0,0,200,
02-oct-23,Cd. de México,"ALVARO OBREGON, CD. MÉX.",0,0,0,0,0,110,
06-oct-23,Cd. de México,"CUAUHTEMOC, CD. MÉX.",0,0,0,0,0,49,
11-oct-23,Chiapas,"CHENALHÓ, CHIS.",0,0,0,0,0,12,
13-oct-23,Chiapas,"EL PORVENIR, CHIS.",0,0,0,0,0,20,
14-oct-23,Chiapas,"EL PORVENIR, CHIS.",0,0,0,0,0,18,
17-oct-23,Chiapas,"BELLA VISTA, CHIS.",0,0,0,2,0,56,
19-oct-23,Cd. de México,"CUAUHTEMOC, CD. MÉX.",0,0,0,0,0,37,
20-oct-23,Cd. de México,"IZTAPALAPA, CD. MÉX.",0,0,0,0,0,157,
26-oct-23,Cd. de México,"CUAUHTEMOC, CD. MÉX.",0,0,0,0,0,115,
26-oct-23,Tlaxcala,"TOTOLAC, TLAX.",0,0,0,0,0,30,
31-oct-23,Cd. de México,"CUAUHTEMOC, CD. MÉX.",0,0,0,0,0,134,
03-nov-23,Coahuila,"MONCLOVA, COAH.",0,0,0,0,0,240,
03-nov-23,Cd. de México,"IZTAPALAPA, CD. MÉX.",0,0,0,0,0,2,
06-nov-23,Coahuila,"MONCLOVA, COAH.",0,0,0,3,0,816,
07-nov-23,Coahuila,"MONCLOVA, COAH.",0,0,0,0,1,984,
09-nov-23,Cd. de México,"CUAJIMALPA DE MORELOS, CD. MÉX.",0,0,0,0,0,74,
10-nov-23,Sinaloa,"SAN IGNACIO, SIN.",0,0,0,0,1,193,
10-nov-23,Cd. de México,"CUAUHTEMOC, CD. MÉX.",0,0,0,0,0,21,
17-nov-23,San Luis Potosí,"SAN LUIS POTOSI, S.L.P.",0,0,0,18,0,0,
17-nov-23,Chiapas,"AMATENANGO DE LA FRONTERA, CHIS.",0,0,0,2,0,32,
20-nov-23,Chiapas,"TONALÁ, CHIS.",0,0,0,2,0,12,
22-nov-23,Chiapas,"CHICOMUSELO, CHIS.",0,0,0,1,0,7,
26-nov-23,Chiapas,"CINTALAPA, CHIS.",0,0,0,3,0,41,
27-nov-23,Cd. de México,"CUAUHTEMOC, CD. MÉX.",0,0,0,0,0,130,
28-nov-23,Cd. de México,"CUAJIMALPA DE MORELOS, CD. MÉX.",0,0,0,0,0,1,
28-nov-23,Puebla,"PUEBLA, PUE.",0,0,0,2,0,0,
28-nov-23,Chihuahua,"JUÁREZ, CHIH.",0,0,0,0,0,93,
29-nov-23,Chihuahua,"JUÁREZ, CHIH.",0,0,0,1,0,445,
30-nov-23,Chiapas,"CHICOMUSELO, CHIS.",0,0,0,0,0,65,
01-dic-23,Chiapas,"PANTELHÓ, CHIS.",0,0,0,0,0,157,
02-dic-23,Chiapas,"CHICOMUSELO, CHIS.",0,0,0,0,0,324,
05-dic-23,Hidalgo,"ATOTONILCO DE TULA, HGO.",0,0,0,0,0,52,
05-dic-23,Cd. de México,"MILPA ALTA, CD. MÉX.",0,0,0,0,0,49,
06-dic-23,Chiapas,"LA GRANDEZA, CHIS.",0,0,0,0,0,25,
06-dic-23,Chiapas,"CHENALHÓ, CHIS.",0,0,0,0,0,63,
07-dic-23,Chihuahua,"JUÁREZ, CHIH.",0,0,0,0,0,34,
08-dic-23,Hidalgo,"ZACUALTIPAN DE ANGELES, HGO.",0,0,0,0,0,6,
08-dic-23,Cd. de México,"CUAUHTEMOC, CD. MÉX.",0,0,0,0,0,745,
08-dic-23,Chihuahua,"JUÁREZ, CHIH.",0,0,0,0,0,35,
09-dic-23,Chiapas,"LA GRANDEZA, CHIS.",0,0,0,0,0,25,
11-dic-23,Chihuahua,"JUÁREZ, CHIH.",0,0,0,10,2,98,
13-dic-23,Hidalgo,"METZTITLAN, HGO.",0,0,0,0,0,25,
13-dic-23,Chihuahua,"JUÁREZ, CHIH.",0,0,0,2,0,0,
15-dic-23,Chihuahua,"JUÁREZ, CHIH.",0,0,0,0,0,48,
20-dic-23,Chiapas,"CHENALHÓ, CHIS.",0,0,0,0,0,230,
22-dic-23,Zacatecas,"ZACATECAS, ZAC.",0,0,0,7,0,316,
27-dic-23,Zacatecas,"GUADALUPE, ZAC.",0,0,0,7,0,308,
11-ene-24,Zacatecas,"LUIS MOYA, ZAC.",0,0,0,1,0,10,
12-ene-24,Zacatecas,"PINOS, ZAC.",0,0,0,0,0,104,
24-ene-24,Zacatecas,"ZACATECAS, ZAC.",0,0,0,1,0,0,
31-ene-24,Zacatecas,"GUADALUPE, ZAC.",0,0,0,0,0,50,
10-feb-24,Zacatecas,"TLALTENANGO DE SANCHEZ ROMAN, ZAC.",0,0,0,3,1,171,
14-feb-24,Zacatecas,"FRESNILLO, ZAC.",0,0,0,10,0,626,
15-feb-24,Zacatecas,"FRESNILLO, ZAC.",0,0,0,17,0,503,
01-mar-24,Cd. de México,"GUSTAVO A. MADERO, CD. MÉX.",0,0,0,0,0,16,
04-mar-24,Cd. de México,"GUSTAVO A. MADERO, CD. MÉX.",0,0,0,0,0,578,
07-mar-24,Zacatecas,"FRESNILLO, ZAC.",0,0,0,20,0,"1,242",
09-mar-24,Zacatecas,"FRESNILLO, ZAC.",0,0,0,212,0,374,
11-mar-24,Zacatecas,"FRESNILLO, ZAC.",0,0,0,6,0,160,
18-mar-24,Cd. de México,"GUSTAVO A. MADERO, CD. MÉX.",0,0,0,0,0,242,
18-mar-24,Cd. de México,"TLALPAN, CD. MÉX.",0,0,0,0,0,26,
19-mar-24,Cd. de México,"IZTAPALAPA, CD. MÉX.",0,0,0,0,0,50,
25-mar-24,Zacatecas,"FRESNILLO, ZAC.",0,0,0,15,0,182,
26-mar-24,Zacatecas,"FRESNILLO, ZAC.",0,0,0,9,0,393,
27-mar-24,Zacatecas,"FRESNILLO, ZAC.",0,0,0,18,0,459,
02-abr-24,Cd. de México,"GUSTAVO A. MADERO, CD. MÉX.",0,0,0,0,1,0,
09-abr-24,Cd. de México,"TLAHUAC, CD. MÉX.",0,0,0,0,0,4,
10-abr-24,Cd. de México,"TLAHUAC, CD. MÉX.",0,0,0,0,0,335,
17-abr-24,Cd. de México,"CUAUHTEMOC, CD. MÉX.",0,0,0,0,0,557,
19-abr-24,Cd. de México,"TLAHUAC, CD. MÉX.",0,0,0,0,0,5,
22-abr-24,Cd. de México,"CUAUHTEMOC, CD. MÉX.",0,0,0,0,0,67,
23-abr-24,Cd. de México,"IZTACALCO, CD. MÉX.",0,0,0,0,0,9,
30-abr-24,Cd. de México,"CUAUHTEMOC, CD. MÉX.",0,0,0,0,0,6,
08-may-24,Zacatecas,"FRESNILLO, ZAC.",0,0,0,5,0,96,
09-may-24,Zacatecas,"FRESNILLO, ZAC.",0,0,0,2,0,93,
13-may-24,Cd. de México,"CUAUHTEMOC, CD. MÉX.",0,0,0,0,0,30,
11-may-24,Zacatecas,"FRESNILLO, ZAC.",0,0,0,5,0,9,
12-may-24,Zacatecas,"FRESNILLO, ZAC.",0,0,0,1,0,0,
14-may-24,Zacatecas,"FRESNILLO, ZAC.",0,0,0,3,0,47,
22-may-24,Cd. de México,"XOCHIMILCO, CD. MÉX.",0,0,0,0,0,60,
23-may-24,Cd. de México,"VENUSTIANO CARRANZA, CD. MÉX.",0,0,0,0,0,32,
24-may-24,Zacatecas,"FRESNILLO, ZAC.",0,0,0,8,0,216,
25-may-24,Zacatecas,"FRESNILLO, ZAC.",0,0,0,6,0,340,
27-may-24,Zacatecas,"FRESNILLO, ZAC.",0,0,0,7,0,300,
28-may-24,Zacatecas,"FRESNILLO, ZAC.",0,0,0,8,0,280,
29-may-24,Zacatecas,"FRESNILLO, ZAC.",0,0,0,8,0,281,
10-jun-24,Cd. de México,"MIGUEL HIDALGO, CD. MÉX.",0,0,0,0,0,155,
19-jun-24,Cd. de México,"BENITO JUAREZ, CD. MÉX.",0,0,0,0,0,22,
20-jun-24,Sinaloa,"NAVOLATO, SIN.",0,0,0,0,1,0,
20-jun-24,Michoacán,"JACONA, MICH.",0,0,0,1,0,0,
21-jun-24,Michoacán,"JACONA, MICH.",0,0,0,29,0,600,
28-jun-24,Zacatecas,"ZACATECAS, ZAC.",0,0,0,3,0,9,
